ánnuitehtadoaba	1. annuitetsbegrep;  
puba	1. pub;  
áššemeannudeaddjenákca	1. saksbehandlerskraft;  
ovdinbuktinnákca	1. formidlingsevne;  
nygaardsvollvanca	1. nygaardsvollbåt;  
seksváidda	1. sexanklager;  
guorusnatgealdda	1. tomgangsspenning;  
gaskaneasvuođđojurdda	1. gjensidighetsprinsipp;  
lahkadovdda	1. nærsans;  
reatkáhávdda	1. omslag av eineavkok;  
smaragda	1. smaragd;  
apartheida	1. apartheid;  
karbondioksiida	1. karbondioksid;  
oalgebahčuolda	1. påle;  
ovdanahttinfoanda	1. utviklingsfond;  
veranda	1. veranda;  
stipenda	1. stipend;  
personalhoavda	1. personalsjef;  
sosiálhoavda	1. sosialsjef;  
ovda	1. foran;  
moattelađas-dávda	1. leddsykdom;  
šohkoláda	1. sjokolade;  
iežaskapitálgráda	1. egenkapitalgrad;  
mielahttostáda	1. medlemsstat;  
idea	1. idé;  
trofea	1. trofé;  
káfea	1. kafé;  
trokea	1. troké;  
sámimusea	1. samemuseum;  
geografa	1. geograf;  
biografa	1. biograf;  
bálddisvuogga	1. kveiteangel;  
biručolga	1. djevelspytt;  
sámidiggeválga	1. sametingsvalg;  
gorrelohkkoválga	1. forholdstallsvalg;  
asfáltabetonga	1. asfaltbetong;  
spesiálpedagoga	1. spesialpedagog;  
sosialantropologa	1. sosialantropolog;  
sámileavga	1. sameflagg;  
fáhccbealčivga	1. småkveite;  
sosialfága	1. sosialfag;  
sámegielfága	1. samiskspråkfag;  
cázádatlága	1. vassdragslov;  
kardaŋga	1. kardang;  
baseaŋga	1. basseng;  
vuojadanbaseaŋga	1. svømmebasseng;  
lášmmohallanbasseŋga	1. treningsbasseng;  
šárgoŋga	1. sjargong;  
folia	1. folie;  
ironia	1. ironi;  
planetaria	1. planetarium;  
meieria	1. meieri;  
teoria	1. teori;  
ráŋggáštanriekteteoria	1. strafferettsteori;  
kaloria	1. kalori;  
poesia	1. poesi;  
homeopáhtia	1. homeopati;  
kollokvia	1. kollokvium;  
sálvia	1. salvie;  
gáfeja	1. kafé;  
medija	1. media;  
gurkemeija	1. gurkemeie;  
myhtologija	1. mytologi;  
logopediija	1. logopedi;  
demografiija	1. demografi;  
muskeldystrofiija	1. dehkkedystrofi;  
bibliográfiija	1. bibliografi;  
leksikográfiija	1. leksikografi;  
metaleksikográfiija	1. metaleksikografi;  
topográfiija	1. topografi;  
kollegiija	1. kollegium;  
kolegiija	1. kollegium;  
strátegiija	1. strategi;  
psikologiija	1. psikologi;  
sosialantropologiija	1. sosialantropologi;  
stimuliija	1. stimulus;  
guohkkinymiija	1. hakkenymi;  
metonymiija	1. metonymi;  
universalgeniija	1. universalgeni;  
plafondmaleriija	1. plafondmaleri;  
kunstgalleriija	1. kunstgalleri;  
metameriija	1. metameri;  
kriteriija	1. kriterium;  
laboratoriija	1. laboratorium;  
govvalaboratoriija	1. fotolaboratorie;  
oahpahanlaboratoriija	1. undervisningslaboratorie;  
nagirlaboratoriija	1. søvnlaboratorie;  
vahátlaboratoriija	1. skadelaboratorie;  
loboratoriija	1. loboratorium;  
territoriija	1. territorium;  
porteeeepotpurriija	1. porteeeepotpurri;  
synestesiija	1. synestesie;  
batiija	1. byråkrati;  
profetija	1. profeti;  
festiváldoarjja	1. festivalstønad;  
medállja	1. medalje;  
oahppiidlatnja	1. lærerrom;  
seminárlatnja	1. seminarrom;  
sanitárlatnja	1. sanitærrom;  
gárja	1. kråke;  
obdukšuvdnalantja	1. obduksjonsstue;  
kája	1. kai;  
kinemateahka	1. kinematek;  
medieteahka	1. medietek;  
pinakoteahka	1. pinakotek;  
hypoteahka	1. hypotek;  
glyptoteahka	1. glyptotek;  
kartoteahka	1. kartotek;  
sámiláhka	1. samelov;  
minerálláhka	1. minerallov;  
vearrodahkoláhka	1. kriminallov;  
toppláhka	1. topplov;  
sosiálbálvalusláhka	1. sosialtjenesteloven;  
gáibideaddjeriika	1. pretensjonsmakt;  
industririika	1. industriland;  
paprika	1. paprika;  
guoktgeahpesseahkka	1. halvparten så lett sekk;  
kloahkka	1. kloakk;  
šahkka	1. sjakk;  
kulihkka	1. kolikk;  
spontánmotorihkka	1. spontanmotorikk;  
poletihkka	1. politikk;  
nissonapolitihkka	1. kvinnepolitikk;  
mediepolitihkka	1. mediepolitikk;  
guovllopolitihkka	1. områdepolitikk;  
rekrutteringspolitihkka	1. rekrutteringspolitikk;  
matemátihkka	1. matematikk;  
pragmátihkka	1. pragmatikk;  
fuohkka	1. fokk;  
boblejáhkka	1. boblejakke;  
vuoncáváhkka	1. kyllingklubbe;  
gaffaltrukka	1. gaffeltruck;  
muohtagielka	1. snøkjelke;  
tanka	1. tanka;  
oláhusmearka	1. milepel;  
muohtaparka	1. snøpark;  
gurka	1. agurk;  
suvrragurka	1. sylteagurk;  
preambela	1. prembel;  
parallela	1. parallell;  
instrumentpanela	1. instrumentpanel;  
bonjusmakrealla	1. makrell i tomatsaus;  
palla	1. palle;  
boalsttartunella	1. putetunnel;  
morella	1. morell;  
konferánsahotella	1. konferansehotell;  
gažadanprohtokolla	1. forhørsprotokoll;  
eananprohtokolla	1. utmålsprotokoll;  
ampulla	1. ampull;  
statsmonopola	1. statsmonopol;  
teflongásterola	1. teflonkasserolle;  
bonjisjuvla	1. skruedrev;  
granatminerála	1. granatmineral;  
brillefutterála	1. brillefutteral;  
johtočála	1. rundskriv;  
láhttidásidoaibma	1. aktivitet på gulvnivå;  
teflonfoarbma	1. teflonform;  
lieđbma	1. åreblad;  
áirolieđbma	1. åreblad;  
atopalašeksema	1. atopisk eksem;  
inertialsystema	1. inertialsystem;  
vokalsystema	1. vokalsystem;  
signalsystema	1. signalsystem;  
karbonsystema	1. karbonsystem;  
metersystema	1. metersystem;  
koordinatsystema	1. koordinatsystem;  
prohibitivsystema	1. prohibitivsystem;  
plomma	1. plomme;  
kondolansetelegrámma	1. kondolansetelegram;  
paralleallográmma	1. parallellogram;  
aroma	1. aroma;  
orgasma	1. orgasme;  
sosialrealisma	1. sosialrelisme;  
konvenšuvdnalisma	1. konvensjuvnalisme;  
sosialliberalisma	1. sosialliberalisme;  
monopolkapitalisma	1. monopolkapitalisme;  
senkapitalisma	1. senkapitalisme;  
seinkapitalisma	1. seinkapitalisme;  
statskapitalisma	1. statskapitalisme;  
privatkapitalisma	1. privatkapitalisme;  
privatbilisma	1. privatbilisme;  
ekspressionisma	1. ekspresjonisme;  
lokalpatriotisma	1. lokalpatriotisme;  
lobyisma	1. lobbyisme;  
nazisma	1. nazisme;  
trampoliidna	1. trampoline;  
gelatiidna	1. gelatin;  
našovdna	1. nasjon;  
mišovdna	1. misjon;  
kommišovdna	1. kommisjon;  
pearmišovdna	1. permisjon;  
regiuvdna	1. region;  
spiuvdna	1. spion;  
sitruvdna	1. sitron;  
vokalkombinašuvdna	1. vokalkombinasjon;  
orgánisašuvdna	1. organisasjon;  
totálstašuvdna	1. totalstasjon;  
industrikonsešuvdna	1. industrikonsesjon;  
mišuvdna	1. misjon;  
pearbmišuvdna	1. permisjon;  
pearmišuvdna	1. permisjon;  
trasmišuvdna	1. transmisjon;  
mororeakšuvdna	1. mororeksjon;  
politiakšuvdna	1. politiaksjon;  
presumšuvdna	1. presumsjon;  
peršuvdna	1. person;  
konsultášuvdna	1. konsultasjon;  
stášuvdna	1. stasjon;  
pumpastášuvdna	1. pumpestasjon;  
porselena	1. porselen;  
domena	1. domene;  
hátna	1. kran;  
fauna	1. fauna;  
hávvarriedvna	1. havregryn;  
dilleplána	1. situasjonsplan;  
areálplána	1. arealplan;  
biotopa	1. biotop;  
dovddidusoahppa	1. epistemologi;  
botnedáhppa	1. bunntapp;  
tara	1. tara;  
iisamearra	1. ishav;  
bonjisgurra	1. spiralspor;  
bonjisbovra	1. spiralbor;  
kantovra	1. kontor;  
ovdakantovra	1. forkontor;  
skuvlakantovra	1. skolekontor;  
sosiálakantovra	1. sosialkontor;  
ruhtakantovra	1. kassakontor;  
ruovttuveahkkekantovra	1. hjemmehjelpskontor;  
registrerenkantovra	1. registreringskontor;  
eananvuovdinkantovra	1. jordsalgskontor;  
váráiduhttinkantovra	1. forsyningskontor;  
oadjokantovra	1. trygdekontoret;  
kulturkantovra	1. kulturkontoret;  
hálddahuskantovra	1. administrasjonskontor;  
geavahuskántovra	1. forbrukerkontor;  
traktuvra	1. traktor;  
sektuvra	1. sektur;  
sámikultuvra	1. samekultur;  
personalkantuvra	1. personalkontor;  
guovllokantuvra	1. distriktskontor;  2. regionskontor;  
ovdakontuvra	1. forkontor;  
kántuvra	1. kontor;  
gielddakántuvra	1. kommunekontor;  
riekteveahkkekántuvra	1. rettshjelpskontor;  
sosiálkántuvra	1. sosialkontor;  
oadjokántuvra	1. trygdekontor;  
doavttirkántuvra	1. legekontor;  
doaktárkántuvra	1. legekontor;  
guovllukántuvra	1. distriktskontor;  2. regionskontor;  
refleksa	1. refleks;  
ohcanrefleksa	1. søkerefleks;  
njammanrefleksa	1. sugerefleks;  
čárvenrefleksa	1. griperefleks;  
asfáltamastriksa	1. asfaltmastriks;  
asfáltamastiksa	1. asfaltmastiks;  
sisbuksa	1. underbukse;  
interferensa	1. interferens;  
kompetensa	1. kompetanse;  
nonmobiliteahta	1. nonmobilitet;  
plákahta	1. plakat;  
bálvalusappárahta	1. serviceapparat;  
intranehta	1. intranet;  
internehta	1. internet;  
femininitehta	1. femininitet;  
subsidiáritehta	1. subsidiaritet;  
ánnuitehta	1. annuitet;  
ovdaánnuitehta	1. forskuddsannuitet;  
maŋŋeánnuitehta	1. etterskuddsannuitet;  
diehtemeahtunvuohta	1. uvitenhet;  
vuostelasvuohta	1. konflikt;  
bealatkeahtesvuohta	1. ugildhet;  
luoddearrolihkuhisvuohta	1. vegkryssulykke;  
dearpannanosvuohta	1. bankefasthet;  
loaktinnanosvuohta	1. slitestyrke;  
ivdnádatvuohta	1. kulørthet;  
pantavuoigatvuohta	1. panterett;  
reálgelbbolašvuohta	1. realkompetanse;  
njalagálašvuohta	1. evighet;  
fáktágirjjálašvuohta	1. dokumentarlitteratur;  
bazahanruhta	1. pengeavsetning;  
čuokkissveisenapparáhta	1. punktsveiseapparat;  
ákta	1. ve;  
liekkasrasttidankoeffisieanta	1. varmegjennomgangskoeffisient;  
kvotienta	1. kvotient;  
nota	1. nota;  
návsta	1. naust;  
badjeldeatta	1. overtrykk;  
learretta	1. lerret;  
billeahtta	1. billett;  
našunaliteahtta	1. nasjonalitet;  
našunálbušeahtta	1. nasjonalbudsjett;  
prejudikahtta	1. prejudikat;  
čáskadanapparahtta	1. brannslukningsapparat;  
prejudkáhtta	1. prejudkat;  
aetáhtta	1. aetat;  
hábitáhtta	1. habitat;  
algobuvtta	1. vare;  
priváhtiiva	1. privativ;  
nissonaperspektiiva	1. kvinneperspektiv;  
guhkesáiggiperspektiiva	1. langtidsperspektiv;  
bonjisskruvva	1. snekkeskrue;  
liidnakláva	1. lineklave;  
alléa	1. allé;  
bišáhke	1. stingsild;  
sviske	1. sviske;  
rele	1. rele;  
belle	1. blikk;  
ivdnádatsodjobiire	1. kulørtonekrets;  
genre	1. genre;  
glukose	1. druesukker;  
tratte	1. tratte;  
reaidahaddi	1. kontantpris;  
geassesajgieddi	1. seterløkke;  
njuorjjubuoidi	1. selspekk;  
mierkavuoidi	1. tåkesmører;  
bajimusmearridanváldi	1. overherredømme;  
oahpaheaddjebeavdi	1. kateter;  
aduserruovdi	1. aduserjern;  
alolastavuovdi	1. edelløvskog;  
gáneljuolcaggi	1. trestav;  
oktoráđđejupmeáigi	1. enevoldstid;  
eretorrunáigi	1. fravær;  
johtoáigi	1. omløpstid;  
giehtaváđgeađgi	1. jernstein;  
bijahussadji	1. sted hvor man har røsket opp reinlav;  
ovttagálvobuvttadeaddji	1. envareprodusent;  
ekonomioaivadeaddji	1. økonomikonsulent;  
sosiáloaivadeaddji	1. sosialkonsulent;  
kulturoaivadeaddji	1. kulturkonsulent;  
eanangáibideaddji	1. arealkrevende;  
iešvuosttaldeaddji	1. selvmotsigende;  
siviláittardeaddji	1. sivilombud;  
kultureaktudeaddji	1. kulturbetingede;  
čálačájeaheaddji	1. skriftprosjektor;  
kánttordoaimmaheaddji	1. kontorfullmektig;  
sosiáloahpaheaddji	1. sosiallærer;  
sosiáljođiheaddji	1. sosialleder;  
kánttorjođiheaddji	1. kontorleder;  
johtáleaddji	1. trafikant;  
ovdaságasteaddji	1. foredragsholder;  
sparrguoddinrádji	1. boggilastgrense;  
miehtterávdnji	1. medstrøm;  
máŋggaluottavuohki	1. flervegsmetode;  
maŋitgaskaáhki	1. senmiddelalder;  
kánttorveahkki	1. kontorassistent;  
njuorjjunáhkki	1. selskinn;  
bohkkaguiski	1. blåskjell;  
johttisámidilli	1. reinnomadisme;  
davraguolli	1. fersk fisk;  
gilvaguolli	1. settefisk;  
sosiálčálli	1. sosialsekretær;  
refleksalihkadeapmi	1. refleksbevegelse;  
gulloiskkadeapmi	1. hørselskontroll;  
sinkadeapmi	1. forsinking;  
seksuálgivssideapmi	1. seksualpress;  
vealggeheapmi	1. gjeldfri;  
ieš-orusteapmi	1. selvbetjent parkering;  
gahččanlápmašupmi	1. fallskade;  
iežaskapitálhápmi	1. egenkapitalform;  
romani	1. romani;  
ivdnádativdni	1. kulørte farge;  
cirgganjunni	1. spylespiss;  
boarásmuvvannáigemearri	1. foreldelsesfrist;  
vuolimusrádjomearri	1. minimum lagerkvantum;  
unnimusmearri	1. minimum;  
kárri	1. karri;  
taksi	1. taxi;  
impedimentoassi	1. impedimentandel;  
muovjamiessi	1. reinkalv i det første hårskiftet;  
geažotbealjmiessi	1. umerket reinkalv;  
návsti	1. naust;  
nylonnuohtti	1. nylonnot;  
kivi	1. kiwi;  
stánči	1. slam;  
bajimusbearráigeahčči	1. overoppsynsmann;  
tabernakel	1. tabernakel;  
orakel	1. orakel;  
spetakkel	1. spetakkel;  
sparkel	1. sparkel;  
vizzetjeagil	1. rabbeskjegg;  
metrum	1. metrum;  
votum	1. votum;  
bábircában	1. makulatur;  
mineralaroggan	1. mineralutvinning;  
dássádáhttingihkan	1. nivellerkikkert;  
čohkkundoalan	1. kam med håndtak;  
indeksaheivehallan	1. indeksregulering;  
geahpeslašmmohallan	1. lungegymnastikk;  
guohtueanan	1. beiteareal;  
sŋiran	1. skralle;  
bábirduoran	1. stiftemaskin;  
miehttejursan	1. medfresing;  
molybden	1. molybden;  
skarlagen	1. skarlagen;  
glykogen	1. glykogen;  
halogen	1. halogen;  
hallusinogen	1. hallusinogen;  
androgen	1. androgen;  
hydrogen	1. hydrogen;  
østrogen	1. østrogen;  
oksygen	1. oksygen;  
luondohábmen	1. karakterdannelse;  
bitumen	1. bitumen;  
kapitáliseren	1. kapitalisering;  
čuokkissveisen	1. punktsveising;  
arsen	1. arsen;  
karoten	1. karoten;  
benzen	1. benzen;  
billeriin	1. margarin;  
badjelluottavuodjin	1. utforkjøring;  
našunalčoahkkin	1. nasjonalforsamling;  
guorusnatjohtin	1. tomgang;  
eananláktin	1. sammenføyning;  
badjelguorbmesihkkarastin	1. overlastsikring;  
konturčielggasmahttin	1. konturforsterkning;  
cuovkanahttin	1. fremkalt abort;  
almmusduhttin	1. tinglysning;  
refleksavázzin	1. automatisk gange;  
estragon	1. estragon;  
ikon	1. ikon;  
konfoluhttanjolon	1. konvoluttklebemaskin;  
mikrobotkkán	1. mikrobryter;  
masommán	1. masovn;  
dulbenjurssán	1. planfres;  
turbo	1. turbo;  
bajitkommando	1. overkommando;  
manomehtar	1. manometer;  
boalsttar	1. pute;  
roavvafuođđar	1. grovfor;  
ruonasfuođđar	1. grønnforvekst;  
aksiálláger	1. aksiallager;  
guovtteráiddoláger	1. torada lager;  
teahter	1. teater;  
guhttanuppelohmehter	1. sekstenmeter;  
kvadratmehter	1. kvadratmeter;  
adapter	1. adapter;  
konverter	1. konverter;  
karbonbábir	1. karbonpapir;  
fievrrádusbábir	1. fraktbrev;  
girdifievrrádusbábir	1. flyfraktbrev;  
šahčir	1. skarp fjellkam;  
guovttetdávttatmohtor	1. totaktsmotor;  
golmmamuddutmohtor	1. trefasemotor;  
traktor	1. traktor;  
mikrodoaimmár	1. mikroprosessor;  
fáttár	1. fadder;  
valljeváilebahkadas	1. ressurskrise;  
goalšoruoššehas	1. sivsanger;  
snoranuohttofanas	1. ringnotfartøy;  
proteidnaávnnas	1. proteintørrstoff;  
anánas	1. ananas;  
ággaras	1. ål;  
gálvojohtolađas	1. omsetningsledd;  
kokos	1. kokos;  
kapers	1. kapers;  
čáhcelagadus	1. vannforsyning;  
kapitálráhkadus	1. kapitalstruktur;  
ovddasvástadus	1. ansvar;  
govvadus	1. framstilling;  
bajimusmearridangáibádus	1. suverenitetskrav;  
čoahkádus	1. sammensetning;  
mearalvuoládus	1. sjømannsfradrag;  
fievrrádus	1. frakt;  
oaivádus	1. veiledning;  
vearromaŋádus	1. skattekreditt;  
fitnooaphahus	1. yrkesopplæring;  
várohus	1. mistanke;  
bálggisčujuhus	1. stibetegnelse;  
čáláhus	1. utskrift;  
beavdegirječáláhus	1. protokollutskrift;  
johtočálus	1. rundskriv;  
vuloštus	1. fundament;  
gáffadat	1. kafeteria;  
časkindávgadat	1. slagseighet;  
arvešoaladat	1. plaskregn;  
šiehtadallanfáladat	1. forhandlingstilbud;  
ávttadat	1. slakteplass;  
sosiálossodat	1. sosialetaten;  
kánttorservodat	1. kontorlandskap;  
guokteoahpaheaddjivuogádat	1. tolærersystem;  
desimálvuogádat	1. desimalsystem;  
dievasivdnádat	1. maksimalkulør;  
kameráldoaimmahat	1. kameralvesen;  
luoitahat	1. avløp;  
differensiálgiddehat	1. differensialsperre;  
dusttehat	1. støtfanger;  
feltspáhtaláiggohat	1. feltspatbrudd;  
dákteluottohat	1. beinverk;  
unnimusealáhat	1. minstepensjon;  
fievridanjohtolat	1. godstrafikk;  
lávvolat	1. kon;  
makaruvnnat	1. makaroni;  
tákseorustat	1. taxiholdeplass;  
lássenrieggabasttat	1. låseringstang;  
jeaggehávat	1. myrhauk;  
grávvejaččat	1. gravøl;  
geavahanriektelaččat	1. bruksrettskrets;  
kitet	1. kjetting;  
gieđaguhkit	1. gripetang;  
johtooamit	1. omløpsmidler;  
biepmussálttit	1. næringssalter;  
oarrskieddu	1. lineforsyn;  
plantarflekšuvdnaguoddu	1. plantarflerert stilling;  
biššonbád-fárfu	1. løkke;  
geaigu	1. ark;  
kánttorbargu	1. kontorarbeid;  
ivdnádatsodju	1. kulørtone;  
vuolimusgálvorádju	1. minimumsbeholdning;  
golggusrádju	1. væskelager;  
botneneahku	1. bunnformasjon;  
indeksalohku	1. indekstall;  
čuokkisčoahkku	1. oppløsning;  
beallejorbafiilu	1. halvrundfil;  
geassesajdoallu	1. seterbruk;  
buhtisindoallu	1. hygiene;  
sosialgollu	1. sosial kostnad;  
kapitálgollu	1. kapitalkostnad;  
vegetarbiebmu	1. vegetarmat;  
tearbmugádnu	1. TV-kanne;  
biru	1. djevel;  
luoddearru	1. vegkryss;  
leidangvearru	1. leidangskatt;  
signálbeaktu	1. signaleffekt;  
kruoktu	1. kruttåte;  
sisabidjureantu	1. innskuddsrente;  
oasuskapitálkontu	1. aksjekapitalskonto, konto for aksjekapital;  
busgáhttu	1. katt;  
eŋgelasgielmáhttu	1. engelskkunnskap;  
preantagálvu	1. trykksak;  
átŋu	1. keip;  
rastabuođđu	1. overstengsel;  
áhkalakkisgiehtaváđđu	1. håkjerringjuksa;  
rohoguoddá	1. rohopute;  
pandá	1. panda;  
kafeá	1. kafe;  
kommunikeá	1. kommuniké;  
dreaggá	1. dregg;  
meieriijá	1. meieri;  
politiijá	1. politi;  
govddodanliinná	1. snik;  
sosialdemokráhtalaš	1. sosialdemokrat;  
hammerfeastalaš	1. hammerfesting;  
almennetriektelaš	1. allmenningsrettshaver;  
sosiálovddasmoraš	1. sosialomsorg;  
luohkká-luohttevaš	1. klassekontakt;  
fiervaviroš	1. fjæreplytt;  
bertoš	1. villreinsnare;  
moaitamuš	1. bebreidelse;  
gulloguovddáš	1. høresentral;  
mearamilitearguovddáš	1. marinebase;  
	
