besset	besset	+?
bora	bora	+?
borra	borra	+?
bussat	bussat	+?
báraheapme	báraheapme	+?
bárrastávval	bárrastávval	+?
duohtavuohki	duohtavuohki	+?
dánsu	dánsu	+?
geardu	geardu	+?
gilvvakeahtes	gilvvakeahtes	+?
girje	girje	+?
girjjis	girjjis	+?
hárjehit	hárjehit	+?
latnjat	latnjat	+?
loahppat	loahppat	+?
lohka	lohka	+?
lávlat	lávlat	+?
matte	matte	+?
miessejoavku	miessejoavku	+?
mieđu	mieđu	+?
muiti	muiti	+?
máhta	máhta	+?
neahtis	neahtis	+?
ovtta	ovtta	+?
persovdna	persovdna	+?
preterihtta	preterihtta	+?
sektovra	sektovra	+?
sistat	sistat	+?
sáhkat	sáhkat	+?
unnimus	unnimus	+?
vahkat	vahkat	+?
vahkkoplána	vahkkoplána	+?
