njuoras A: ydmyk; mild; svak _ øm, mild, svak
jábálaš A: velstående; rik _ rik
oahppováillat A: utdanningsskadelidt; utdanningsskadelidende _ uten utdanning
hilbat A: uskikkelig; rampet _ vilter, skøyeraktig
balddihahtti A: urovekkende; skremmende _ skremmende
boasttu- A: uriktig _ feil, uriktig
oahppameahttun A: uoppdragen _ ulærd
dohkketmeahttun A: uholdbar; uakseptabel _ ubrukelig, udugelig, uakseptabel
ávdin A: ubebodd; øde _ øde
eahpečielggas A: uavklart; uklar _ uklar
áddjái A: tidkrevende; sein _ sein, tidkrevende
váibbas A: søvnig; trøtt _ trøtt
seaggi A: sped; smal; tynn _ tynn, spinkel
bahánihkkán A: slem _ uskikkelig
árvvas A: sjenerøs; gavmild _ generøs, gavmild
starggas A: robust; stiv _ stiv, stø
válmmaš A: rede; ferdig _ ferdig
mearkkalaš A: pussig; merkelig _ merkelig
oktageardán A: primitiv; naiv; enkel _ enkel
ebmui A: prektig; flott _ flott
nággár A: opposisjonell; gjenstridig _ sta, stridig
jierbmái A: oppegående; intelligent; klok; smart _ klok
návccaheapme A: næringssvak; svak _ svak, veik
dárogielat A: norsktalende; norsk; norskspråklig _ norskspråklig
dárogiel A: norsk; norskspråklig _ norskspråklig
šlundi A: nedslått _ motløs, bedrøvet
suohtas A: moro; morsom; hyggelig _ morsom, hyggelig
hállái A: meddelsom _ pratsom
máŋggabealat A: mangeartet; allsidig _ allsidig, mangesidig
vigiheapme A: lytefri; uskyldig _ uskyldig
lágalaš A: lovmessig; rettslig; lovlig _ lovlig; rettsgyldig
eleš A: livskraftig _ kvikk og livlig; livsdyktig; lengelevende
beakkálmas A: legendarisk; kjent _ kjent, berømt
riikkaviidosaš A: landsomfattende; landsdekkende; nasjonal _ riksdekkende
gelbbolaš A: kompetent; verdig _ dugelig; verdig
vuoiŋŋalaš A: immateriell; åndelig; religiøs; mental _ åndelig
muittoheapme A: glemsk _ glømsk, glemsom, distre
várrugas A: føre var; var _ forsiktig
máđoheapme A: formidabel _ forskrekkelig
dáláš A: eksisterende _ nåtidens
dálá A: eksisterende _ nåtidig
láiki A: doven _ lat
jállu A: djerv; modig _ modig
njuolgat A: direkte; rett _ rett, bein
njálggat A: deilig _ velsmakende, søt
šealgat A: blinkende _ blank
mearrideaddji A: avgjørende _ bestemmende
anihahtti A: anvendelig; anvendbar _ brukbar
falli A: sportslig; rask _ rask
roastil A: uredd _ dristig
dábálaš A: allmenn; ordinær; normal; standard; vanlig _ vanlig, alminnelig
erenoamáš A: særlig; særskilt; spesiell _ spesiell, ekstra
vásedin A: særlig; særskilt _ særskilt
ahkit A: trist; kjedelig _ kjedelig, utrivelig
ovttaskas A: enkelt _ enslig
eaŋkil A: enkelt; enkel _ enkel
duhtavaš A: tilfreds; fornøyd _ fornøyd
geasuheaddji A: attraktiv _ tiltrekkende
bivnnut A: attraktiv; populær _ omsvermet, godt likt
jearggalaš A: konsekvent; fornuftig; rasjonell _ fornuftig
garas A: streng; sterk; voldsom; hard _ hard
čavgat A: streng _ stram
goavvi A: streng; vanskelig _ hensynsløs
áddehahtti A: brukervennlig; forståelig _ forståelig
udju A: beskjeden _ sjenert
girjái A: variert; mangfoldig _ spraglet, flekket
dohkálaš A: forsvarlig _ høvelig, tjenlig
ráfálaš A: harmonisk; fredelig _ fredelig
soabalaš A: harmonisk; fredelig _ fredelig, forsonlig
olgguldas A: ekstern; ytre _ ytre, utvendig
roahkkat A: utadvendt; åpen _ freidig
čorgat A: ryddig _ renslig
ovddit A: fremre; foregående _ tidligere, foregående, forrige; fremre
ovddimus A: fremre; første _ først, fremst
bargonávccalaš A: yrkesaktiv _ arbeidsfør
heivvolaš A: hensiktsmessig; egnet; passelig _ passelig
ávkkálaš A: hensiktsmessig; nyttig _ nyttig; formålstjenlig
ovttalágan A: lik _ samme slags
seammalágan A: lik; tilsvarende _ likedan
dárbbašmeahttun A: unødig; unødvendig _ unødvendig
soddjil A: dynamisk; fleksibel _ bøyelig
bistevaš A: permanent; fast; langvarig _ varig, fast
bissovaš A: permanent; kronisk; fast _ vedvarende
njoahci A: sakte; sein; treg; sen _ sein, langsom
ođđaáigásaš A: tidsriktig; moderne _ moderne
moivvas A: forvirrende; uklar _ uklar, grumset
báhkas A: opphetet; varm _ varm
viiddis A: omfattende; vid; bred _ vid, utstrakt
alvvalaš A: offensiv _ energisk
bahá A: ond; alvorlig _ sint
gutneheapme A: uverdig; frekk _ frekk
árvvoheapme A: uverdig; vanskelig _ vanskelig, brysom; verdiløs
hearki A: utsatt; sårbar; svak _ øm, følsom
seammasullasaš A: tilsvarende; lignende _ lignende
sullasaš A: tilsvarende; liknende; lignende _ liknende
oskkáldas A: trofast; lojal _ pålitelig
ruđalaš A: finansiell; økonomisk; rik _ pengemessig; rik
gánnáhahtti A: bærekraftig; lønnsom _ lønnsom
bajimuš A: overordnet _ øverst
bajit A: overordnet; øvre _ øvre
válddálaš A: uttrykkelig; mektig; myndig _ mektig, myndig
váilevaš A: mangelfull; manglende _ manglende
sámegielat A: samisk _ samiskspråklig
elektrovnnalaš A: elektronisk _ elektronisk _ SAME
vuosttaš A: første; første _ først
vuosttas A: første; første _ først
ovddemus A: første _ først
vuosttamuš A: første _ først
fiinnis A: flott; fin _ fin
áddemeahttun A: uforståelig _ uforståelig _ SAME
áddetmeahttun A: uforståelig _ uforståelig _ SAME
almmolaš A: offisiell; offentlig _ offentlig, offisiell
beaktil A: næringsrik; effektiv _ næringsrik
álbmái A: næringsrik _ kraftig
boahtteáigásaš A: fremtidsrettet; fremtidig; framtidig _ fremtidsrettet, fremtidig
liekkas A: varm _ varm _ SAME
liekkus A: varm; hyggelig _ hyggelig, koselig
dearvvašlaš A: sunn _ sunn _ SAME
dearvvaslaš A: sunn _ sunn _ SAME
dearvvaš A: sunn; frisk _ frisk
dárki A: viss; sikker _ viss, sikker
dihto A: viss; bestemt _ viss
vissis A: viss; bestemt; sikker _ sikker; bestemt, viss
duihmi A: dum _ dum, tungnem
jalla A: dum _ dum _ SAME
doavki A: dum _ dum _ SAME
duođalaš A: alvorlig; høytidelig; reell _ alvorlig
ovddolaš A: underlig; merkelig _ underlig, merkelig
ártet A: underlig; merkelig; rar _ rar, merkelig
eaimmaskas A: underlig _ snodig, underlig
ealas A: livlig; kvikk; levende _ livlig, kvikk, energisk
virkui A: livlig; kvikk; vital _ kvikk, livlig
vitmat A: kvikk; skarp; dyktig _ lærenem, skarp
áŋgir A: flittig; ambisiøs; ivrig _ ivrig, flittig
viššal A: flittig; aktiv _ flittig
ealjár A: flittig; dyktig _ flittig
fasti A: stygg; fæl _ stygg, fæl
ropmi A: stygg _ stygg _ SAME
čáppat A: fin; pen; vakker _ pen
friddja A: fri _ fri _ SAME
friija A: fri _ fri _ SAME
luovus A: fri; løs _ løs, laus
veaittalas A: fri _ fri, på egen hånd
fuolaheapme A: likegyldig _ likegyldig _ SAME
headju A: dårlig; svak; negativ _ dårlig, skral
heittot A: dårlig; svak _ dårlig, svak
fuotni A: dårlig; svak; negativ _ dårlig
galmmas A: kald _ kald _ SAME
čoaskkis A: kald _ kjølig
geatnegas A: ansvarlig _ pliktig; ansvarlig
návccalaš A: sterk; dyktig _ sterk, dyktig
searalaš A: sterk; dyktig; selvstendig _ sterk, dyktig
gievra A: sterk; sterk; sterk _ sterk
nanus A: sterk _ solid, sterk
gárži A: smal; trang _ trang, smal
hiđis A: sein; sen _ sein
hutkái A: kreativ _ kreativ _ SAME
jegolaš A: lydig _ lydig _ SAME
siivui A: lydig; rolig; snill _ snill, rolig
suvrris A: sur; sur _ sur
jiesas A: sur _ sur, blåsur
lihkolaš A: heldig; lykkelig _ lykkelig, heldig
lámis A: ufør _ vanfør, ufør, lam
lášmat A: smidig; snar _ smidig, snar
miellagiddevaš A: interessant _ interessant _ SAME
movttet A: optimistisk; glad _ i godt humør, optimistisk
mášoheapme A: urolig _ rastløs, urolig
muoseheapme A: urolig _ urolig _ SAME
riekta A: rett; riktig; korrekt _ riktig
oanehaš A: kort _ kort _ SAME
ollislaš A: fullverdig; total _ fullverdig
ovttageardán A: naiv; ensidig; enkel _ enfoldig, naiv
ođas A: ny _ ny _ SAME
rabas A: åpen; ledig _ åpen
rehálaš A: hederlig; ærlig; rettferdig _ ærlig, hederlig
rákkis A: treg _ treg _ SAME
normála A: normal _ normal _ SAME
seksuálalaš A: seksuell _ seksuell _ SAME
sierra A: særskilt _ særskilt; adskilt
sivaheapme A: uskyldig _ uskyldig _ SAME
villas A: vill _ vill, vilter
vilddas A: vill _ ustyrlig, vilter
bastil A: skarp; kvass _ kvass
viđát A: femte _ femte _ SAME
vuollegaš A: lav _ lav _ SAME
unni A: lav; liten _ liten
váttis A: vanskelig _ vanskelig _ SAME
váivái A: vanskelig; ubehagelig _ vanskelig, ubehagelig
váigat A: vanskelig; kjedelig _ kjedelig, vanskelig
čavddis A: urørt _ tett, uten hull; urørt
čielggas A: tydelig; klar _ klar, tydelig
ekonomalaš A: økonomisk _ økonomisk _ SAME
sosiála A: sosial _ sosial _ SAME
olmmošlaš A: høflig; folkelig; menneskelig; grei _ høflig; menneskelig
čearddalaš A: etnisk _ etnisk _ SAME
etnalaš A: etnisk _ etnisk _ SAME
máŋggakultuvrralaš A: flerkulturell _ flerkulturell _ SAME
geavatlaš A: praktisk _ praktisk _ SAME
oainnus A: synlig _ synlig _ SAME
eaktodáhtolaš A: frivillig _ frivillig _ SAME
iešdáhtolaš A: frivillig _ forsettlig
eŋgelas A: engelsk _ engelsk _ SAME
eaŋgals A: engelsk _ engelsk _ SAME
oktonas A: ensom _ alene
buiga A: ekte _ ekte, virkelig
teknihkalaš A: teknisk _ teknisk _ SAME
ilolaš A: glad; gledelig _ gledelig
almmus A: tilgjengelig; offentlig _ offentlig
mearkkašahtti A: betydelig; påfallende; vesentlig _ betydningsfull
issoras A: enorm _ forferdelig
máŧoheapme A: enorm; umulig _ umulig
áibmadas A: enorm _ kolossal
gaskaboddosaš A: foreløpig; midlertidig _ midlertidig
jeagoheapme A: tverr _ ulydig
govdat A: stolt; bred _ brei, bred
čeavlái A: stolt _ overlegen, hoven
vuovdnái A: stolt _ pågående, energisk; staselig
ilgat A: voldsom _ nifs
stáđis A: stabil; fast _ stø, fast
otná A: dag _ dagens
otnáš A: dag _ dagens
mávssolaš A: verdifull; viktig _ dyrebar; viktig
muttát A: moderat; passelig; rimelig _ passelig
rašši A: sårbar; svak _ veik, skjør
agálaš A: uendelig; evig _ evig
jáhkehahtti A: troverdig _ trolig, sannsynlig
vuollásaš A: underliggende _ underlagt
imaš A: påfallende; merkelig; rar _ merkelig
risttalaš A: kristelig; kristen _ kristen
kristtalaš A: kristelig; kristen _ kristen
jaskat A: stille; rolig; taus _ rolig, stille, taus
boahtte A: kommende _ kommende _ SAME
boahttevaš A: kommende; fremtidig; framtidig _ kommende
dánskalaš A: dansk _ dansk _ SAME
dánska A: dansk _ dansk _ SAME
suorggahahtti A: skremmende _ skremmende _ SAME
seavdnjat A: mørk _ mørk _ SAME
čáhppesvarat A: mørk _ mørk _ SAME
ránis A: grå _ grå _ SAME
albma A: skikkelig _ ordentlig, skikkelig
alit A: blå _ blå _ SAME
allat A: høy _ høy, høg
amas A: fremmed; ukjent _ fremmed, ukjent
vieris A: fremmed _ fremmed _ SAME
asehaš A: tynn _ tynn _ SAME
njárbat A: tynn _ tynn; glissen
goiddas A: tynn; svak _ tynn, svak
bahča A: bitter _ bitter _ SAME
rihča A: bitter _ besk, bitter
baski A: trang _ trang _ SAME
bassi A: hellig _ hellig _ SAME
beaivválaš A: daglig _ daglig _ SAME
dovddus A: kjent _ kjent _ SAME
oahpis A: kjent _ kjent _ SAME
bealjeheapme A: døv _ døv, tunghørt
buoidi A: feit _ feit _ SAME
báikkálaš A: lokal _ lokal _ SAME
bávččas A: vond _ vond, smertefull
coagis A: grunn _ grunn _ SAME
dearvvas A: frisk _ frisk _ SAME
dehálaš A: viktig _ viktig _ SAME
deaŧalaš A: viktig _ viktig _ SAME
diehtemeahttun A: uvitende _ uvitende _ SAME
diehttalas A: naturlig _ viss, naturlig
lunddolaš A: naturlig _ naturlig _ SAME
dieđalaš A: vitenskapelig _ vitenskapelig _ SAME
linis A: myk _ myk _ SAME
dimis A: myk; mjuk _ myk, mjuk
divrras A: dyr; kostbar _ dyr, kostbar
dihtomielalaš A: bevisst _ bevisst _ SAME
diđolaš A: bevisst _ bevisst _ SAME
doaŋgi A: stiv _ stiv, støl, slapp
stirddas A: stiv _ stiv _ SAME
duhtameahttun A: misfornøyd _ misfornøyd _ SAME
duđavaš A: fornøyd _ fornøyd _ SAME
duiska A: tysk _ tysk _ SAME
duolbbas A: flat _ flat _ SAME
sieiva A: vanlig; ren _ vanlig, alminnelig
dárkil A: grundig _ nøyaktig, grundig
vuđolaš A: grundig; grunnleggende _ grundig, grunnleggende
earálágan A: annerledes; ulik; forskjellig _ ulik, forskjellig, annerledes
nuppelágan A: annerledes; forskjellig _ annerledes, forskjellig
unohas A: ubehagelig; uheldig _ uhøvelig, ubehagelig
eatnjehas A: ubehagelig _ ubehagelig, nifs
vahátlaš A: skadelig _ skadelig _ SAME
fiskat A: gul _ gul _ SAME
fágalaš A: faglig _ faglig _ SAME
fámolaš A: mektig _ mektig _ SAME
gallji A: vid _ vid, rommelig
gaskamearálaš A: gjennomsnittlig _ gjennomsnittlig _ SAME
suohkat A: tykk; frodig _ tjukk, tett
assái A: tykk _ tjukk
gassat A: tykk; dyp; dyp; grov _ tykk; dyp; dyp, grov
váfi A: tykk; svær; trygg; sikker; frodig _ svær, tjukk; sikker, trygg
čieŋal A: dyp _ dyp, djup
roakkas A: dyp; grov _ dyp, grov
roattus A: dyp; grov _ grov, dyp
roavis A: grov; rå _ grov
geafi A: fattig _ fattig _ SAME
healpu A: lett _ lett, lettvint
álki A: lett; enkel _ lett, lettvint
geahpas A: lett _ lett _ SAME
geahppat A: lett _ lett _ SAME
gelddolaš A: spennende _ spennende _ SAME
gierdameahttun A: utålmodig _ utålmodig _ SAME
giitevaš A: takknemlig _ takknemlig _ SAME
gillil A: utrettelig _ utrettelig, tålmodig
árjjalaš A: ivrig; aktiv _ ivrig, energisk
givas A: ivrig; modig _ ivrig, modig
goalmmát A: tredje _ tredje _ SAME
guorus A: tom; ledig _ tom
guovttegielat A: tospråklig _ tospråklig _ SAME
guovttegielalaš A: tospråklig _ tospråklig _ SAME
gurut A: venstre _ venstre _ SAME
guđát A: sjette _ sjette _ SAME
válmmas A: ferdig; klar _ ferdig, klar
gárvvis A: ferdig; klar _ ferdig
gávccát A: åttende _ åttende _ SAME
hávski A: morsom; hyggelig _ morsom, hyggelig
hearvái A: morsom _ herlig, morsom
hávskái A: morsom; hyggelig _ hyggelig, morsom
somá A: morsom; artig _ morsom, artig
vuogas A: passelig _ høvelig, passelig, behagelig
hirbmat A: svær _ svær _ SAME
hálbi A: billig; rimelig _ billig
hálddahuslaš A: administrativ _ administrativ _ SAME
smáđáhkis A: hyggelig; grei _ hyggelig
iešlágan A: merkelig _ merkelig, noe for seg selv
imašlaš A: merkelig _ merkelig _ SAME
jahkásaš A: årlig _ årsgammel; årlig
lodji A: rolig _ tam, rolig
jávoheapme A: taus _ taus _ SAME
jierpmálaš A: fornuftig _ fornuftig _ SAME
viissis A: klok _ klok, vis
joavdelas A: unødvendig _ unyttig, unødvendig
jorbat A: rund _ rund _ SAME
jáhkkemeahttun A: utrolig _ utrolig _ SAME
luovos A: løs _ løs _ SAME
loažžat A: løs _ slapp, løs
lobiheapme A: ulovlig _ ulovlig _ SAME
lobálaš A: lovlig _ lovlig _ SAME
logát A: tiende _ tiende _ SAME
máizzas A: lunken _ lunken _ SAME
loikkas A: lunken _ lunken _ SAME
lossat A: tung _ tung _ SAME
mánnálaš A: barnslig _ barnslig _ SAME
mánálaš A: barnslig _ barnslig _ SAME
veadjemeahttun A: umulig _ umulig _ SAME
máŧolaš A: mulig _ mulig _ SAME
vejolaš A: mulig; eventuell _ mulig
njealját A: fjerde _ fjerde _ SAME
njuoskkas A: våt; rå _ våt, bløt
njálmmálaš A: muntlig _ muntlig _ SAME
nuorra A: ung _ ung _ SAME
nuoski A: urenslig _ urenslig _ SAME
oarbbis A: foreldreløs _ foreldreløs _ SAME
oktasaš A: felles _ felles _ SAME
olgeš A: høyre _ høyre _ SAME
oppalaš A: generell; total _ generell
obbalaš A: generell; total _ generell, fullstendig
ovccát A: niende _ niende _ SAME
vuoigat A: riktig _ åpenhjertig; riktig
historjjálaš A: historisk _ historisk _ SAME
politihkalaš A: politisk _ politisk _ SAME
ruoksat A: rød _ rød _ SAME
ruoná A: grønn _ grønn _ SAME
ruonas A: grønn _ grønn _ SAME
ruosttas A: rusten _ rusten _ SAME
ruošša A: russisk _ russisk _ SAME
loahpalaš A: endelig _ endelig _ SAME
ráhkis A: kjær _ kjær _ SAME
ráhpat A: flink _ bra, flink
čeahppi A: flink; dyktig _ flink
ránska A: fransk _ fransk _ SAME
šiega A: snill _ snill _ SAME
siskkáldas A: intern _ det indre, innbyrdes, intern
sitkat A: seig _ seig, utholdende
áššálaš A: skyldig; saklig _ skyldig, tiltalt
sujalaš A: skyldig _ skyldig _ SAME
sivalaš A: skyldig _ skyldig _ SAME
velggolaš A: skyldig _ skyldig _ SAME
smávis A: liten _ liten _ SAME
uhcci A: liten _ liten _ SAME
čiegus A: hemmelig _ hemmelig _ SAME
suollemas A: hemmelig _ hemmelig _ SAME
diehtoáŋgir A: nysgjerrig _ nysgjerrig _ SAME
sáhkkái A: nysgjerrig _ nysgjerrig; snakkesalig
sáhkkii A: nysgjerrig _ nysgjerrig; snakkesalig
varas A: fersk _ fersk _ SAME
vielgat A: hvit _ kvit, hvit
váimmolaš A: hjertelig _ hjertelig _ SAME
váralaš A: farlig _ farlig _ SAME
várálaš A: farlig _ farlig _ SAME
ábolaš A: nyttig _ nyttig _ SAME
árbevirolaš A: tradisjonell _ tradisjonell _ SAME
čalmmeheapme A: svaksynt _ blind, svaksynt
čihččet A: sjuende; syvende _ sjuende
čuovvovaš A: følgende _ følgende _ SAME
čáhppat A: svart _ svart _ SAME
čálalaš A: skriftlig _ skriftlig _ SAME
čáppis A: pen; vakker _ pen, vakker
kultuvrralaš A: kulturell _ kulturell _ SAME
gullevaš A: tilhørende _ tilhørende _ SAME
šállošahtti A: beklagelig _ beklagelig _ SAME
váidalahtti A: beklagelig _ beklagelig _ SAME
dalá A: daværende _ daværende _ SAME
persovnnalaš A: personlig _ personlig _ SAME
dáiddalaš A: kunstnerisk _ kunstnerisk _ SAME
berošteaddji A: interessert _ interessert _ SAME
vuolit A: nedre _ nedre _ SAME
ovttajienalaš A: enstemmig _ enstemmig _ SAME
ivdnái A: fargerik _ fargerik _ SAME
gonagaslaš A: kongelig _ kongelig _ SAME
girkolaš A: kirkelig _ kirkelig _ SAME
mánnosaš A: månedlig _ månedlig _ SAME
sávahahtti A: ønskelig _ ønskelig _ SAME
vahkkosaš A: ukentlig _ ukentlig _ SAME
botniheapme A: bunnløs _ bunnløs _ SAME
gráfalaš A: grafisk _ grafisk _ SAME
klassihkalaš A: klassisk _ klassisk _ SAME
veahkkái A: hjelpsom _ hjelpsom _ SAME
láittas A: kjedelig _ kjedelig _ SAME
doaresfágalaš A: tverrfaglig _ tverrfaglig _ SAME
eanaš A: mange _ det meste, de fleste
eanas A: mange _ det meste
máilmmiviidosaš A: global _ global _ SAME
fávru A: vakker _ skjønn, vakker
hámálaš A: vakker _ staselig, vakker
ovttabealat A: ensidig _ ensidig _ SAME
bivval A: mild _ mild _ SAME
láđis A: mild _ mild, blid
láivi A: mild; svak; svak _ svak
rikkis A: rik _ rik _ SAME
boandái A: rik _ rik _ SAME
boaris A: gammel _ gammel _ SAME
vuoras A: gammel _ gammel _ SAME
ovddeš A: gammel; tidlig _ tidligere
dološ A: gammel _ gammeldags
ollis A: full; hel _ hel, full
dievaslaš A: full _ fullstendig
dievas A: full _ full, fullstendig
oadjebas A: trygg; trygg _ trygg
dorvvolaš A: trygg; trygg; sikker _ trygg, tillitsfull
sihkar A: trygg; trygg; sikker; sikker _ sikker
dárbbašlaš A: nødvendig _ nødvendig _ SAME
vealtameahttun A: nødvendig _ uunngåelig
geamus A: uklar _ uklar, disig
iešguđetlágan A: ulik; forskjellig _ forskjellige slags
sierranas A: forskjellig _ atskilt
jođán A: rask; snar _ hurtig, rask
johtil A: rask; snar _ hurtig
valli A: rask _ hurtig, rask
guovddáš A: sentral _ sentral _ SAME
stánddalaš A: dyktig; stødig _ stødig, dyktig
fávdnát A: dyktig _ bra, dyktig
geahnoheapme A: svak _ udugelig, svak
čuorbi A: svak _ klønete, udugelig
šiervi A: svak _ spinkel, svak
sealvi A: klar _ klar, normal
gearggus A: klar _ klar _ SAME
šearrat A: klar _ blank, klar
girkat A: klar _ klar, skinnende
geažos A: hel _ hel _ SAME
oppa A: hel _ hel, all
duostil A: modig _ dristig
váibmui A: modig _ modig _ SAME
guhkki A: lang _ lang _ SAME
gummá A: rar _ rart
guovttegeardásaš A: dobbel _ dobbel _ SAME
háhppil A: snar _ kjapp, snar
iešheanalaš A: selvstendig _ selvstendig _ SAME
iešráđálaš A: selvstendig; uavhengig _ egenmektig, selvstendig
jalgat A: jevn _ slett, jevn
lagas A: nær _ nærliggende, nær
lagaš A: nær _ nær _ SAME
molssaevttolaš A: alternativ _ alternativ _ SAME
riikkaidgaskasaš A: internasjonal _ internasjonal _ SAME
internationála A: internasjonal _ internasjonal _ SAME
gaskariikkalaš A: internasjonal _ internasjonal _ SAME
ráinnas A: ren _ rein, ren
buhtis A: ren _ rein
rávis A: voksen _ voksen _ SAME
eallilan A: voksen _ godt voksen, som har levd en stund
stuoris A: stor _ stor _ SAME
stuorebuš A: stor _ litt større
luohttevaš A: stødig _ tillitsfull
vuoiggalaš A: rettferdig _ redelig
vánhurskkis A: rettferdig _ gudfryktig; rettferdig
árrat A: tidlig _ tidlig _ SAME
positiivvalaš A: positiv; positiv _ positiv
positiiva A: positiv; positiv _ positiv
negatiiva A: negativ; negativ _ negativ
eahpesihkar A: usikker _ usikker _ SAME
dorvvuheapme A: usikker _ motløs
nationála A: nasjonal; nasjonal _ nasjonal
govttolaš A: rimelig _ rimelig _ SAME
sorjjasmeahttun A: uavhengig _ uavhengig _ SAME
formálalaš A: formell _ formell _ SAME
priváhta A: privat _ privat _ SAME
maŋit A: sist _ bakre
hillján A: sen _ langsom, makelig
áigeguovdil A: aktuell _ tidsaktuell
guoskevaš A: aktuell _ angående
oskkolaš A: religiøs _ troende
duohta A: reell _ sann
lihkoheapme A: uheldig _ ulykkelig
dávggas A: fleksibel _ elastisk, spenstig
juohkelágan A: allsidig _ allslags
dássásaš A: likeverdig _ jevnbyrdig; jevnhøy
bolffas A: frodig _ lodden
