rohkki N: avdød _ avdød _ SAME
čoahkkináigi N: møtesekvens; møtetidspunkt _ møtetid
njiŋŋálas N: hunnlaks _ hunndyr, av hunkjønn
šibitdállu N: gardsdrift _ gårdsbruk med husdyr
prográmmafálaldat N: programtjeneste; programtilbud _ programtilbud
oahpahusguovddáš N: utdanningsenhet; utdanningssentral; utdanningssentrum; utdanningssenter _ undervisningssenter
mánáidgárdeláhka N: barnehagetjeneste; barnehagelov _ barnehagelov
beaivedikšu N: omsorgsdøgn _ dagpleie
badjemánná N: reindriftsunge; flyttsamebarn; reindriftsbarn _ reindriftsbarn
telefonoktavuohta N: telefonforbindelse; telefonkontakt _ telefontilknytning
máksinnákca N: betalingsevne; likviditetsforvaltning; likviditet _ likviditet
johtolatplána N: jernbanebevilgning _ trafikkplan
dáiddaoahppu N: kunstutdannelse; kunstutdanning _ kunstutdanning
duodječájáhus N: sløydutstilling _ duodjiutstilling
festiváladoarjja N: festivaltilskudd; festivalstøtte _ festivalstønad
diibmu N: lønnsslipp; time _ time; ur, klokke
ráđđehusovttasbargu N: regjeringssamarbeid _ regjeringssamarbeid _ SAME
njealjejuvllat N: terrengsykkel; firhjuling _ firehjulssykkel
oalgecealkka N: leddsetning _ bisetning
lotnolasealáhus N: næringskombinasjonsavtale; næringskombinasjon _ næringskombinasjon
boazu N: miniatyrrein; reinsdyr; rein _ rein, reinsdyr
oljoopmodat N: oljeformue _ oljeressurser
prinsihppadigaštallan N: prinsippdiskusjon _ prinsippdebatt
gihpa N: studiehefte; brosjyre; hefte _ hefte
luonddunamahus N: naturbetegnelse _ naturbenevnelse
fuolkevuođanamahus N: slektskapsbenevnelse _ slektsskapsbenevnelse
rámmajuolludeapmi N: rammetilskudd; rammeoverføring _ rammebevilgning
rámmadoarjja N: rammetilskudd _ rammestøtte
jienastuslohku N: samemanntall; manntall; valgmanntall _ manntall, valgmanntall
válljenmunni N: valgmulighet; utvalg _ utvalg
oahpposadji N: læreplass; studieplass; plass _ studieplass
riikkasearvi N: landsforbund; riksforbund _ landsforening
giellabeassi N: språkleir; språkreir _ språkreir
ovddasvástádussuorgi N: ansvarsområde _ ansvarsfelt
kulturlávdegoddi N: kulturkomite _ kulturkomité
servodatsuorgi N: samfunnsområde; samfunnssektor _ samfunnssektor
iskkus N: prøveuttak; prøve; undersøkelse _ prøve
válgalávdegoddi N: valgkomite _ valgkomité
bargomátki N: tjenestereise _ arbeidsreise
doarjja N: støttespiller; tilskudd; bidrag; støtte; støtte _ stønad; støtte
dáiddaguovddáš N: kunstnersenter _ kunstsenter
badjesápmelaš N: reindriftsame; reindriftssame _ reindriftssame
boazosápmelaš N: reindriftsame; reindriftssame _ reindriftssame
ealáhuslávdegoddi N: næringskomite; næringskomité _ næringsutvalg, næringskomité
guovllukantuvra N: regionkontor; områdekontor; underkontor; distriktskontor _ distriktskontor, regionskontor
rápmaeaktu N: rammevilkår; rammebetingelse _ rammebetingelse
rámmaeaktu N: rammevilkår; rammebetingelse _ rammebetingelse
ovttasbargoguoibmi N: samarbeidspart; samarbeidspartner _ samarbeidspartner
prošeaktadoarjja N: prosjektstøtte _ prosjektstønad
ássanguovlu N: bosettingsområde; bosetningsområde _ bosetningsområde
oktasaščoavddus N: pakkeløsning; fellesløsning _ fellesløsning
biebmoávnnas N: næringsstoff; næringsmiddel _ næringsmiddel
bivdokultuvra N: fangstkultur _ jaktkultur
veahkaváldi N: voldsutøver; makt; vold; overgrep _ vold, makt, overgrep
gámasuoidni N: sennagress; sennegras _ sennegress
valáštallansuorgi N: idrettsgren; idrettsområde _ idrettsgrein
bearjjas N: vindskjul _ røykskjerm
kulturdeaivvadeapmi N: kulturmøte _ kulturtreff
gávpotstivra N: bystyregruppe; bystyre _ bystyre
fápmodilli N: maktstilling; kraftsituasjon _ styrkeforhold
leansmánnibálvá N: lensmannsfullmektig _ lensmannsbetjent
govvačájáhus N: bildeutstilling _ billedutstilling
boazodávda N: reinsjukdom; reinsykdom _ reinsykdom
jugešvuohta N: misbruksproblem; alkoholmisbruk _ drukkenskap
investerendoarjja N: investeringstilskudd; investeringsstøtte _ investeringsstønad
matematihkkagirji N: matematikkverk _ matematikkbok
álgoálbmotguovlu N: urfolksregion; urfolksområde _ urbefolkningsområde
vealaheapmi N: forskjellsbehandling; diskriminering _ diskriminering
deaivvadanbáiki N: møtested; møteplass _ treffsted
stáhtadoarjja N: statstilskudd _ statsstøtte
buvttadandoarjja N: produksjonstilskudd; produksjonsstøtte _ produksjonsstøtte
bargovuohki N: arbeidsform; arbeidsmåte; arbeidsmetode; prosedyre _ arbeidsmetode; prosedyre
lassiealáhus N: tilleggsnæring _ attåtnæring, bierverv
orohatjuohkin N: distriktsinndeling _ reinbeitedistriktsinndeling
gáicadoallu N: geitbruk; geitehold _ geitebruk
lohkkiidčálus N: leserinnlegg _ leserbrev
prográmmadoaibma N: programaktivitet; programvirksomhet _ programvirksomhet
oamastanvuoigatvuohta N: eierrettighet; eiendomsrett _ eiendomsrett
bealdu N: jordbearbeiding; innmark _ åker
kulturdoarjja N: kulturstøtte _ kulturstønad
gássabohkan N: gassutvinning _ gassboring
oahpahusministtar N: utdanningsminister _ undervisningsminister
ovddidandoarjja N: utviklingstilskudd _ utviklingsstønad
oahpahuspolitihkka N: opplæringspolitikk; utdanningspolitikk _ utdanningspolitikk
eamiálbmotguovlu N: urfolksområde _ urbefolkningsområde
dárkkistanlávdegoddi N: revisjonsutvalg; kontrollkomité _ kontrollkomité
nákkosgirji N: doktorgradsavhandling; doktoravhandling _ doktoravhandling
eanetlohkoráđđehus N: flertallsregjering _ flertallsregjering _ SAME
vearrodássi N: skattenivå _ skattenivå _ SAME
giellaváttisvuohta N: språkvanske; språkproblem _ språkproblem
boazodoallošiehtadallan N: reindriftsavtaleforhandling; reindriftsforhandling _ reindriftsforhandling
lohkanmearri N: pensumlitteratur; pensum _ pensum
bivdoguovlu N: fiskeområde _ fangstområde
niitu N: utmarksslått _ natureng
buohccedivššár N: sykesøster; sykepleier _ sykepleier
jienastanvuohki N: avstemningsmåte _ voteringsprosedyre
doarjjaortnet N: tilskuddsordning; støtteordning _ støtteordning
nissonoassi N: kvinneandel _ kvinneandel _ SAME
giehtaduodji N: håndverksprodukt; håndarbeid; håndverk _ håndarbeid
boazodoallohoavda N: reindriftssjef _ reindriftssjef _ SAME
mánáidgárdefálaldat N: barnehagedekning; barnehagetilbud _ barnehagetilbud
oahppodilli N: undervisningssituasjon; opplæringssituasjon _ læresituasjon
sátnegeavaheapmi N: begrepsbruk _ ordbruk
birasgáhttenossodat N: miljøvernavdeling _ miljøvernenhet
konvoluhtta N: omslagskonvolutt; konvolutt _ konvolutt
ovdanamma N: personnavn; fornavn _ fornavn
stáhtafápmu N: statsmakt _ statsmakt _ SAME
álgoálbmotguovddáš N: urfolksenter; urfolkssenter _ urfolkssenter
čearda N: stammefolk; art _ art
oahppofálaldat N: opplæringstilbud; studietilbud; utdanningstilbud; undervisningstilbud _ undervisningstilbud
oktasašskuvla N: fellesskole; enhetsskole _ enhetsskole
válgavuohki N: valgordning _ valgprosedyre
válgaortnet N: valgordning _ valgordning _ SAME
kulturviessu N: kulturbygg; kulturhus _ kulturhus
bággonjuovvan N: tvangsslakting _ tvangsslaktning
giellaruhta N: språkmiddel _ språkpenger
eamiálbmotvuoigatvuohta N: urfolksrettighet _ urbefolkningsrettighet
álgoálbmotvuoigatvuohta N: urfolksrettighet _ urbefolkningsrettighet
boazodoallohálddahus N: reindriftsforvaltning _ reindriftsadministrasjon
oahppolávdegoddi N: utdanningskomite _ studieutvalg
eamiálbmot N: urfolk _ urbefolkning
álgoálbmot N: urfolk _ urbefolkning
bargoeaktu N: arbeidsvilkår _ arbeidsbetingelse
oahpahusdepartemeanta N: undervisningsdepartement _ utdanningsdepartement
muohtačalbmi N: snøkrystall _ snøfnugg
turistabáiki N: turistattraksjon _ turiststed
datneárpu N: metalltråd _ tinntråd
gurutbellodat N: venstreparti _ venstreparti _ SAME
riikkarádji N: landegrense _ riksgrense
njuovvanboazu N: slaktedyr; slakt _ slakterein
skuvlavisti N: skolehus; skolebygg; skolebygning _ skolebygning
skuvlamátki N: skoleveg; skoletur _ skoletur
dálkkas N: medikament; legemiddel; medisin _ medisin
bealljelasta N: øreflipp _ det ytre øre
juovlanigá N: nisse; julenisse _ julenisse
báikkálašsearvi N: lokallag; lokalforening _ lokalforening
garraduodji N: trearbeid; tresløyd _ sløyd
lihkusávaldat N: gratulasjon _ lykkeønskning
láhttenvuohki N: handlemåte; adferd _ oppførsel
areálaplána N: arealplan _ arealplan _ SAME
huksenbargu N: byggearbeid _ byggearbeid _ SAME
riikkačoahkkin N: riksmøte; landsmøte _ landsmøte
čuohtejahki N: hundreår; århundre _ århundre
álbmotstivra N: folkestyre _ folkestyre _ SAME
fágaolmmoš N: fagfolk _ fagperson
luonddugáhtten N: naturvern; miljøvern _ miljøvern
politiijabálvá N: politimann _ politibetjent
dutkkus N: studie; eksamen _ eksamen
niesti N: skolemat _ niste
guohtuneana N: beiteområde _ beiteland, beiteareal
ámmát N: verv; embete; stilling _ embete, stilling
bargodilli N: arbeidssituasjon; arbeidsliv; arbeidsforhold _ arbeidsforhold
spiidni N: purk; gris; svin _ gris, svin
viellja N: storebror; søsken _ bror
moarri N: affekt _ vrede, raseri
njálggis N: godteri _ slikkeri
čoalli N: innvoll; tarm _ tarm; lengden på garnets øverste del
sáttu N: singel; sand _ sand
unnimusmearri N: minimumsfaktor; minstestandard _ minimum; minstestandard
biergobihttá N: kjøttbit; kjøttstykke _ kjøttstykke
dákti N: knokkel; bein _ bein
šlápma N: ståhei; støy _ støy, larm
bátni N: tannsett; tann _ tann
ođđabeairuohtta N: nyttårskveld _ nyttårsaften
vađđa N: sletteland; slette _ åpen slette med skog rundt
máttaráddjá N: tippoldefar _ oldefar, stamfar
jumeš N: tvillingpar; tvilling _ tvilling
lubma N: lom _ lomme
hearva N: pryd _ stas, pynt
superlatiiva N: superlativ _ superlativ _ SAME
biebmodilli N: ernæringssituasjon; matsituasjon; kosthold _ matsituasjon
lavdnjegoahti N: jordgamme; torvgamme _ torvgamme
lávka N: ryggsekk _ ransel; bag
sieđga N: vier _ vidje
boradanboddu N: matpause _ spisepause
boaresbárdni N: ungkar _ gammelungkar
náhkkebivttas N: pels _ skinnplagg
galmmihanrusttet N: fryseanlegg _ kjøleanlegg
bárehuoš N: guttunge _ halvvoksen gutt
visti N: paviljong; hus; bygning _ hus, bygning
soggi N: ytterkant _ plass innerst ved veggen
mearrajohtolat N: skipsfart; sjøfart; sjøtransport _ sjøtrafikk
vázzinsoabbi N: spaserstokk _ gåstav
váikkuheapmi N: medvirkning; påvirkning; innflytelse _ påvirkning
láhtti N: gulv; golv _ golv
inuihtta N: inuitt _ inuit
lassá N: terskel; dørstokk _ dørstokk; firkantet ramme av tre
uksabealis N: terskel _ dørkarm, plassen ved siden av døra
šielbmá N: terskel; dørstokk _ dørstokk
bealátkeahtesvuohta N: habilitet _ ugildhet
hehttehus N: hinder; ulempe; hindring _ hindring
gonagas N: kong _ konge
geinnodat N: trase _ flyttevei
šillju N: tun; plass _ gårdsplass; plass
oalgi N: nisje _ skulder
feaskkir N: korridor; gang _ bislag, entre, gang
vuoibmi N: kondisjon; makt; styrke _ styrke, makt
hivvodat N: volum; masse _ mengde, masse
opmodatvearru N: formuesskatt; formueskatt _ formueskatt
dearvvuohta N: hilsen _ hilsning
materiála N: materiell; materiale _ materiale
ruonas N: grønt _ grønnsak
caggi N: barriere; bærebjelke; støtte _ støtte, avstiver
bagadeapmi N: instruksjon; veiledning _ rettledning
ávvu N: jubileum; begeistring _ fryd
suohkanbáhppa N: sogneprest; sokneprest _ sokneprest
almmuheapmi N: utgivelse _ offentliggjøring
beavdeliidni N: duk _ bordduk
suhttu N: aggresjon; sinne _ sinne
veajet N: yngel _ fiskeyngel
stohpogálvu N: innbo; inventar; møbel _ møbel
soadji N: ving _ vinge; erme; fløy
oktavuohta N: samhold; forbindelse; fellesskap; tilknytning _ forbindelse, kontakt
eallineaktu N: livsvilkår; levevilkår; levekår _ levevilkår
ođđajahki N: nyår _ nyttår
bázahus N: avfall; rest; levning; slam _ rest
guhkkodat N: lengde _ utstrekning
oaivvuš N: utløp _ elveos, elveutløp
duođalašvuohta N: virkelighet; alvor _ alvorlighet
finnmárkulaš N: finnmarking _ finnmarksværing
huksen N: utbygging; bygg; bygging _ bygging
čilgehus N: redegjørelse; definisjon _ forklaring
dihtor N: pc; data; datamaskin _ datamaskin, computer
beaggin N: omdømme _ rykte
áigemearri N: frist _ tidsfrist
dieđihanáigemearri N: frist; påmeldingsfrist _ påmeldingsfrist
duktásadji N: tuft; hustuft _ hustuft; tomt
márkanbáiki N: markedsplass; kirkested _ kirkested
fidnodoaibma N: yrkesaktivitet _ yrkesforetak
mearreáigi N: åremål _ termin
meardi N: merd _ ruse
láse N: glas; vindu; glass _ glass, vindusrute
oaivámuš N: høvding _ overhode
giliviessu N: grendehus _ bygdehus
herven N: dekorasjon; ornamentikk _ ornamentikk
neahpi N: nevø _ onkelbarn; manns nevø eller niese
gárvu N: klær _ klesplagg
bivttas N: klær _ klesplagg
oktiigullevašvuohta N: solidaritet; samhørighet _ tilhørighet
ovttaseallin N: sameksistens; samliv _ samliv
einnostus N: preg; spådom; prognose _ spådom; prognose
gollu N: bekostning; kostnad; slitasje; utgift _ kostnad; slitasje
stašuvdna N: base _ stasjon
jeagil N: lav _ reinlav
gorži N: vannfall; foss _ foss
čálgu N: velvære; trivsel; velferd _ trivsel; velferd
siepman N: spir; sæd _ frø, sæd
prentehus N: trykkeri; trykking; opplag _ trykking
váldolávdegoddi N: hovedutvalg _ hovedkomité
boallu N: tast _ knapp
noaidi N: noaide _ sjaman
válla N: vald; skrål _ bråk, skrål
báikegoddi N: lokalsamfunn _ grend; landdistrikt
ráŋggáštus N: sanksjon; straff _ straff
álbmotallaskuvla N: folkehøyskole _ folkehøgskole
nammačuorvun N: opprop; navneopprop _ navneopprop
čikŋa N: dekor _ pynt, stas
gávpegálvu N: konsern _ handelsvare
mánná N: småbarn; barn _ barn
lastamuorra N: lauvskog _ løvtre
šibitdoavttir N: veterinær; dyrlege _ dyrlege
diggeriekti N: tingsrett; tingrett _ tingrett
sátnevájas N: ordspråk; ordtak _ ordtak
earru N: skille; skilsmisse; avskjed _ avskjed; skilsmisse
gihppu N: sett _ bunt, klase
ládju N: slått; høyslått _ slåttonn
fággi N: ankerfeste _ ryggtak
fális N: hval _ kval
kruvdno N: kr.; krone _ krone
dávvirvuorká N: musé; museum _ museum; lager, oppbevaringssted
musea N: musé; museum _ museum
johtolat N: ferdsel; trafikk _ flyttevei; trafikk
vuodjin N: ferdsel; kjøring _ kjøring
buhtadus N: kompensasjon; godtgjørelse; erstatning _ erstatning
mátki N: reis; reise _ reise
snihkkár N: håndverker; snekker _ snekker
rihtu N: ras; storm _ skred
uđas N: ras _ snøskred
kilomehter N: km; kilometer _ kilometer
guovddáš N: sentral; senter _ sentrum, senter
rievssatbivdu N: rypefangst _ rypejakt
riegádanbeaivi N: fødselsdato; fødselsdag _ fødselsdag
servodatoahppu N: samfunnskunnskap; samfunnsfag _ samfunnsfag
mánnabiigá N: barnepass _ barnevakt
dáhpi N: sedvane _ skikk
vierru N: sedvane; rutine _ skikk, vane; rutine
ovttaskasolmmoš N: enkeltperson; enkeltmenneske _ enkeltmenneske
eaŋkilolmmoš N: enkeltperson; enkeltmenneske _ enkeltmenneske
čállinvuohki N: ortografi; skrivemåte _ skrivemåte
mearrabivdu N: sjøfiske; fiske _ fiske
fievru N: transportmiddel; framkomstmiddel; kjøretøy _ framkomstmiddel
erenoamášvuohta N: spesialitet; særpreg _ eiendommelighet; særpreg
ruhtadeapmi N: finans _ finansiering
muorra N: trevirke; brensel; tre _ tre; ved
davvisámegiella N: nordsamisk _ nordsamisk _ SAME
dokumentára N: dokumentarfilm; dokumentar _ dokumentar
areálageavaheapmi N: arealbruk _ arealdisponering
bargoveahka N: stab; personell _ arbeidsstyrke
dávgeruohtu N: parentes _ parentes _ SAME
ruohtu N: parentes _ parentes _ SAME
bánno N: kjele; kjel _ steikepanne
teáhterčájálmas N: teaterstykke; teaterforestilling _ teaterforestilling
fágadoaba N: faguttrykk; fagterm _ fagterm
háhkan N: anskaffelse; rekruttering _ erverv; rekruttering
muorraduodji N: tresløyd _ sløyd
dállu N: småbruk; gård; hus _ gård; hus
goikket N: skalle _ skalle sydd av leggskinn
nuvttot N: skalle _ skalle sydd av leggskinn
finánsalávdegoddi N: finanskomité _ finansutvalg
rehkenastin N: oppgjør; beregning; regning _ det å regne sammen
geatnegasvuohta N: forpliktelse; plikt; ansvar _ plikt; ansvar
allaskuvlaoahppu N: høyskoleutdanning; høgskoleutdanning _ høgskoleutdanning
oljobohkan N: oljeproduksjon; oljevirksomhet; oljeutvinning _ oljeboring
válgaboađus N: valgoppgjør; valgresultat _ valgresultat
vuođđooahppu N: grunnopplæring; grunnutdanning _ grunnutdanning
astoáiggedoaibma N: fritidsinteresse; fritidsaktivitet _ hobby, fritidssyssel
giellaoahpahus N: språkopplæring _ språkundervisning
hárjehallan N: øving; øvelse; prøve; trening _ trening; prøve
sátnefriddjavuohta N: ytringsfrihet _ ytringsfrihet _ SAME
fidnooahppu N: yrkesutdanning; yrkesopplæring _ yrkesopplæring
gaskaoapmi N: virkemiddel; middel; redskap; verktøy _ middel
joatkka N: videreføring _ forlenger
njuikun N: vevgrind _ hopping; grindvev
árvolassáneapmi N: verdiskapning; verdiskaping _ verdiskaping
árvu N: verdighet; status; verdi _ verdi, verd; status
buresbirgejupmi N: velstand; velferd _ velferd
geaidnočuovga N: vegbelysning _ gatelys
gáivo N: vannbrønn; brønn _ brønn
dorvvuhisvuohta N: utrygghet _ motløshet
eretfárren N: utflytting; fraflytting _ fraflytting
stuibmi N: urolighet; opprør _ bråk; opprør
bargonávccahisvuohta N: uførhet _ arbeidsuførhet
unohasvuohta N: ubehag _ ubehagelighet
hirsa N: tømmer _ tømmerstokk
dimbbar N: tømmer _ tømmerstokk
čulku N: tvangstrøye _ kubbe
bárru N: tsunami; bølge _ bølge
smáhkkomuorra N: trestamme _ hoggestabbe
guovttegielalašvuođaruhta N: tospråklighetsmiddel _ tospråklighetspenger
lohpádus N: tilsagn _ løfte
heiveheapmi N: tilrettelegging; tilpasning _ tilpassing
leahttu N: tempo _ fart
leaktu N: tempo _ fart, hastighet
govvaráidu N: tegnefilm; tegneserie _ tegneserie
duostilvuohta N: tapperhet; mot _ mot
báhčinguovlu N: skytefelt _ skyteområde
báhčinšillju N: skytefelt _ skytebane
huikkas N: skrik; skrål _ vedvarende roping
earráneapmi N: skillsmisse; skilsmisse _ skilsmisse
vearrogeasus N: skattefradrag; skattetrekk _ skattetrekk
vuotta N: skallebånd; komagbånd _ komagbånd
iešgovva N: sjølbilde; selvbilde _ selvbilde
iešstivrejupmi N: selvstyre; autonomi _ autonomi
iešdieđáhus N: selvangivelse; egenerklæring _ egenmelding
oktiibidjan N: sammensetning _ sammenføyning
áššesuorgi N: saksområde; saksfelt _ saksområde
boraspirevahát N: rovvilttap; rovdyrskade _ rovdyrskade
riektedilli N: rettsforhold; rettsstilling _ rettsstilling, rettslig stilling
vuorru N: rekkjefølgje; omgang; rekkefølge _ tur, omgang; skift
mátkeealáhus N: reiseliv; turistnæring _ turistnæring
geahpádus N: reduksjon; lettelse _ lettelse, minskning
rehálašvuohta N: redelighet _ redelighet, ærlighet
nállevealaheapmi N: rasediskriminering; rasisme _ rasisme
cuiggodeapmi N: påpekning; merknad; kritikk _ påpeking, kritikk
muittuhus N: påminnelse _ påminning
áŋgirvuohta N: pågangsmot; innsatsvilje; iver; motivasjon _ iver
hearvabáddi N: pyntebånd; pynteband _ pynteband
uvssot N: portal _ teltdør
máŋggaidlohku N: pluralitet; pluralis; flertall _ flertall, pluralis
čuokkis N: pkt.; punkt _ prikk, punkt, punktum; poeng
geađgejuolgi N: pilar; plattform _ grunnmur
searvevuohta N: partnerskap; fellesskap _ fellesskap
bealli N: part; del _ del, halvpart
oasálaš N: part; aktør; deltaker _ medvirkende, partisipant, deltaker; deleier
geahčastat N: oversikt _ blikk, øyekast
sátneriggodat N: ordrikdom; ordforråd _ ordforråd
lášmmohallan N: opptrening; kroppsøving; kroppsøvning; gymnastikk _ gymnastikk
lohkan N: opptelling; lesing _ lesing
bargojuohku N: oppgavefordeling; arbeidsdeling _ arbeidsdeling
bargojuogadeapmi N: oppgavefordeling _ arbeidsfordeling
heahtedilli N: nødsituasjon; krise _ krise, nødssituasjon
váimmus N: nav; kjerne _ marg i tre; kjerne
moalla N: målstrek; mål _ mål, blink
njálbmi N: munning _ munn
multimedia N: multimedium _ multimedia
balaheapmi N: mistenksomhet _ sjalusi
muitoboddu N: minnemarkering; minnestund _ minnestund
meassut N: messe _ festlighet
dieđihangaskaoapmi N: medium _ media
mielmearrideapmi N: medbestemmelse _ medbestemmelse _ SAME
biebmogálvu N: matprodukt; matvare; næringsmiddel _ næringsmiddel
biebmogoallus N: matkjede; næringskjede _ næringskjede
lastagoahti N: løvhytte _ løvløe
oahppaplána N: læreplan _ læreplanverk
oahppoplána N: læreplan; studieplan; læreplanverk _ studieplan
geahpesdávda N: lungelidelse; kols _ lungesykdom
ovttadássásašvuohta N: likeverdighet; likeverd; likestilling _ likestilling
dásseárvu N: likeverd; likestilling _ likestilling
fuollameahttunvuohta N: likegyldighet _ grov uaktsomhet
leaksoveahkki N: leksehjelper; leksehjelp _ leksehjelp
láigošiehtadus N: leieavtale; festekontrakt _ leiekontrakt; festekontrakt
láigosoahpamuš N: leieavtale _ leiekontrakt
bargguhisvuohta N: ledighet; arbeidsledighet _ arbeidsløshet
čoarvegiella N: lassoløkke _ lassoring av horn, hornøgle
riikkadássi N: landsbasis _ riksplan
earri N: kvote _ mengde
bivdoearri N: kvote _ jaktkvote
almmuhus N: kunngjøring; deklarasjon _ annonse; deklarasjon
kulturbargu N: kulturutøvelse; kulturarbeid _ kulturarbeid
kulturdoaibma N: kulturtiltak _ kulturaktivitet
kulturruhta N: kulturmiddel _ kulturpenger
gáranasruitu N: kråkebolle _ sjøpinnsvin, sjøpinnsvin
allodat N: kroppshøyde; høyde _ høyde
fápmojođas N: kraftledning _ strømledning
ruvdna N: kr; krone _ krone
ruvdno N: kr; krone _ krone
kruvdnu N: kr; krone _ krone
gáma N: kommag; sko _ fottøy; komag, skalle
lávdegoddi N: komite; utvalg _ komité, utvalg; nemnd
komitea N: komite _ komité
duppalčuokkis N: kolon _ kolon _ SAME
gáktegoarrun N: koftesying; koftesøm _ koftesøm
juotna N: knep _ list, intrige; disposisjon
eanaspábba N: klode; jordklode; jord _ jordklode
biergobuvttadeapmi N: kjøttavkastning; kjøttproduksjon _ kjøttproduksjon
guoddalus N: kjæremål; anmeldelse _ anklage, anmeldelse
kásus N: kasus _ kasus _ SAME
miessemearkun N: kalvemerking _ reinkalvmerking
giehtaváđđu N: juksamaskin _ jukse
bargovejolašvuohta N: jobbmulighet; arbeidsmulighet _ arbeidsmulighet
fuolaheapmi N: ivaretakelse; omsorg _ omsorg
badjelgeahččanvuohta N: intoleranse _ overlegenhet
jierbmi N: intelligens; hjerne _ forstand, fornuft
čuojanas N: instrument _ musikkinstrument
bagadus N: instruks; veiledning _ rettledning
vuosteháhku N: innvending; motstand _ motstand
sisaboahtovejolašvuohta N: inntektsmulighet _ inntektsmulighet _ SAME
cealkámuš N: innspill; resolusjon; utsagn; uttalelse _ uttalelse; resolusjon
hutkkus N: innovasjon _ påfunn
sáivaguolásteapmi N: innlandsfiske; ferskvannsfiske _ ferskvannsfiske
sáivaguolli N: innlandsfisk; ferskvannsfisk _ ferskvannsfisk
oastinšiehtadus N: innkjøpsavtale; kjøpekontrakt _ kjøpekontrakt
gohččun N: innkalling; kommando; pålegg _ innkallelse; reskript
gulaskuddan N: høring _ forespørsel
guolga N: hårlag _ pelshår; kroppshår
siibma N: håndsnøre _ fortom
ruovttudoallu N: husholdning; heimkunnskap _ heimkunnskap
dállodoallu N: hushold; gårdsbruk; husstand _ husstand
šibitdoallu N: husdyrhold _ storfehold
váldodoaibma N: hovedfunksjon; hovedoppgave _ hovedbeskjeftigelse
váldocealkka N: hovedbudskap; helsetning _ hovedsetning
čoarbbealli N: hoft; lår _ lår, hofte
ruovttubargu N: hjemmelekse _ hjemmearbeid
aisttonmearka N: hermetegn _ anførselstegn
ruovttudoallooahppu N: heimstadlære; heimkunnskap _ heimkunnskap
eanahálddašeapmi N: grunnforvaltning _ jordforvaltning
váldočoahkkin N: generalforsamling _ generalforsamling _ SAME
šibitbiebmu N: fôr; dyrefor _ dyrefor
ovttastupmi N: fusjon _ sammenslutning; koalisjon
astoáiggeortnet N: fritidsordning _ skolefritidsordning
ráfáiduhttinmearrádus N: fredningsvedtak; fredningsbestemmelse _ fredningsbestemmelse
govva N: foto; bilde; fotografi _ bilde
juolgenohta N: fotnote _ fotnote _ SAME
ovdakantuvra N: forværelse _ forkontor
hálddašanovddasvástádus N: forvaltningsansvar _ forvaltningsansvar _ SAME
ovdamunni N: fortrinn; fordel; privilegium _ fordel; privilegium
dáruiduhttinpolitihkka N: fornorskingspolitikk; fornorskningspolitikk _ fornorskningspolitikk
dáruiduhttin N: fornorsking; fornorskning _ fornorskning
dajaldat N: formulering; setning; uttrykk _ setning, uttrykk
soahpamuš N: forlik; konvensjon; kontrakt; avtale _ avtale; kontrakt
ovdagihtiijienasteapmi N: forhåndsstemmegivning; forhandsstemmegivning _ forhåndsstemming
buorredáhttu N: forgodtbefinnende; velvilje _ velvilje
veadju N: forfatning; kraft; evne _ kraft; evne
sáhkku N: forelegg _ mulkt
juohku N: fordeling _ deling
cuvccas N: folkesagn; myte; eventyr _ sagn, eventyr, myte
TV-prográmma N: fjernsynsprogram; TV-program _ TV-program
guollešládja N: fiskeslag _ fiskeart
guolleearri N: fiskerikvote; fiskekvote _ fiskekvote
sámemiššuvdna N: finnemisjon; samemisjon _ samemisjon
sorbmi N: fare; død _ noe livsfarlig; dødsulykke
várra N: fare; risiko _ forsiktighet
bivdoroggi N: fangstgrop _ dyregrav
rehket N: faktura; regning _ regning
guite N: faktura _ kvittering
árvvoštallan N: evaluering; anmeldelse; vurdering; kritikk _ anmeldelse, kritikk, vurdering
ovttaidlohku N: entall _ entall, singularis
vuorrádus N: engstelse; uro _ knipe
geažus N: endelse _ endelse _ SAME
náitaleapmi N: ekteskapsinngåelse _ giftemål
eallinvuođđu N: eksistensgrunnlag; livsgrunnlag _ livsgrunnlag
birgenláhki N: eksistensgrunnlag; levekår; livsgrunnlag _ levekår
iešvuohta N: egenart; egenskap _ egenskap
duodjedoaibma N: duodjivirksomhet; formingsaktivitet _ formingsaktivitet
hádja N: duft; lukt _ lukt
readdju N: dress; frakk; jakke _ jakke, frakk
skearru N: diskos; plate _ rund skive; grammofonplate
oalli N: dimensjon _ djupål; bakstykke
oassemáksu N: delutbetaling _ avdrag
bursa N: børs _ pengepung
čalbmeláset N: brille _ briller
bielká N: bordtak _ bjelke
govvadáidda N: billedkunst _ bildekunst
báktedoaibma N: bergverksvirksomhet; bergverk _ bergverk
gálssot N: belling _ vinterbelling
biddu N: belling _ vinterbelling for kvinner; leggvarmer
noađđi N: belastning; byrde _ bør, byrde
ágga N: begrunnelse; argument; grunn _ unnskyldning; argument
buorádus N: bedring; forbedring _ forbedring; omvendelse
vuojadanálddis N: basseng _ svømmebasseng
mánáidsuodjalanbálvalus N: barnevernstjeneste _ barnevernstjeneste _ SAME
jienastanortnet N: avstemmingsmåte; avstemningsordning _ voteringsrekkefølge
bargolohpi N: arbeidstilltalelse; arbeidstillatelse _ arbeidstillatelse
bargoráfi N: arbeidsro _ arbeidsfred
bargodienas N: arbeidsinntekt; arbeidsfortjeneste _ arbeidsfortjeneste
áppes N: abc-bok _ ABC-bok
bargoduogáš N: yrkeserfaring; arbeidserfaring; praksis _ praksis
bargovásihus N: yrkeserfaring; arbeidserfaring _ arbeidserfaring
nuoraiddássi N: ungdomstrinn _ ungdomstrinn _ SAME
lullisápmi N: sørsameområde; sørsame _ sørsame
oppalašárvosátni N: standpunktvurdering; standpunktkarakter _ standpunktkarakter
gielladoaibma N: språktiltak; språkarbeid _ språkaktivitet
njuolggadus N: retningslinje; regel _ regel
boazodoallovuoigatvuohta N: reindriftsrett; reindriftsrettighet _ reindriftsrettighet, rett til å utøve reindrift
ovdasiidogovva N: omslagsbilde; forsidebilde _ forsidebilde
heahteveahkki N: nødhjelp; førstehjelp _ førstehjelp
birasgáhttendepartemeanta N: miljøverndepartement _ miljødepartement
olmmošárvu N: menneskeverd _ menneskeverd _ SAME
eanavuovdinláhka N: jordslagslov _ jordsalgslov
álgosátni N: innledning; forord _ forord
bálká N: honorar; betaling; lønn _ betaling
ovdasátni N: føreord; forord _ forord
girdijohtolat N: flytrafikk _ lufttrafikk
fágasuorgi N: fagområde _ fagfelt
sohkardávda N: diabetes _ sukkersyke
bázzi N: skulptur; støtte _ monument, støtte
biire N: krets; reinbeitedistrikt _ reinbeitedistrikt
bierggas N: gjenstand; ting; sak; utstyr _ ting, sak; genitalia
dávvir N: gjenstand; eiendel; skatt; verdi; utstyr _ eiendel, skatt, verdi
rávesolmmoš N: voksen _ voksen _ SAME
ollesolmmoš N: voksen _ voksen _ SAME
jugus N: drikke _ drikke _ SAME
juhkamuš N: drikke _ drikk
siskkoš N: innmat _ det indre
šilta N: skilt _ skilt _ SAME
galba N: skilt _ nederste del av reinhorn; skilt; skjold
skuvlamánná N: elev; skolebarn _ skolebarn
návdi N: pelsdyr; rovdyr; ulv _ rovdyr; ulv
skeittá N: skøyte _ skøyte _ SAME
luiste N: skøyte _ skøyte _ SAME
assisteanta N: assistent _ assistent _ SAME
sávzanávet N: sauefjøs _ sauefjøs _ SAME
preterihtta N: fortid _ preteritum, fortid
sektor N: sektor _ sektor _ SAME
suorgi N: sektor; linje; område _ forgreining, linje; felt
skuvlaálgin N: skolestart _ skolestart _ SAME
eastadanbargu N: forebyggingsarbeid _ forebyggingsarbeid _ SAME
mihtilmasvuohta N: særpreg _ særegenhet, særtrekk
dánsa N: dans _ dans _ SAME
dánsun N: dans _ dansing
bohtal N: flaske _ flaske _ SAME
latiidna N: latin _ latin _ SAME
latiinnagiella N: latin _ latinsk
lagasvuohta N: nærhet _ nærhet _ SAME
lahkavuohta N: nærhet _ nærhet _ SAME
kondoma N: kondom _ kondom _ SAME
hoidu N: opplegg _ opplegg _ SAME
disposišuvdna N: disposisjon _ disposisjon _ SAME
dramatihkar N: dramatiker _ dramatiker _ SAME
duottarskuvla N: fjellskole _ fjellskole _ SAME
balddonasmuitalus N: spøkelseshistorie _ spøkelseshistorie _ SAME
astu N: fritid _ fritid _ SAME
astoáigi N: fritid _ fritid _ SAME
friddjaáigi N: fritid _ fritid _ SAME
sihkkeloaivesuodji N: sykkelhjelm _ sykkelhjelm _ SAME
servodatviessu N: samfunnshus _ samfunnshus _ SAME
njuorjju N: kobbe; sel _ sel, kobbe
njuorju N: kobbe; sel _ sel, kobbe
láseráigi N: vindu _ vindu _ SAME
glássa N: vindu; glass _ vindu; glass _ SAME
čoavddus N: fasit; løsning _ fasit, løsning
čoavddagirji N: fasit _ fasit _ SAME
boallobeavdi N: tastatur _ tastatur _ SAME
grammatihkka N: grammatikk _ grammatikk _ SAME
johttisápmelaš N: flyttsame _ flyttsame _ SAME
johttisápmi N: flyttsame _ flyttsame _ SAME
badjeolmmoš N: flyttsame; reindriftssame; reineier _ reindriftssame
bargiidbellodat N: arbeiderparti _ arbeiderparti _ SAME
instituhtta N: institutt _ institutt _ SAME
vuordámuš N: forventning _ forventning _ SAME
stivrralahttu N: styremedlem _ styremedlem _ SAME
mánnávuohta N: barndom _ barndom _ SAME
hommá N: tiltak _ tiltak, gjøremål
doaibma N: tiltak; drift; funksjon; virksomhet; aktivitet; oppgave; handling; oppdrag _ virksomhet, gjøremål, aktivitet; drift; tiltak
doaibmabidju N: tiltak _ tiltak _ SAME
justiisalávdegoddi N: justiskomité _ justiskomité _ SAME
olmmošlohku N: innbyggertall; folketall _ innbyggertall
militeara N: militær _ militær _ SAME
váidalus N: klage _ klage, anklage
moaitámuš N: klage; kritikk _ bebreidelse, klage
moaitta N: klage; kritikk _ klage
váidda N: klage _ anklage
bivdinjoavku N: jaktlag _ jaktlag _ SAME
bivdojoavku N: jaktlag _ jaktlag _ SAME
valáštallansearvi N: idrettslag _ idrettslag _ SAME
rámbuvra N: butikk _ butikk _ SAME
rámbuvri N: butikk _ butikk _ SAME
buvda N: butikk _ butikk _ SAME
gávpi N: butikk; salg; handel _ handel; forretning
el-rávdnji N: elektrisitet; strøm _ elektrisitet
elrávdnji N: elektrisitet; strøm _ elektrisitet, strøm
šleađga N: elektrisitet; strøm _ strøm; elektrisitet
stivrenjoavku N: styringsgruppe _ styringsgruppe _ SAME
luonddugáhttenlihttu N: naturvernforbund _ naturvernforbund _ SAME
luonddugáhttensearvi N: naturvernforbund _ miljøvernforening
boahttevuohta N: framtid; fremtid _ framtid
boahtteáigi N: framtid; fremtid _ fremtid
birasgáhttenministtar N: miljøvernminister _ miljøvernminister _ SAME
jahkečuohti N: århundre _ århundre _ SAME
boazodoalloeiseváldi N: reindriftsmyndighet _ reindriftsmyndighet _ SAME
mirko N: gift _ gift _ SAME
gielladilli N: språksituasjon _ språksituasjon _ SAME
miellačájeheapmi N: demonstrasjon _ demonstrasjon _ SAME
miellačájáhus N: demonstrasjon _ demonstrasjon _ SAME
fuorrágávppašeapmi N: prostitusjon _ prostitusjon _ SAME
nuorravuohta N: ungdom _ ungdom _ SAME
nuorra N: ungdom _ ungdom _ SAME
birasgáhtten N: miljøvern _ miljøvern _ SAME
loahppaboahtu N: sluttprodukt _ sluttprodukt _ SAME
bargoskihpár N: kollega _ kollega _ SAME
bargoskibir N: kollega _ kollega _ SAME
bargoustit N: kollega _ kollega _ SAME
stuorradiggi N: storting _ storting _ SAME
vihki N: sykdom; feil _ feil; sykdom
buohcu N: sykdom _ sykdom _ SAME
buozalmas N: sykdom _ sykdom _ SAME
dávda N: sykdom _ sykdom _ SAME
buozanvuohta N: sykdom _ sykdom _ SAME
jaskatvuohta N: stillhet _ stillhet _ SAME
jávohisvuohta N: stillhet; taushet _ taushet
dutkanásahus N: forskningsinstitusjon _ forskningsinstitusjon _ SAME
logijahki N: tiår _ tiår _ SAME
meašttirgilvu N: mesterskap _ mesterskap _ SAME
duhátjahki N: tusenår _ tusenår _ SAME
jahkeduhát N: tusenår _ årtusen
dáhton N: dato _ dato _ SAME
vuosttaškonsuleanta N: førstekonsulent _ førstekonsulent _ SAME
gieldadepartemeanta N: kommunaldepartement _ kommunaldepartement _ SAME
biebmoluossa N: oppdrettslaks _ oppdrettslaks _ SAME
ámmátskuvla N: yrkesskole _ yrkesskole _ SAME
ovdánahttinfitnodat N: utviklingsselskap _ utviklingsselskap _ SAME
eanavuoigatvuohta N: landrettighet _ landrettighet _ SAME
eananvuoigatvuohta N: landrettighet _ jordrettighet
álbmotbellodat N: folkeparti _ folkeparti _ SAME
bivdovuohki N: fangstmetode _ fangstmetode _ SAME
sámegielmáhttu N: samiskkunnskap _ samiskkunnskap _ SAME
geavahanvuoigatvuohta N: bruksrettighet; bruksrett _ bruksrettighet
geavahanriekti N: bruksrettighet; bruksrett _ bruksrett
valáštallan N: idrett _ sport, idrett
faláštallan N: idrett _ idrett _ SAME
lasáhus N: tillegg; økning _ tillegg
lasiheapmi N: tillegg _ tillegg _ SAME
lassi N: tillegg _ tillegg; aksessorisk
boastakantuvra N: postkontor _ postkontor _ SAME
olgoriikkaministtar N: utenriksminister _ utenriksminister _ SAME
boranávdevahát N: rovdyrskade _ rovdyrskade _ SAME
hálddašanvuoigatvuohta N: forvaltningsrett _ forvaltningsrett _ SAME
dearvvašvuođabearráigeahčču N: helsetilsyn _ helsetilsyn _ SAME
láhkačeahppi N: jurist _ jurist _ SAME
giellamáhttu N: språkkunnskap _ språkkunnskap _ SAME
sátnevuorká N: ordforråd _ ordforråd _ SAME
oktiičaskin N: sammenslåing _ sammenslåing _ SAME
válgalistu N: valgliste _ valgliste _ SAME
dásseárvobargu N: likestillingsarbeid _ likestillingsarbeid _ SAME
sárdneolmmái N: predikant _ predikant _ SAME
oamastus N: eie; eierskap _ eie
johtu N: bevegelse; gang _ fart, bevegelse, gang
lihkastat N: bevegelse _ bevegelse _ SAME
lihkadus N: bevegelse _ rørelse, åndelig bevegelse
reasta N: rest _ rest _ SAME
máŋggabealatvuohta N: mangfoldighet; mangfold _ mangfoldighet
giittus N: takk _ takk _ SAME
giitu N: takk _ takk _ SAME
giittos N: takk _ takk _ SAME
giitámuš N: takk _ noe å takke for
luonddumeahcci N: naturreservat _ naturreservat _ SAME
luonddureserváhtta N: naturreservat _ naturreservat _ SAME
gelddolašvuohta N: spenning _ spenning _ SAME
gealdda N: spenning _ spenning _ SAME
ambulánsabálvalus N: ambulansetjeneste _ ambulansetjeneste _ SAME
stádagirku N: statskirke _ statskirke _ SAME
sosiálabálvalus N: sosialtjeneste _ sosialtjeneste _ SAME
restoráŋŋa N: restaurant _ restaurant _ SAME
láhkateaksta N: lovtekst _ lovtekst _ SAME
dáhkádusfitnodat N: forsikringsselskap _ forsikringsselskap _ SAME
vuoiŋŋamašvardin N: hjerneblødning _ hjerneblødning _ SAME
gudneáŋgirvuohta N: ambisjon _ ambisjon, ærgjerrighet
idjadanruhta N: nattillegg _ nattillegg _ SAME
almmolašvuođaláhka N: offentlighetslov _ offentlighetsloven
aláš N: bakketopp; høyde _ høyde, bakketopp
várrečohkka N: bakketopp; fjelltopp _ fjelltopp
amasgiella N: fremmedspråk _ fremmedspråk _ SAME
vierrogiella N: fremmedspråk _ fremmedspråk _ SAME
arvevuovdi N: regnskog _ regnskog _ SAME
arvi N: regn _ regn _ SAME
arvedálki N: regn _ regnvær
atnu N: bruk; nytte _ bruk, nytte
geavaheapmi N: bruk _ bruk _ SAME
geavahus N: bruk; konsum; praksis _ bruk; konsum
doallu N: bruk; drift; driftsenhet _ driftsenhet; drift
atnudiŋga N: bruksting _ bruksting _ SAME
atnubierggas N: bruksting _ bruksgjenstand
baika N: skit _ skit _ SAME
dušši N: skit; tull _ ingenting, bagatell
bajoščáhci N: overflatevann _ overflatevann _ SAME
bargofápmodoaimmahat N: arbeidsmarkedsetat _ arbeidsmarkedsetat _ SAME
bargofápmu N: arbeidskraft _ arbeidskraft _ SAME
bargoheaitta N: streik _ streik _ SAME
bargohárjáneapmi N: arbeidserfaring; erfaring _ arbeidserfaring
bargovásáhus N: arbeidserfaring; erfaring _ arbeidserfaring
bargosadji N: arbeidsplass _ arbeidsplass _ SAME
bargu N: arbeid; oppgave; oppdrag _ arbeid
vahkkoloahppa N: helg _ helg _ SAME
bassi N: helg; helligdag _ helligdag; helg
beaktu N: effekt _ effekt _ SAME
oassi N: del; utdrag; passus; andel _ del; passus; akt; lodd
gáhppálat N: del; eksemplar _ stykke, del
oasáš N: del _ liten del
bealátvuohta N: inhabilitet _ inhabilitet _ SAME
beanna N: penn _ penn _ SAME
beanná N: penn _ penn _ SAME
peanna N: penn _ penn _ SAME
veahka N: familie; makt; styrke _ styrke, makt; mannskap; familie
bearaš N: familie _ familie _ SAME
joavku N: familie; husstand; flokk; gruppe _ flokk, gruppe; lag; husstand
fuolki N: familie; slektning _ slektning
bearjadat N: fredag _ fredag _ SAME
beroštupmi N: interesse; omsorg; engasjement _ omsorg, interesse; engasjement
beroštusriidu N: interessekonflikt _ interessekonflikt _ SAME
beroštusvuostálasvuohta N: interessemotsetning _ interessemotsetning _ SAME
biebmolassi N: matauk _ matauk _ SAME
biebmováhnen N: fosterforelder _ fosterforelder _ SAME
bietna N: detalj _ detalj _ SAME
bievla N: barmark _ barmark _ SAME
bihttá N: lekse; utdrag; bit _ stykke, bit; lekse; utdrag
leaksu N: lekse _ lekse _ SAME
ruovttubihttá N: lekse _ hjemmeoppgave
bihttábordin N: puslespill _ puslespill _ SAME
biibbalhistorjá N: bibelhistorie _ bibelhistorie _ SAME
orohat N: reinbeitedistrikt; distrikt _ boplass; oppholdssted; reinbeitedistrikt
biras N: miljø; omslag _ miljø, omgivelse; del av mannslue; kulisse; omslag
birgendássi N: levestandard _ levestandard _ SAME
eallindássi N: levestandard _ levestandard _ SAME
bivdda N: anmodning; bønn _ bønn; anmodning
ávžžuhus N: anmodning; anbefaling _ oppfordring, anbefaling
huksehus N: bygg; konstruksjon _ bygg; konstruksjon _ SAME
bivgi N: bygg _ bygg _ SAME
bláđđi N: magasin; blad _ blad, magasin
boaldámuš N: brensel; drivstoff _ brensel; brennstoff, drivstoff
boanda N: bonde _ bonde _ SAME
boarrásiidsiida N: aldershjem _ aldershjem _ SAME
čoahkkinortnet N: dagsorden; forretningsorden _ dagsorden, forretningsorden
áššelistu N: dagsorden; saksliste _ saksliste, dagsorden, møtekart
bohcci N: rør _ rør, sugerør; nålfutteral
revre N: rør _ rør _ SAME
boraspire N: rovdyr _ rovdyr _ SAME
náhkki N: skinn _ skinn, hud
sisti N: skinn _ garvet skinn
borgi N: skinn _ skinn _ SAME
buhtadas N: godtgjørelse _ erstatning, godtgjørelse, vederlag
buohcceviessu N: sykehus _ sykehus _ SAME
báhkin N: hedning _ hedning _ SAME
báhkka N: varme _ varme, hete
bázahas N: levning _ levning _ SAME
bážan N: skytevåpen _ skytevåpen _ SAME
deaddu N: press; vekt _ tyngde, vekt; press, trykk
deatta N: press _ vekt, trykk, press
deappu N: tare _ brunalge, tare
dárra N: tare _ tare _ SAME
dearvvašvuohta N: helse _ helse _ SAME
diida N: overtro _ overtro _ SAME
tiida N: overtro; forestilling _ forestilling, overtro
dikšu N: terapi; behandling _ pleie; terapi
dilli N: forhold; situasjon _ forhold, tilstand
dilálašvuohta N: forhold; anledning; situasjon; omstendighet _ anledning; forhold, tilstand
gaskavuohta N: forhold; relasjon _ forhold, relasjon
gorri N: forhold; relasjon _ proporsjon; relasjon
liiba N: anledning _ sjanse, høve
čoaltu N: klump _ klump _ SAME
doahkki N: klump _ klump; fugleflokk
duoggi N: klump _ klump _ SAME
doarjjastivra N: tilskuddsstyre _ tilskuddsstyre _ SAME
doavttirskuvla N: medisinstudium _ medisinstudium _ SAME
dolgi N: fjær _ fjær _ SAME
dávgi N: fjær _ bue; fjær
dorski N: torsk _ torsk _ SAME
duopmu N: dom _ dom _ SAME
duođaštus N: attest; dokumentasjon; bekreftelse _ bekreftelse, bevitnelse; attest; bevis, dokumentasjon
bargoduođaštus N: attest _ arbeidsattest
dáhpedorbmi N: tilfelle _ tilfelle _ SAME
dáhpáhus N: tilfelle; hendelse _ hendelse
dáhttu N: ønske; vilje _ ønske, vilje
árji N: ønske _ ønske, trang
sávaldat N: ønske _ ønske _ SAME
háliidus N: ønske _ lengsel, lyst
oapmi N: eiendel; ting _ eiendel, ting; kreatur
eadni N: mor _ mor _ SAME
eallinvuohki N: levesett; levemåte; livsstil _ levesett, levemåte, livsstil
ealáhus N: næringsvei; næring; næringsliv _ næring, næringsvei
eanaeaiggát N: grunneier _ grunneier _ SAME
eana N: land; jord; eiendom _ jord, jorde; land, mark; eiendom
nannán N: land; fastland _ fastland; kontinent
eatnanmuorji N: jordbær _ jordbær _ SAME
eananmuorji N: jordbær _ jordbær _ SAME
rávdnji N: strøm; strøm _ strøm
erohus N: forskjell; avvik _ forskjell
evttohanvuoigatvuohta N: forslagsrett _ forslagsrett _ SAME
evttohas N: kandidat _ kandidat; kandidatur
kandidáhtta N: kandidat _ kandidat _ SAME
evttohus N: forslag _ forslag _ SAME
árvalus N: forslag; tanke; innstilling _ tanke; forslag
eŋgelasgiella N: engelsk _ engelsk språk
eaŋgalasgiella N: engelsk _ engelsk språk
fidnu N: yrke _ yrke, beskjeftigelse
fylkkadiggi N: fylkesting _ fylkesting _ SAME
gárri N: fat _ fat; trau
fáhtta N: fat _ fat _ SAME
lihtti N: fat; kar _ kjørel, kar, kopper
fálaldat N: tilbud _ tilbud _ SAME
fárru N: følge; reisefølge _ følge, reisefølge
čuovus N: følge; følgeskriv; konsekvens _ følgeskriv; følge
garra N: skall _ skall, skorpe
skálžu N: skall; skjell _ skjell
gaska N: mellomrom; opphold; avstand _ mellomrom, avstand
loapmi N: mellomrom; åpning _ åpning, mellomrom
ruhta N: middel _ penge
gažaldatskovvi N: spørreskjema _ spørreskjema _ SAME
geahččalanprošeakta N: prøveprosjekt _ prøveprosjekt _ SAME
geaidnu N: vei; veg _ vei, veg
luodda N: vei; veg _ spor, vei
máđidja N: vei; løype _ vei, fast løype
máđii N: vei _ vei, fast løype
raŧŧi N: vei; veg _ vei, veg, vintervei
bálggis N: vei; veg _ sti; veg
geardi N: etasje; generasjon; gang _ gang; etasje; aldersklasse
gearggusvuohta N: beredskap _ beredskap _ SAME
geasus N: fradrag _ fradrag _ SAME
geađgi N: stein _ stein _ SAME
geres N: pulk _ pulk _ SAME
giddagas N: fengsel _ fengsel _ SAME
giehtačála N: håndskrift _ håndskrift _ SAME
giehtačálus N: manus _ manus _ SAME
giella N: språk _ språk; snare
giellaguovddáš N: språksenter _ språksenter _ SAME
giellakursa N: språkkurs _ språkkurs _ SAME
giellagursa N: språkkurs _ språkkurs _ SAME
sámegielgursa N: språkkurs; samiskkurs _ samiskkurs
gievdni N: kjel; bøtte _ bøtte, kjel
váivi N: plage _ besvær, plage
giksi N: plage; bryderi _ plage
šuokŋa N: klang; tone; melodi _ klang
gilkkas N: klang _ klang _ SAME
skádja N: klang _ ekko; etterklang
gilli N: bygd _ bygd _ SAME
gillámuš N: lidelse _ lidelse _ SAME
girdibileahtta N: flybillett _ flybillett _ SAME
lávvomuorra N: teltstang _ teltstang til lavvo
goahtemuorra N: teltstang _ teltstang _ SAME
goahti N: gamme _ gamme; vintertelt
goalmmádas N: tredjedel _ tredjedel, tredel
goargu N: heder; etternavn _ stas, heder; familienavn
gudni N: heder; ære _ ære
goavki N: gløtt; åpning _ gløtt, åpning
gohppu N: kopp _ kopp _ SAME
kohppa N: kopp _ kopp _ SAME
goldin N: drivgarnfiske _ drivgarnsfiske
gore N: kurv _ kurv _ SAME
mársu N: kurv _ kurv _ SAME
gudji N: gate; passasje _ gate, passasje
gáhta N: gate _ gate _ SAME
gulloapparáhtta N: høreapparat _ høreapparat _ SAME
guolbba N: slette _ slette, mo
jalga N: slette _ slette _ SAME
guolenáhkki N: fiskeskinn _ fiskeskinn _ SAME
čuopma N: fiskeskinn _ fiskeskinn _ SAME
guollerusttet N: fiskebruk _ fiskebruk _ SAME
guolli N: fisk _ fisk _ SAME
guolásteapmi N: fiskeri; fiske _ fiskeri; fiske _ SAME
guolástus N: fiskeri; fiske _ fiske
guolástuspolitihkka N: fiskeripolitikk _ fiskeripolitikk _ SAME
guovllustivra N: områdestyre _ områdestyre _ SAME
guovlu N: reinsogn; retning; område; distrikt; region; areal; territorium _ trakt, distrikt; område; reinsogn; retning
boazosuohkan N: reinsogn; reindriftskommune _ reindriftskommune
gáffeboddu N: kaffepause _ kaffepause _ SAME
gáfeboddu N: kaffepause _ kaffepause _ SAME
gáffádat N: kafe _ kafe _ SAME
kaféa N: kafe _ kafé
gáibádus N: fordring; krav _ krav; fordring
gálbi N: kalv _ kalv _ SAME
miessi N: kalv _ reinkalv
gálvu N: vare; produkt _ vare, bagasje
gáržžideapmi N: begrensning; restriksjon _ begrensning, restriksjon
hoavda N: sjef; leder _ leder, sjef
njunuš N: sjef; ledelse _ tet, ledelse, fortropp
hálddahus N: administrasjon _ administrasjon _ SAME
hárjehus N: øvelse _ øvelse _ SAME
iešdovdu N: selvfølelse _ selvfølelse _ SAME
iešluohttámuš N: selvtillit _ selvtillit _ SAME
iešsorbmen N: selvmord _ selvmord _ SAME
iešsuodjalus N: selvforsvar _ selvforsvar _ SAME
ipmil N: gud _ gud _ SAME
ipmilbálvalus N: gudstjeneste _ gudstjeneste _ SAME
áddejupmi N: forståelse; oppfatning; syn _ syn, forståelse
ipmárdus N: forståelse; oppfatning _ forståelse
jahkebargu N: årsverk _ årsverk _ SAME
jahkodat N: årgang; årssyklus _ årstid; årssyklus; årgang
jienastanvuoigatvuohta N: stemmerett _ stemmerett _ SAME
jienasteapmi N: avstemning _ avstemning _ SAME
johttisámedilli N: reinnomadisme _ reinnomadisme _ SAME
jorbodat N: sirkel _ runding, sirkel
gierdu N: sirkel; ring _ ring, runding; linebøyel; spektrum
čiekčanspábba N: fotball _ fotball _ SAME
juolgespábba N: fotball _ fotball _ SAME
spábbačiekčan N: fotball _ fotballkamp
juovlamuorra N: juletre _ juletre _ SAME
juovlabeahci N: juletre _ julefuru
juovlamánnu N: desember _ desember _ SAME
juvla N: hjul _ hjul _ SAME
ráhtis N: hjul _ hjul _ SAME
kaleanddar N: kalender _ kalender _ SAME
kantiidna N: kantine _ kantine _ SAME
boradanlatnja N: kantine _ spiserom
kaseahtta N: kassett _ kassett _ SAME
jietnabáddi N: kassett _ lydbånd
kilo N: kilo _ kilo _ SAME
konferánsa N: konferanse _ konferanse _ SAME
konfirmašuvdna N: konfirmasjon _ konfirmasjon _ SAME
konvenšuvdna N: konvensjon _ konvensjon _ SAME
kulturmuitoláhka N: kulturminnelov _ kulturminneloven
kulturmuitosuodjaleapmi N: kulturminnevern _ kulturminnevern _ SAME
lasseárvodivat N: merverdiavgift _ merverdiavgift _ SAME
latnja N: sprekk; rom; lokale; åpning _ rom; sprekk; åpning
sálvu N: sprekk _ sprekk; fuge
leahki N: dal _ dal _ SAME
vággi N: dal _ dal, liten dalsenkning
leahpu N: fred; ro _ fred, ro
ráfi N: fred _ fred _ SAME
máššu N: ro _ ro _ SAME
leahttorádji N: fartsgrense _ fartsgrense _ SAME
loatna N: lån _ lån _ SAME
lokta N: loft _ loft _ SAME
luohkká N: klasse _ klasse; bakke; skåkbue
ceahkki N: klasse; grad; trinn _ trinn; grad
luohkkáceahkki N: klassetrinn _ klassetrinn _ SAME
luođđa N: kule; skudd _ kule
šládja N: slag; type; art; art _ slag, sort
lágáš N: slag _ slag _ SAME
láhkaásahus N: forskrift _ forskrift _ SAME
láseliidni N: gardin _ gardin _ SAME
lássaliidni N: gardin _ gardin _ SAME
lávlla N: sang _ sang _ SAME
lávlu N: sang; sanger _ sang
lávlun N: sang _ synging
olmmái N: venn; mann; kamerat _ mann; venn, kamerat
lávvi N: venn _ god kjenning, venn
skihpár N: venn; kamerat _ kamerat, venn
skibir N: venn; kamerat _ venn, kamerat
ustit N: venn; kamerat _ venn, kamerat
mearka N: merke; signal; reinmerke; tegn; tegn; tegn _ merke, signal; fiskemed
mearragáddi N: kyst _ kyst _ SAME
riddu N: kyst _ kyst; strand
miehtebiegga N: medvind _ medvind _ SAME
mielddus N: følgeskriv; vedlegg _ følgeskriv, vedlegg
miella N: sinn _ sinn; humør; lyst
miestta N: busk _ busk _ SAME
mihttomearri N: målsetting; mål _ målsetting
miila N: mil _ mil _ SAME
mokta N: optimisme; motivasjon _ humør, optimisme; motivasjon
muitalus N: fortelling; historie _ fortelling
máinnas N: fortelling; eventyr _ eventyr
muohta N: snø _ snø _ SAME
máhcastat N: brett _ fold, brett
máhttu N: ferdighet; kunnskap; kompetanse; kvalifikasjon _ kunnskap, ferdighet; kvalifikasjon
mánáidskuvla N: barneskole _ barneskole _ SAME
márkan N: kirkested; marked; tettsted _ marked; kirkested, tettsted
nieida N: jente; datter _ jente; datter _ SAME
nieidamánná N: jente _ jentebarn
niestelávka N: nistesekk _ nistesekk, matransel
njealjádas N: fjerdedel _ fjerdedel _ SAME
náittosgovva N: bryllupsbilde _ brudebilde, bryllupsbilde
oaidnu N: synspunkt; syn _ syn; synspunkt
olmmoščearda N: folkeslag; nasjon _ folkeslag; nasjon _ SAME
ortnet N: orden; orden; ordning _ orden
skihkka N: orden _ skikk; orden
ovdagoddi N: formannskap _ formannskap _ SAME
ovdagovva N: ideal; forbilde _ ideal
ovdaolmmoš N: formann; leder _ leder, formann, forkvinne
ovttasbargu N: samarbeid _ samarbeid _ SAME
paneladigaštallan N: paneldebatt _ paneldebatt _ SAME
prošeakta N: prosjekt _ prosjekt _ SAME
raddi N: bryst _ bryst; barm
čižži N: bryst; pupp _ kvinnebryst
rektor N: rektor _ rektor _ SAME
riika N: rike _ rike _ SAME
roaiská N: pisk _ pisk _ SAME
spihčá N: pisk _ svepe
roaškkas N: rabalder _ smelling, rabalder
ruhtagollu N: utgift _ utgift _ SAME
olggosgollu N: utgift _ utgift _ SAME
rumaš N: kropp _ legeme, kropp
gorut N: kropp _ skrott
ruoŧagiella N: svensk _ svensk _ SAME
rusttet N: installasjon; byggverk; anlegg _ anordning, installasjon, anlegg; byggverk; etablissement
ráhkkanas N: innretning; greie _ innretning, greie
ráhpi N: slam _ slam, søle
rášša N: høyfjellsområde _ høyfjellsområde _ SAME
sabet N: ski _ ski _ SAME
čuoigan N: ski; langrenn; skirenn _ skirenn
seahtu N: stand; stilling _ stand, stilling
searvegoddi N: menighet _ menighet _ SAME
servodat N: samfunn _ samfunn _ SAME
servodatfága N: samfunnsfag _ samfunnsfag _ SAME
sirdin N: overføring; flytting _ flytting; overføring
sisdoallu N: innholdsfortegnelse; innhold _ innhold; innholdsfortegnelse
skohter N: snøscooter; scooter _ scooter, snøscooter
muohtaskohter N: snøscooter; snøskuter _ snøskuter
skuovva N: sko; støvel _ sko
sohkagoddi N: slekt _ slekt _ SAME
sohka N: slekt _ slekt, ætt; slektning
sogalaš N: slekt; slektning _ slektning
stoahkanapparáhtta N: lekeapparat _ lekeapparat _ SAME
stoarbma N: storm _ storm _ SAME
suopman N: dialekt; stemme _ stemme, røst; dialekt
sárggis N: linje; strek _ strek
linjá N: linje _ linje _ SAME
linnjá N: linje _ linje _ SAME
suovva N: røyk _ røyk _ SAME
duhpát N: røyk; tobakk _ tobakk
ságastallan N: samtale; debatt; dialog _ samtale; dialog
sáivačáhceguolli N: ferskvannsfisk _ ferskvannsfisk _ SAME
sámediggi N: sameting _ sameting _ SAME
unnitlohku N: mindretall; minoritet _ mindretall
ustitvuohta N: vennskap _ vennskap _ SAME
viidna N: vin _ vin, brennevin
viidni N: vin; brennevin _ vin
vuogádat N: system _ framgangsmåte; system
vuoigŋa N: ånd _ ånd _ SAME
vuoiŋŋalašvuohta N: ånd _ åndelighet
vuoitu N: fordel; gevinst _ seier; fordel; gevinst; avkastning
vuoiŋŋanas N: pust _ pust _ SAME
vuoiŋŋahat N: pust _ åndedrett
vuoksá N: okse _ okse _ SAME
sarvvis N: okse _ reinsbukk
bárggeš N: komagbånd _ flettet snor til komagbånd
vuođđojurdda N: ideologi; prinsipp _ prinsipp; ideologi
váhnenčoahkkin N: foreldremøte _ foreldremøte _ SAME
válga N: valg _ valg _ SAME
várrepresideanta N: visepresident _ visepresident _ SAME
várri N: fjell; råd _ fjell; råd _ SAME
duottar N: fjell _ vidde
áhta N: element; ting _ ting; element
áigodat N: intervall; sesong _ intervall; tidsperiode
áigumuš N: intensjon; vilje _ vilje, hensikt; intensjon
álbmotbeaivi N: nasjonaldag _ nasjonaldag _ SAME
árpu N: tråd _ tråd _ SAME
láigi N: tråd; garn _ garn, ulltråd
stáhtus N: status _ status _ SAME
ásahus N: ordning; institusjon; organ _ ordning, foranstaltning; institusjon, organ
ávnnas N: emne; materiale _ emne, skurlast
fáddá N: emne; tema; motiv _ tema, motiv
áššebábir N: saksdokument; dokument; sakspapir _ sakspapir, aktstykke, saksdokument
áššegollu N: sakskostnad _ sakskostnad _ SAME
čađaheapmi N: gjennomgang; gjennomføring _ gjennomgang, gjennomføring
geahčadeapmi N: gjennomgang _ innsyn
čielgi N: ryggrad; rygg _ rygg, ryggrad; landrygg; hovedsnøre
čielgedákti N: ryggrad _ ryggvirvel
čivga N: unge _ unge _ SAME
čoahkkáigeassu N: oppsummering; sammendrag _ oppsummering; sammendrag _ SAME
čoarvvuš N: gevir _ gevir _ SAME
čoarvvus N: gevir _ gevir _ SAME
čoarvi N: gevir; horn _ horn
čujuhus N: adresse; henvisning _ adresse; anvisning, henvisning
čuohti N: hundre _ hundre _ SAME
čáhci N: vann _ vann, vatn
jávri N: vann _ innsjø
čálašeapmi N: korrespondanse _ korrespondanse _ SAME
čálus N: notat _ notat, skriv
čázet N: komag _ komag, sommerkomag
buser N: genser _ genser _ SAME
báidi N: genser _ skjorte
myhta N: myte _ myte _ SAME
gáddu N: myte; tro _ knehase; tro, formodning
guollejávri N: fiskevann _ fiskevann _ SAME
ámmátolmmoš N: embetsmann _ embetsmann _ SAME
noras N: lårbein _ lårbein, margbein
viisodat N: klokskap _ klokskap _ SAME
astoáiggeviessu N: fritidsbolig; fritidshus _ fritidshus, fritidsbolig
bargiidpolitihkka N: personalpolitikk _ personalpolitikk _ SAME
bargonávccahisvuođaoadju N: uføretrygd _ uføretrygd _ SAME
buhcciidruoktu N: sykehjem _ sykehjem _ SAME
bátnedivššohat N: tannklinikk _ tannklinikk _ SAME
departemeantaráđđi N: departementsråd _ departementsråd _ SAME
diehtogáldu N: informasjonskilde; datakilde _ informasjonskilde, datakilde
diehtojuohkinteknologiija N: informasjonsteknologi _ informasjonsteknologi _ SAME
diehtovuođđu N: informasjonsgrunnlag; database _ database; informasjonsgrunnlag
doaibmagoddi N: arbeidsutvalg; kommisjon _ kommisjon, arbeidsutvalg
bargolávdegoddi N: arbeidsutvalg _ arbeidsutvalg _ SAME
doaibmaguovddáš N: aktivitetssenter _ aktivitetssenter _ SAME
doaibmalohpi N: konsesjon; løyve _ konsesjon, løyve
lohpi N: løyve; tillatelse; lov _ tillatelse, lov
doaibmasisaboahtu N: driftsinntekt _ driftsinntekt _ SAME
doavtterbálvalus N: legetjeneste _ legetjeneste _ SAME
duktasadji N: hustuft _ hustuft _ SAME
dutkanprošeakta N: forskningsprosjekt _ forskningsprosjekt _ SAME
dásseárvoláhka N: likestillingslov _ likestillingslov _ SAME
fievrredandoarjja N: frakttilskudd _ frakttilskudd _ SAME
fitnodatregisttar N: foretaksregister _ foretaksregister _ SAME
gielddariekti N: herredsrett _ herredsrett _ SAME
givssideapmi N: mobbing _ mobbing _ SAME
gulahallanváhnen N: foreldrekontakt _ foreldrekontakt _ SAME
gulaskuddannotáhtta N: høringsnotat _ høringsnotat _ SAME
guovttegielalašvuođadoarjja N: tospråklighetstilskudd _ tospråklighetstilskudd _ SAME
gáddeavádat N: strandsone _ strandsone _ SAME
jođihandoarjja N: driftstilskudd; driftsstøtte _ driftstilskudd
loahpaheapmi N: avslutning _ avslutning _ SAME
luoddadirektoráhtta N: vegdirektorat _ vegdirektorat _ SAME
luonddusuodjalanláhka N: naturvernlov _ naturvernlov _ SAME
lávdegoddeevttohus N: komitéinnstilling _ komitéinnstilling _ SAME
meroštallannjuolggadus N: beregningsregel _ beregningsregel _ SAME
mánáidoadju N: barnetrygd _ barnetrygd _ SAME
mánáidsuodjalusláhka N: barnevernlov _ barnevernlov _ SAME
nationálabušeahtta N: nasjonalbudsjett _ nasjonalbudsjett _ SAME
njuovahatstruktuvra N: slakteristruktur _ slakteristruktur _ SAME
oahppostipeanda N: utdanningsstipend _ utdanningsstipend _ SAME
odelsláhka N: odelslov _ odelslov _ SAME
ovdaprošeakta N: forprosjekt _ forprosjekt _ SAME
ovddidanprošeakta N: utviklingsprosjekt _ utviklingsprosjekt _ SAME
ovttaolbmofitnodat N: enkeltmannsforetak _ eneierforetak, enkeltmannsforetak
ovttasbargolávdegoddi N: samarbeidsutvalg _ samarbeidskomité, samarbeidsutvalg
predikatiiva N: predikativ _ predikativ _ SAME
redakšuvdnalávdegoddi N: redaksjonskomité _ redaksjonskomité _ SAME
regionálapolitihkka N: regionalpolitikk _ regionalpolitikk _ SAME
guovlopolitihkka N: regionalpolitikk; distriktspolitikk _ distriktspolitikk
riektecealkámuš N: kjennelse _ kjennelse _ SAME
riektegeavat N: rettspraksis _ rettspraksis _ SAME
riektegeavahus N: rettspraksis _ rettsanvendelse
riektesihkarvuohta N: rettssikkerhet _ rettssikkerhet _ SAME
rámmaplána N: rammeplan _ rammeplan _ SAME
sadjásašvirgi N: vikariat _ vikariat _ SAME
seavagiella N: tegnspråk _ tegnspråk _ SAME
giehtagiella N: tegnspråk _ tegnspråk _ SAME
servodatberoštupmi N: samfunnsinteresse _ samfunnsinteresse _ SAME
siffar N: siffer _ siffer _ SAME
skovvi N: blankett; skjema _ skjema, blankett
skuvlafriddjaortnet N: skolefritidsordning _ skolefritidsordning _ SAME
skuvlaastoáiggeortnet N: skolefritidsordning _ skolefritidsordning _ SAME
astoáiggefálaldat N: skolefritidsordning; fritidstilbud _ fritidstilbud
sárdnestuollu N: talerstol _ talerstol _ SAME
telefonguovddáš N: sentralbord _ sentralbord _ SAME
telefončoahkkin N: telefonmøte _ telefonmøte _ SAME
ulbmilmearrádus N: formålsbestemmelse _ formålsbestemmelse _ SAME
ulbmilparagráfa N: formålsbestemmelse; formålsparagraf _ formålsparagraf
vearrovuogádat N: skattesystem _ skattesystem _ SAME
vuoigŋaduodji N: åndsverk _ åndsverk _ SAME
jurddamáilbmi N: tankeverden _ tankeverden _ SAME
oaggunáigi N: fisketid _ fisketid _ SAME
oahppanbáiki N: lærested _ lærested _ SAME
juogus N: seksjon _ seksjon _ SAME
forum N: forum _ forum _ SAME
maori N: maori _ maori _ SAME
plánen N: planlegging _ planlegging _ SAME
preassa N: presse _ presse _ SAME
media N: presse _ media
bajásšaddan N: oppvekst _ oppvekst _ SAME
sámerádio N: sameradio _ sameradio _ SAME
bargoeallin N: arbeidsliv _ arbeidsliv _ SAME
lagasrádio N: nærradio _ nærradio _ SAME
riegádeapmi N: fødsel _ fødsel _ SAME
boazoálbmot N: reindriftsfolk _ reindriftsfolk _ SAME
giellageavaheapmi N: språkbruk _ språkbruk _ SAME
giellabargu N: språkarbeid _ språkarbeid _ SAME
fágabiras N: fagmiljø _ fagmiljø _ SAME
ruvdnaprinsa N: kronprins _ kronprins _ SAME
ođđadárogiella N: nynorsk _ nynorsk _ SAME
rádjeofelaš N: grenselos _ grenselos _ SAME
plánabargu N: planarbeid _ planarbeid _ SAME
guovllukommišuvdna N: distriktskommisjon _ distriktskommisjon _ SAME
nuoraidsearvi N: ungdomsforbund _ ungdomsforbund _ SAME
rádjaguovlu N: grenseområde _ grenseområde _ SAME
geassebargu N: sommerjobb _ sommerjobb _ SAME
plánalávdegoddi N: planutvalg _ planutvalg _ SAME
bearašmiellahttu N: familiemedlem _ familiemedlem _ SAME
rehketmašiidna N: kalkulator _ regnemaskin, kalkulator
diehtu N: informasjon; beskjed; kunnskap; opplysning _ kunnskap, viten; informasjon
diehtojuohkin N: informasjon; orientering _ informasjon, orientering
sorta N: type _ sort
jagiáigi N: sesong _ årstid
digaštallan N: debatt; diskusjon _ debatt, ordskifte
buvtta N: produkt _ produkt _ SAME
vuovdin N: salg _ salg _ SAME
buvttadus N: produksjon _ produksjon, avkastning
mearrádus N: vedtak; bestemmelse _ bestemmelse
vátni N: mangel _ mangel _ SAME
vádjit N: mangel; underskudd _ underskudd, mangel
váili N: mangel; underskudd _ mangel, underskudd
osku N: religion; tro _ tro; religion
geahččaleapmi N: prøve; forsøk _ prøve
geahččalus N: prøve; prøvelse; fristelse _ prøvelse; fristelse
bušeahtta N: budsjett _ budsjett _ SAME
sadji N: posisjon; sted; rolle; plass _ sted, plass; posisjon; rolle
posišuvdna N: posisjon _ posisjon _ SAME
dorvu N: sikkerhet; tillit; trygghet _ tillit; sikkerhet
sihkarvuohta N: sikkerhet _ sikkerhet _ SAME
hápmi N: stil; form _ form; skikkelse; utseende; fasade
eaktu N: forutsetning; vilkår; kriterium _ betingelse, vilkår; klausul; kriterium
duohtavuohta N: alvor; realitet; faktum _ sannhet
fearán N: episode; hendelse; historie _ hending, hendelse
guorahallan N: analyse; utredning; utredning; undersøkelse _ utredning; analyse
vuolggaheapmi N: initiativ _ initiativ _ SAME
dálkkádat N: klima _ klima _ SAME
bálvalus N: service; tjeneste _ tjeneste
ovdanbuktin N: presentasjon; fremstilling; foredrag; uttrykk; framstilling _ presentasjon
ádji N: opphold _ tidhefte
čuohpaheapmi N: operasjon _ operasjon _ SAME
leaika N: humor; spøk _ spøk
gielddus N: forbud _ forbud _ SAME
dáidu N: sans; kunnskap; evne _ kunnskap; forstand
sále N: sal _ sal _ SAME
tennjet N: tegning _ tegning _ SAME
tevnnet N: tegning _ tegning _ SAME
ealáhat N: pensjon _ beite; pensjon
suodjalus N: beskyttelse; forsvar; vern _ beskyttelse, vern
suodji N: beskyttelse; vern _ ly, vern
goallosvovdna N: tilhenger _ tilhenger _ SAME
borasdávda N: kreft _ kreft _ SAME
dihtomiella N: bevissthet _ bevissthet _ SAME
suoidni N: gress _ gress, høy; sennegress
rássi N: gress _ gras; urt, blomst
sáŋgár N: forbilde; helt _ helt
ruovderaŧŧi N: jernbane _ jernbane _ SAME
ruovdemáđidja N: jernbane _ jernbanespor
váldi N: fullmakt; mandat; myndighet _ fullmakt, myndighet, mandat
fápmudus N: fullmakt; mandat _ mandat
náittosbárra N: ektepar _ brudepar
náittospárra N: ektepar _ brudepar
dovddastus N: erkjennelse _ innrømmelse, tilståelse; betroelse
oahpponeavvu N: læremiddel _ læremiddel _ SAME
dutkan N: etterforskning; forskning; undersøkelse _ undersøkelse; forskning
ovttasbargoprošeakta N: samarbeidsprosjekt _ samarbeidsprosjekt _ SAME
garrusátni N: banning _ banneord
stevvel N: støvel _ støvel _ SAME
ekovuogádat N: økosystem _ økosystem _ SAME
jahkelohku N: årstall _ årstall _ SAME
guoddá N: madrass _ pute
gilvočuoigan N: langrenn; skirenn _ skirenn
báhpasuohkan N: prestegjeld _ prestesokn
čáhcerusttet N: vannverk _ vannanlegg
eanandoallopolitihkka N: landbrukspolitikk _ landbrukspolitikk _ SAME
gávpeolmmái N: handelsmann _ handelsmann _ SAME
gávpejas N: handelsmann _ handelsmann _ SAME
berošteaddjijoavku N: interessegruppe _ interessegruppe _ SAME
riikkageaidnu N: riksveg; riksvei _ riksvei
almmuhantávval N: oppslagstavle _ oppslagstavle _ SAME
bargobivttas N: kjeledress _ arbeidsplagg
dárbbaš N: rekvisita; behov _ behov, nødvendighet
váldooassi N: hovedenhet; hoveddel _ hoveddel
sátnevuorrolistu N: talerliste _ talerliste _ SAME
resursaváili N: ressursknapphet _ ressurssvak
ruoššagiella N: russisk _ russisk _ SAME
čuovga N: lys _ lys _ SAME
láppis N: lam _ lam _ SAME
molssaeaktu N: alternativ _ alternativ _ SAME
juolgi N: bein; fot _ fot, bein
goarta N: kort _ kort _ SAME
koarta N: kort _ kort _ SAME
sálti N: salt _ salt _ SAME
feaila N: feil _ feil _ SAME
boasttuvuohta N: feil _ feil _ SAME
váddu N: feil; skade _ skade, feil
meattáhus N: feil _ feil _ SAME
meaddádus N: feil _ feil, tabbe
vearri N: feil; urett _ urett, feil
ruoktu N: hjem _ heim, hjem
vuohki N: måte; metode _ måte, metode
láhki N: måte _ måte, vis
báđar N: flyktning _ flyktning _ SAME
eaiggát N: eier _ eier _ SAME
ossodathoavda N: avdelingsleder; avdelingsdirektør _ avdelingsleder
áirras N: representant _ representant _ SAME
bálvá N: tjener; tjenestemann _ tjener
bálkábargu N: lønnsarbeid _ lønnsarbeid _ SAME
oaggunstávrá N: fiskestang _ fiskestang _ SAME
oaggunstággu N: fiskestang _ fiskestang _ SAME
čáhcádat N: vassdrag _ vassdrag _ SAME
čázádat N: vassdrag _ vassdrag, vassfar
goavddis N: runebomme _ runebomme _ SAME
noaidegárri N: runebomme _ runebomme _ SAME
meavrresgárri N: runebomme _ runebomme _ SAME
gávpotguovddáš N: bykjerne _ bykjerne _ SAME
luoikkaheapmi N: utlån _ utlån _ SAME
sámegieldiibmu N: samisktime _ samisktime _ SAME
synonyma N: synonym _ synonym _ SAME
riddokultuvra N: kystkultur _ kystkultur _ SAME
vahkkoplána N: ukeplan _ ukeplan _ SAME
čállinproseassa N: skriveprosess _ skriveprosess _ SAME
ritma N: rytme _ rytme _ SAME
responsa N: respons _ respons _ SAME
fonta N: font _ font _ SAME
neahtta N: nett _ nett _ SAME
čállin N: skriving _ skriving _ SAME
oađđenseahkka N: sovepose _ sovepose _ SAME
skandála N: skandale _ skandale _ SAME
beaivečuovga N: dagslys _ dagslys _ SAME
suoivva N: skygge _ skygge _ SAME
suoivvan N: skygge _ skygge _ SAME
teáhterčájáhus N: teaterforestilling _ teaterforestilling _ SAME
ámadadju N: ansikt _ ansikt _ SAME
ámadeadju N: ansikt _ ansikt _ SAME
leksikon N: leksikon _ leksikon _ SAME
katastrofa N: katastrofe _ katastrofe _ SAME
ivdnegeavaheapmi N: fargebruk _ fargebruk _ SAME
gievkkanbeavdi N: kjøkkenbord _ kjøkkenbord _ SAME
filosofa N: filosof _ filosof _ SAME
tráhppa N: trapp _ trapp _ SAME
ráhppa N: trapp _ trapp _ SAME
ráhppá N: trapp _ trapp _ SAME
boardda N: trapp _ trapp _ SAME
tráhppá N: trapp _ trapp _ SAME
skuvlaseahkka N: skolesekk _ skolesekk _ SAME
skuvlalávka N: skolesekk _ skolesekk _ SAME
skuvlabargu N: skolearbeid _ skolearbeid _ SAME
romána N: roman _ roman _ SAME
lohkanhárjehallan N: lesetrening _ lesetrening _ SAME
geometriija N: geometri _ geometri _ SAME
spiinnebiergu N: svinekjøtt _ svinekjøtt _ SAME
stáidnár N: steinbit _ steinbit _ SAME
stáinnir N: steinbit _ steinbit _ SAME
nissonbeaivi N: kvinnedag _ kvinnedag _ SAME
iđitbiebmu N: frokost _ frokost _ SAME
iđđesbiebmu N: frokost _ frokost _ SAME
iđitborramuš N: frokost _ frokost _ SAME
huksentiŋga N: byggemateriale _ byggemateriale _ SAME
lássa N: glass _ glass; skjær som synes over vannet
dákteriggi N: skjelett _ skjelett _ SAME
ambulánsa N: ambulanse _ ambulanse _ SAME
buohccibiila N: ambulanse _ ambulanse _ SAME
buohccebiila N: ambulanse _ sykebil, ambulanse
alfabehta N: alfabet _ alfabet _ SAME
mohtorsihkkel N: motorsykkel _ motorsykkel _ SAME
advearba N: adverb _ adverb _ SAME
giellateknologiija N: språkteknologi _ språkteknologi _ SAME
beaivelatnja N: stue _ dagligstue, stue
stohpu N: stue; hus; bolig _ stue; hus
orrunlatnja N: stue _ stue _ SAME
olgoseaidni N: yttervegg _ yttervegg _ SAME
olggoš N: omslag; trekk; overflate _ omslag, trekk; overflate
jumešbealli N: tvilling _ tvilling _ SAME
šuhkoláda N: sjokolade _ sjokolade _ SAME
koaffar N: koffert _ koffert _ SAME
politihkkár N: politiker _ politiker _ SAME
politihkar N: politiker _ politiker _ SAME
stáhta N: stat _ stat _ SAME
stáda N: stat _ stat _ SAME
sámeálbmot N: samefolk _ samefolket
artista N: artist _ artist _ SAME
sámediggeáirras N: sametingsrepresentant _ sametingsrepresentant _ SAME
ekonomiija N: økonomi _ økonomi _ SAME
ruhtadilli N: økonomi _ økonomi _ SAME
direktevra N: direktør _ direktør _ SAME
advokáhta N: advokat _ advokat _ SAME
buletiija N: politi _ politi _ SAME
poliisa N: politi _ politi _ SAME
politiija N: politi _ politi _ SAME
boles N: politi _ politi _ SAME
filbmafestivála N: filmfestival _ filmfestival _ SAME
válgabiire N: valgkrets _ valgkrets _ SAME
boazoealáhus N: reindriftsnæring _ reindriftsnæring _ SAME
boazodoalloealáhus N: reindriftsnæring _ reindriftsnæring _ SAME
kulturráđđi N: kulturråd _ kulturråd _ SAME
olmmošvuoigatvuohta N: menneskerettighet _ menneskerettighet _ SAME
kulturskuvla N: kulturskole _ kulturskole _ SAME
listu N: liste _ liste _ SAME
lista N: liste _ liste _ SAME
ruovttubáiki N: hjemsted _ hjemsted _ SAME
ohcanáigemearri N: søknadsfrist _ søknadsfrist _ SAME
ohcanáigi N: søknadsfrist _ søknadsfrist _ SAME
neahttasiidu N: nettside _ nettside _ SAME
alimusriekti N: høyesterett _ høyesterett _ SAME
e-boasta N: e-post _ e-post _ SAME
e-maila N: e-post _ e-post _ SAME
e-poasta N: e-post _ e-post _ SAME
nuppástuhttinprográmma N: omstillingsprogram _ omstillingsprogram _ SAME
doaibmaplána N: handlingsplan _ handlingsplan _ SAME
ruvkedoaibma N: gruvedrift _ gruvedrift _ SAME
almmolašvuohta N: offentlighet _ offentlighet _ SAME
leansmánnekantuvra N: lensmannskontor _ lensmannskontor _ SAME
musihkkafestivála N: musikkfestival _ musikkfestival _ SAME
guovttegielalašvuohta N: tospråklighet _ tospråklighet _ SAME
guovttegielatvuohta N: tospråklighet _ tospråklighet _ SAME
válgalihttu N: valgforbund _ valgforbund _ SAME
goansta N: kunst _ kunst _ SAME
dáidda N: kunst _ kunst _ SAME
boazodoalloskuvla N: reindriftsskole _ reindriftsskole _ SAME
geafivuohta N: fattigdom _ fattigdom _ SAME
tonna N: tonn _ tonn _ SAME
sámepolitihkar N: samepolitiker _ samepolitiker _ SAME
sámepolitihkkár N: samepolitiker _ samepolitiker _ SAME
ráđđelahttu N: rådsmedlem _ rådsmedlem _ SAME
riikkastivra N: landsstyre _ landsstyre _ SAME
dáiddačájáhus N: kunstutstilling _ kunstutstilling _ SAME
reportáša N: reportasje _ reportasje _ SAME
veahtu N: hindring; hefte _ hefte, hindring
eastta N: hindring _ hindring _ SAME
mánáidruoktu N: barnehjem _ barnehjem _ SAME
dutkamuš N: forskning _ forskning _ SAME
meahccebálvalus N: fjelltjeneste _ fjelltjeneste _ SAME
festivála N: festival _ festival _ SAME
kapteaidna N: kaptein _ kaptein _ SAME
konfirmánta N: konfirmant _ konfirmant _ SAME
stivrračoahkkin N: styremøte _ styremøte _ SAME
interneahttasiidu N: internettside _ internettside _ SAME
máttasápmi N: sørsame _ sørsame _ SAME
lullisápmelaš N: sørsame _ sørsame _ SAME
máttasápmelaš N: sørsame _ sørsame _ SAME
kulturárbi N: kulturarv _ kulturarv _ SAME
turistaealáhus N: turistnæring _ turistnæring _ SAME
turismaealáhus N: turistnæring _ turistnæring _ SAME
mandáhta N: mandat _ mandat _ SAME
eanandoalloministtar N: landbruksminister _ landbruksminister _ SAME
eanadoalloministtar N: landbruksminister _ landbruksminister _ SAME
kulturdepartemeanta N: kulturdepartement _ kulturdepartement _ SAME
bellodatustit N: partifelle _ partifelle _ SAME
girjjáš N: hefte _ liten bok, hefte
beassášfestivála N: påskefestival _ påskefestival _ SAME
rukto N: rute _ rute _ SAME
ruvtto N: rute _ rute _ SAME
jurddašanvuohki N: tenkemåte _ tenkemåte _ SAME
kulturbálkkašupmi N: kulturpris _ kulturpris _ SAME
stuorradiggeáirras N: stortingsrepresentant _ stortingsrepresentant _ SAME
spábbačiekčanlihttu N: fotballforbund _ fotballforbund _ SAME
vuotnaguovlu N: fjordområde _ fjordområde _ SAME
olgoriikalaš N: utlending _ utlending _ SAME
vuođđudus N: stiftelse _ stiftelse, grunnleggelse
muitokonsearta N: minnekonsert _ minnekonsert _ SAME
fylkkadoavttir N: fylkeslege _ fylkeslege _ SAME
álbmotlihttu N: folkeforbund _ folkeforbund _ SAME
áigečála N: tidsskrift _ tidsskrift _ SAME
journalistaoahppu N: journalistutdanning _ journalistutdanning _ SAME
proavás N: prost _ prost _ SAME
nuoraidlávdegoddi N: ungdomsutvalg _ ungdomsutvalg _ SAME
luondduhálddašeapmi N: naturforvaltning _ naturforvaltning _ SAME
duiskalaš N: tysker _ tysker _ SAME
bovdehus N: invitasjon _ invitasjon _ SAME
bovdejupmi N: invitasjon _ invitasjon _ SAME
plakáhta N: plakat _ plakat _ SAME
sámeministtar N: sameminister _ sameminister _ SAME
kulturministtar N: kulturminister _ kulturminister _ SAME
ođassátta N: nyhetssending _ nyhetssending _ SAME
boazonjuovahat N: reinslakteri _ reinslakteri _ SAME
válgastivra N: valgstyre _ valgstyre _ SAME
kulturdoallu N: kulturarrangement _ kulturarrangement _ SAME
guolástusministtar N: fiskeriminister _ fiskeriminister _ SAME
dáhkki N: tak _ tak _ SAME
rohpi N: tak _ tak _ SAME
ruhtasubmi N: pengesum _ pengesum _ SAME
guovlodepartemeanta N: regionaldepartement _ regionaldepartement _ SAME
luohttámuš N: tillit _ tillit _ SAME
luohttevašvuohta N: tillit _ tillit _ SAME
dramatihkka N: dramatikk _ dramatikk _ SAME
fylkkalávdegoddi N: fylkesutvalg _ fylkesutvalg _ SAME
etáhtta N: etat _ etat _ SAME
girkočoahkkin N: kirkemøte _ kirkemøte _ SAME
boastaboksa N: postboks _ postboks _ SAME
poastaboksa N: postboks _ postboks _ SAME
kulturorganisašuvdna N: kulturorganisasjon _ kulturorganisasjon _ SAME
dutkandepartemeanta N: forskningsdepartement _ forskningsdepartement _ SAME
kultureallin N: kulturliv _ kulturliv _ SAME
dutkanbargu N: forskningsarbeid _ forskningsarbeid _ SAME
árja N: iver; energi; innsats _ energi, iver; innsats
dáiddačeahppi N: kunstner _ kunstner _ SAME
dáiddár N: kunstner _ kunstner _ SAME
máilmmisoahti N: verdenskrig _ verdenskrig _ SAME
oljofitnodat N: oljeselskap _ oljeselskap _ SAME
dáiddamusea N: kunstmuseum _ kunstmuseum _ SAME
stuoraservodat N: storsamfunn _ storsamfunn _ SAME
stuorraservodat N: storsamfunn _ storsamfunn _ SAME
eksámen N: eksamen _ eksamen _ SAME
loahppageahččaleapmi N: eksamen _ eksamen; generalprøve
oktasašorohat N: fellesbeite _ fellesbeite _ SAME
oktasašguohtun N: fellesbeite _ fellesbeite _ SAME
gieldaministtar N: kommunalminister _ kommunalminister _ SAME
álbmotjienasteapmi N: folkeavstemning _ folkeavstemning _ SAME
kulturmuitoráđđi N: kulturminneråd _ kulturminneråd _ SAME
stuorradiggedieđáhus N: stortingsmelding _ stortingsmelding _ SAME
boazopolitiija N: reinpoliti _ reinpoliti _ SAME
šiehtadallanjoavku N: forhandlingsgruppe _ forhandlingsgruppe _ SAME
páhppa N: prest _ prest _ SAME
báhppa N: prest _ prest _ SAME
diehtojuohkinhoavda N: informasjonssjef _ informasjonssjef _ SAME
bartaeaiggát N: hytteeier _ hytteeier _ SAME
skuvlafálaldat N: skoletilbud _ skoletilbud _ SAME
sotnabeaiskuvla N: søndagsskole _ søndagsskole _ SAME
minsttar N: mønster _ mønster _ SAME
historihkkár N: historiker _ historiker _ SAME
čoahkkinjođihangoddi N: møteledelse _ møteledelse _ SAME
čoahkkinjođiheapmi N: møteledelse _ møteledelse _ SAME
cáhcu N: strek _ strek _ SAME
sáhcu N: strek _ strek _ SAME
bartasadji N: hyttetomt; tomt _ hyttetomt
olgoriikkadepartemeanta N: utenriksdepartement _ utenriksdepartement _ SAME
gilišillju N: bygdetun _ bygdetun _ SAME
fuolkevuohta N: slektskap _ slektskap _ SAME
sáttogáddi N: sandstrand _ sandstrand _ SAME
skuvlastivra N: skolestyre _ skolestyre _ SAME
deaddileapmi N: trykking; opplag _ trykking
guovddášeiseváldi N: sentralmyndighet _ sentralmyndighet _ SAME
dásseárvolávdegoddi N: likestillingsutvalg _ likestillingsutvalg _ SAME
báhčinlohpi N: fellingstillatelse _ fellingstillatelse _ SAME
váldokantuvra N: hovedkontor _ hovedkontor _ SAME
mánotbadji N: måned _ måned _ SAME
mánnu N: måned _ måne; måned
lágamánniriekti N: lagmannsrett _ lagmannsrett _ SAME
lágamánneriekti N: lagmannsrett _ lagmannsrett _ SAME
sámediggelistu N: sametingsliste _ sametingsliste _ SAME
ministtarráđđi N: ministerråd _ ministerråd _ SAME
čábbodat N: skjønnhet _ skjønnhet _ SAME
ráđđehusbellodat N: regjeringsparti _ regjeringsparti _ SAME
nástegovva N: stjernebilde _ stjernebilde _ SAME
girkodepartemeanta N: kirkedepartement _ kirkedepartement _ SAME
válgaáigodat N: valgperiode _ valgperiode _ SAME
tearbma N: term _ term _ SAME
stáhtaministtar N: statsminister _ statsminister _ SAME
jorgalanbargu N: oversettelsesarbeid; oversettelse _ oversettelsesarbeid
sámediggeáigodat N: sametingsperiode _ sametingsperiode _ SAME
smávvafanas N: småbåt _ småbåt _ SAME
searvegodderáđđi N: menighetsråd _ menighetsråd _ SAME
rádiosátta N: radiosending _ radiosending _ SAME
giellastivra N: språkstyre _ språkstyre _ SAME
vuollegašvuohta N: ydmykhet _ ydmykhet _ SAME
politiijameašttir N: politimester _ politimester _ SAME
giellahálddašanguovlu N: språkforvaltningsområde _ språkforvaltningsområde _ SAME
dásseárvobálkkašupmi N: likestillingspris _ likestillingspris _ SAME
dearvvasvuođaguovddáš N: helsesenter _ helsesenter _ SAME
dearvvašvuođaguovddáš N: helsesenter _ helsesenter _ SAME
boazodoallokantuvra N: reindriftskontor _ reindriftskontor _ SAME
prošeaktabargu N: prosjektarbeid _ prosjektarbeid _ SAME
ealáhusossodat N: næringsavdeling _ næringsavdeling _ SAME
olgohivsset N: utedo _ utedo _ SAME
kulturfálaldat N: kulturtilbud _ kulturtilbud _ SAME
girkodulka N: kirketolk _ kirketolk _ SAME
eanandoallodepartemeanta N: landbruksdepartement _ landbruksdepartement _ SAME
dutkanguovddáš N: forskningssenter _ forskningssenter _ SAME
oahppomátki N: studietur _ studietur _ SAME
dihtorprográmma N: dataprogram _ dataprogram _ SAME
stáhtaráđđi N: statsråd _ statsråd _ SAME
stádaráđđi N: statsråd _ statsråd _ SAME
ráđđehusadvokáhta N: regjeringsadvokat _ regjeringsadvokat _ SAME
fylkkadiggeáirras N: fylkestingsrepresentant _ fylkestingsrepresentant _ SAME
resursaguovddáš N: ressurssenter _ ressurssenter _ SAME
mánáidfestivála N: barnefestival _ barnefestival _ SAME
sámediggepresideanta N: sametingspresident _ sametingspresident _ SAME
nohkkanlatnja N: soverom _ soverom _ SAME
oađđenlatnja N: soverom _ soverom _ SAME
politiijaguovlu N: politidistrikt _ politidistrikt _ SAME
davviguovlu N: nordområde _ nordområde _ SAME
riddoministtar N: kystminister _ kystminister _ SAME
dearvvašvuođaministtar N: helseminister _ helseminister _ SAME
reaškkas N: latter _ latter _ SAME
čohkkánsadji N: sitteplass _ sitteplass _ SAME
filbmaguovddáš N: filmsenter _ filmsenter _ SAME
TV N: fjernsyn _ TV, fjernsyn
ahki N: alder _ alder _ SAME
albmi N: himmel _ himmel _ SAME
alkohola N: alkohol _ alkohol _ SAME
allakonjunktuvra N: høykonjunktur _ høykonjunktur _ SAME
allaskuvla N: høgskole; høyskole _ høgskole
allavearru N: toppskatt _ toppskatt _ SAME
almennet N: allmenning _ allmenning _ SAME
hálti N: himmelretning; retning _ himmelretning; kurs; retning
almmiguovlu N: himmelretning _ himmelretning _ SAME
almmáiolmmoš N: mann _ mann _ SAME
dievdoolmmoš N: mann _ mann _ SAME
dievdu N: mann _ mann _ SAME
almmái N: mann _ mann _ SAME
gállis N: mann _ kall, mann
arkiivačoavdda N: arkivnøkkel _ arkivnøkkel _ SAME
artihkal N: artikkel _ artikkel _ SAME
salla N: fang _ fang, favn
fátmi N: fang _ fang _ SAME
aski N: fang _ fang _ SAME
astoáiggeklubba N: fritidsklubb _ fritidsklubb _ SAME
astoáiggeopmodat N: fritidseiendom _ fritidseiendom _ SAME
ávki N: nytte _ nytte _ SAME
áhpu N: nytte _ nytte _ SAME
gealbu N: nytte; kompetanse _ gagn, nytte; kompetanse
gávdni N: nytte _ nytte, gagn
attáldat N: gave; anlegg; evne _ gave
skeaŋka N: gave _ gave _ SAME
aviisa N: avis _ avis _ SAME
áviisa N: avis _ avis _ SAME
avvi N: belte _ belte _ SAME
boagán N: belte _ belte _ SAME
avádat N: sone _ sone _ SAME
badjebáza N: overskudd _ overskudd _ SAME
badjelbáza N: overskudd _ overskudd _ SAME
ballu N: frykt _ frykt; angst
bargguhisvuođaruhta N: arbeidsledighetstrygd _ arbeidsledighetstrygd _ SAME
bargiidlihkadus N: arbeiderbevegelse _ arbeiderbevegelse _ SAME
bargoaddidivat N: arbeidsgiveravgift _ arbeidsgiveravgift _ SAME
bargobihttá N: arbeidsoppgave; oppgave _ arbeidsoppgave
bargobiras N: arbeidsmiljø _ arbeidsmiljø _ SAME
bargojoavku N: arbeidsgruppe; utvalg _ utvalg, arbeidsgruppe
bargolatnja N: arbeidsrom _ arbeidsrom _ SAME
bargomárkan N: arbeidsmarked _ arbeidsmarked _ SAME
bargonoađđi N: arbeidsbyrde _ arbeidsbyrde _ SAME
bargoplána N: arbeidsplan _ arbeidsplan _ SAME
bargoriekti N: arbeidsrett _ arbeidsrett _ SAME
bargoáigi N: arbeidstid _ arbeidstid _ SAME
barta N: hytte _ hytte _ SAME
bassebeaivi N: helligdag _ helligdag _ SAME
beahci N: furu _ furu _ SAME
beaiveruhta N: dagpenger _ dagpenger _ SAME
beaivi N: dag _ dag; sol
bealgi N: tommelfinger _ tommelfinger, tommel; stortå
beallji N: øre _ øre; svømmefinne
evre N: øre _ øre _ SAME
beana N: hund _ hund _ SAME
čeahborbeaska N: pesk _ pesk, tykk pesk, pesk av tykt høstskinn
beaska N: pesk _ pesk _ SAME
suollemassátni N: passord _ passord _ SAME
beassansátni N: passord _ passord _ SAME
beavdegirjelasáhus N: protokolltilførsel _ protokolltilførsel _ SAME
beavdi N: bord; pult _ bord
bordi N: bord; rekke _ bord; rekke; skranke
bellodat N: parti _ parti _ SAME
bensiidna N: bensin _ bensin _ SAME
bensinstašuvdna N: bensinstasjon _ bensinstasjon _ SAME
girjerájus N: bibliotek _ bibliotek _ SAME
girjerádju N: bibliotek _ bibliotek _ SAME
bibliotehka N: bibliotek _ bibliotek _ SAME
biebmu N: mat _ mat, føde
borramuš N: mat _ mat _ SAME
biegga N: vind _ vind _ SAME
bierdna N: bjørn _ bjørn _ SAME
guovža N: bjørn _ bjørn _ SAME
diggi N: ting; rett _ ting, rett; tinglyd
diŋga N: ting _ ting _ SAME
tiŋga N: ting _ ting _ SAME
ášši N: sak _ sak _ SAME
sálga N: kjøttstykke _ kjøttstykke _ SAME
biergohaddi N: kjøttpris _ kjøttpris _ SAME
oažži N: kjøtt; muskel _ kjøtt; kjød, legeme; muskel
biergu N: kjøtt _ kjøtt _ SAME
bievlavuoján N: barmarkskjøretøy _ barmarkskjøretøy _ SAME
moallu N: bit _ smule, bit
binná N: bit _ bit, stykke; liten flokk
bihtánsámegiella N: pitesamisk _ pitesamisk _ SAME
biila N: bil _ bil _ SAME
divohat N: verksted _ verksted _ SAME
birasviessu N: miljøbygg _ miljøbygg _ SAME
birranbeaivi N: døgn _ døgn _ SAME
jándor N: døgn _ døgn _ SAME
bisma N: biskop _ biskop _ SAME
molssodanlatnja N: garderobe _ stellerom; garderobe
bivttasheŋgehat N: garderobe _ garderobe _ SAME
lasta N: blad _ løv, blad
poasta N: post _ post _ SAME
boasta N: post _ post _ SAME
boazodoalloláhka N: reindriftslov _ reindriftslov _ SAME
boazodoallostivra N: reindriftsstyre _ reindriftsstyre _ SAME
boazodoallošiehtadus N: reindriftsavtale _ reindriftsavtale _ SAME
boazolohku N: reintall _ reintall _ SAME
boazoáidi N: reingjerde _ reingjerde _ SAME
boađus N: resultat _ resultat _ SAME
bohccobiergu N: reinkjøtt _ reinkjøtt _ SAME
ráidu N: rekke; serie; rekkefølge; kolonne _ raid, rekke; serie; kolonne
borgemánnu N: august _ august _ SAME
reive N: brev _ brev _ SAME
breava N: brev _ brev _ SAME
šoavva N: brus; sus _ sus, brus
šávva N: brus _ brus _ SAME
juhca N: brus; sus _ sus, brus
bruvsa N: brus _ brus _ SAME
buolaš N: kulde _ kulde, frost
buolva N: generasjon _ slektsledd, generasjon; kne
sohkabuolva N: generasjon _ slektsledd, generasjon
bustávva N: bokstav; tegn _ bokstav
buvru N: grøt _ grøt _ SAME
suohkat N: grøt _ grøt _ SAME
buđet N: potet _ potet _ SAME
bábir N: papir _ papir _ SAME
bádja N: vadmel _ vadmel _ SAME
gákkis N: vadmel _ vadmel _ SAME
báhti N: gryte _ gryte _ SAME
ruitu N: gryte _ gryte _ SAME
báidnu N: farge _ farge, maling
ivdni N: farge _ farge _ SAME
báikenamma N: stedsnavn _ stedsnavn _ SAME
báiki N: sted _ sted, heim
bálddis N: kveite _ kveite _ SAME
máksu N: betaling; betydning _ betaling; betydning _ SAME
bárdni N: sønn; gutt _ gutt; sønn
bárku N: bark _ bark _ SAME
bárra N: par _ par _ SAME
párra N: par _ par _ SAME
bátnedoavttir N: tannlege _ tannlege _ SAME
bávččas N: smerte _ smerte _ SAME
vuoissahat N: smerte _ sting, smerte
gihpu N: smerte _ smerte _ SAME
báŋku N: bank _ bank _ SAME
gráda N: grad _ grad _ SAME
cealkka N: setning; uttrykk _ setning; uttrykk _ SAME
cuoŋománnu N: april _ april _ SAME
savu N: kulp _ kulp, stilleflytende strekning i elva
savvon N: kulp _ kulp _ SAME
dappal N: kulp _ kulp, bakevje
jorbmi N: kulp _ djup kulp; myrhull
darfegoahti N: torvgamme _ torvgamme _ SAME
darfi N: torv _ torv _ SAME
lavdnji N: torv _ torv _ SAME
daŋas N: lyng _ lyng _ SAME
teadja N: te _ te _ SAME
deadja N: te _ te _ SAME
deahkki N: muskel _ muskel _ SAME
departemeanta N: departement _ departement _ SAME
diehtemeahttunvuohta N: uvitenhet _ uvitenhet _ SAME
dieđa N: vitenskap; kunnskap _ vitenskap
dieđáhus N: melding _ melding _ SAME
diggegoddi N: tingrett _ tingrett _ SAME
dihtorspeallu N: dataspill _ dataspill _ SAME
tiibma N: time _ time, klokke
tiibmu N: time _ time; ur, klokke
juksu N: hyse _ hyse _ SAME
diksu N: hyse _ hyse, kolje
dikta N: dikt _ dikt _ SAME
maŋŋebárga N: tirsdag _ tirsdag _ SAME
disdat N: tirsdag _ tirsdag _ SAME
vearru N: avgift; skatt _ skatt, avgift
divat N: avgift _ avgift _ SAME
divri N: insekt _ dyr, insekt
doaivva N: håp _ håp _ SAME
doaivu N: håp; tro _ håp
doardna N: tårn _ tårn _ SAME
toardna N: tårn _ tårn _ SAME
doavttir N: lege _ lege, doktor
dolla N: bål; ild _ bål, ild
dovdu N: følelse; erfaring _ følelse; erfaring _ SAME
dronnet N: dronning _ dronning _ SAME
dulka N: tolk _ tolk _ SAME
dulvi N: flom _ flom _ SAME
duogáš N: bakgrunn _ bakgrunn _ SAME
tuollu N: toll _ toll _ SAME
duollu N: toll; toll _ tele; toll
duolva N: skitt _ smuss, skitt
luhča N: skitt _ skitt, avføring, søle
riekti N: domstol; rett; rett; rettighet _ rett, domstol
duopmostuollu N: domstol _ domstol _ SAME
duopmár N: dommer _ dommer _ SAME
duorastat N: torsdag _ torsdag _ SAME
duottarstohpu N: fjellstue _ fjellstue _ SAME
fearrán N: hendelse _ hending, hendelse
dálki N: vær _ vær _ SAME
vierca N: vær _ vær _ SAME
fierca N: vær _ vær _ SAME
viessu N: hus; bolig _ hus
dálvi N: vinter _ vinter _ SAME
dárbu N: behov _ behov _ SAME
dássi N: nivå _ jamnhøyde; nivå
dáža N: nordmann _ nordmann _ SAME
dáčča N: nordmann _ nordmann, svenske
eahket N: kveld _ kveld _ SAME
eanu N: onkel _ onkel _ SAME
čeahci N: onkel _ onkel _ SAME
eahki N: onkel _ onkel _ SAME
eahpeluohttámuš N: mistillit _ mistillit _ SAME
eahpedorvu N: mistillit _ mistillit _ SAME
eahpeluohttámuševttohus N: mistillitsforslag _ mistillitsforslag _ SAME
eahpádus N: tvil _ tvil; betenkelighet, skepsis
sarvva N: elg _ elg _ SAME
ealga N: elg _ elg _ SAME
eallin N: liv _ liv, leven
heagga N: liv _ liv _ SAME
eallindilálašvuohta N: livssituasjon; levekår _ livssituasjon
eallindilli N: livssituasjon; levekår _ livssituasjon
eallingeardi N: livsløp _ livsløp _ SAME
eallu N: flokk; reinflokk _ flokk, reinflokk
boazoeallu N: reinflokk _ reinflokk _ SAME
eallinláibi N: levebrød _ levebrød _ SAME
eallámuš N: levebrød _ levebrød _ SAME
ealáhusfoanda N: næringsfond _ næringsfond _ SAME
ealáhuspolitihkka N: næringspolitikk _ næringspolitikk _ SAME
áhkká N: kone _ hustru, kone
gálgu N: kone _ kone, hustru
eamit N: kone _ hustru, kone
eatnandoallu N: jordbruk _ jordbruk _ SAME
eanadoallu N: jordbruk; landbruk _ jordbruk
eanandoallu N: jordbruk; landbruk _ jordbruk
eananspábba N: jordklode; jord _ jordklode
eatnanspábba N: jordklode _ jordklode _ SAME
eanetlohku N: flertall _ flertall _ SAME
eatnigiella N: morsmål _ morsmål _ SAME
eiseváldi N: myndighet _ myndighet _ SAME
ekologiija N: økologi _ økologi _ SAME
ekonoma N: økonom _ økonom _ SAME
elliidsuodjaleapmi N: dyrevern _ dyrevern _ SAME
erenoamášoahpahus N: spesialundervisning _ spesialundervisning _ SAME
erenoamášpedagogihkka N: spesialpedagogikk _ spesialpedagogikk _ SAME
eretcealkin N: oppsigelse _ oppsigelse _ SAME
etihkka N: etikk _ etikk _ SAME
evangelium N: evangelium _ evangelium _ SAME
eŋgel N: engel _ engel _ SAME
čiehka N: krok _ hjørne, krok
faggi N: krok _ krok, knagg
roahkki N: krok; hake _ krok, hake; hektekrok, malje
vanca N: båt _ båt _ SAME
vanas N: båt _ båt _ SAME
fanas N: båt; fartøy _ båt
fiila N: fil _ fil _ SAME
filbma N: film _ film _ SAME
finjučála N: kursiv _ kursiv _ SAME
firkkal N: forkle _ forkle _ SAME
foanda N: fond _ fond _ SAME
foarbma N: form _ form _ SAME
friddjaminuhtta N: friminutt _ friminutt _ SAME
friijaminuhtta N: friminutt _ friminutt _ SAME
fylka N: fylke _ fylke _ SAME
fylkkagielda N: fylkeskommune _ fylkeskommune _ SAME
fylkkasuohkan N: fylkeskommune _ fylkeskommune _ SAME
fylkkamánni N: fylkesmann _ fylkesmann _ SAME
fága N: fag _ fag _ SAME
fágasearvi N: fagforening _ fagforening _ SAME
fáhcca N: vott _ vott _ SAME
fápmu N: makt; kraft; styrke _ makt, styrke
fáttar N: fadder _ fadder _ SAME
risváhnen N: fadder _ fadder _ SAME
gahpir N: lue _ lue _ SAME
galbmaskábe N: kjøleskap _ kjøleskap _ SAME
ganjal N: tåre _ tåre _ SAME
gaskaahki N: middelalder _ middelalder _ SAME
gaskaáigi N: middelalder _ middelalder _ SAME
gaskafága N: mellomfag _ mellomfag _ SAME
gaskavahkku N: onsdag _ onsdag _ SAME
gassačoalli N: tykktarm _ tykktarm _ SAME
dopmu N: støv _ støv _ SAME
gavja N: støv _ støv _ SAME
gažaldat N: spørsmål _ spørsmål _ SAME
jearaldat N: spørsmål _ spørsmål _ SAME
geahpis N: lunge _ lunge _ SAME
geallir N: kjeller _ kjeller _ SAME
keallir N: kjeller _ kjeller _ SAME
geasseluopmu N: sommerferie _ sommerferie _ SAME
geassemánnu N: juni _ juni _ SAME
geassi N: sommer _ sommer _ SAME
geatki N: jerv _ jerv _ SAME
ovddasvástádus N: ansvar _ ansvar _ SAME
gielda N: kommune _ kommune; sogn
suohkan N: kommune _ kommune; sogn; herred
gielddaráđđehus N: kommunestyre _ kommunestyre _ SAME
gielddastivra N: kommunestyre _ kommunestyre _ SAME
suohkanstivra N: kommunestyre _ kommunestyre _ SAME
gielis N: løgn _ løgn; løgner
giellafága N: språkfag _ språkfag _ SAME
giellaprošeakta N: språkprosjekt _ språkprosjekt _ SAME
giellaráđđi N: språkråd _ språkråd _ SAME
skállu N: bøtte _ bøtte _ SAME
kievkkan N: kjøkken _ kjøkken _ SAME
gievkkan N: kjøkken _ kjøkken _ SAME
gievkkanhoavda N: kjøkkensjef _ kjøkkensjef _ SAME
gikta N: skyss _ synkestein, vekt; skyss
sáhttu N: skyss _ skyss _ SAME
siidu N: side _ side _ SAME
gilga N: side _ side _ SAME
gilisearvi N: bygdelag _ bygdelag _ SAME
giliskuvla N: grendeskole _ grendeskole _ SAME
gilvu N: konkurranse; kamp _ konkurranse
gilvvohallan N: konkurranse _ konkurranse _ SAME
gilvva N: sæd _ sæd, frø
gilvvagárdi N: hage _ hage _ SAME
ginttal N: stearinlys _ talglys, stearinlys
girji N: bok _ bok; brev; flekk i pelsen
girjjálašvuohta N: litteratur _ litteratur _ SAME
kirku N: kirke _ kirke _ SAME
girku N: kirke _ kirke _ SAME
giđđa N: vår _ vår _ SAME
goarrunmašiidna N: symaskin _ symaskin _ SAME
goaskin N: ørn _ ørn _ SAME
neahkameahttun N: spøkelse _ spøkelse _ SAME
gobmi N: spøkelse _ spøkelse _ SAME
goikeguolli N: tørrfisk _ klippfisk; tørrfisk
golggotmánnu N: oktober _ oktober _ SAME
gonagasbárdni N: prins _ kongssønn, prins
prinsa N: prins _ prins _ SAME
gordni N: korn _ korn _ SAME
gorrelohku N: forholdstall _ forholdstall _ SAME
guorssahat N: hoste _ hoste _ SAME
gosahat N: hoste _ hoste _ SAME
govdodat N: bredde _ bredde _ SAME
lahttu N: medlem _ medlem, lem
miellahttu N: medlem _ medlem _ SAME
gullevašvuohta N: identitet; tilknytning _ tilhørighet; identitet
identitehta N: identitet _ identitet _ SAME
gullu N: hørsel _ hørsel _ SAME
gummestevvel N: gummistøvel _ gummistøvel _ SAME
stálpi N: ulv _ ulv _ SAME
gumpe N: ulv _ ulv _ SAME
guoika N: stryk _ stryk, fossestryk
guoksa N: melke _ melke _ SAME
guolbi N: golv _ jordgolv, golv
lieksi N: tran _ tran _ SAME
guolevuodja N: tran _ fiskeleverolje, tran
guopparas N: svamp _ svamp _ SAME
guossa N: gran _ gran _ SAME
guovvamánnu N: februar _ februar _ SAME
kursa N: kurs _ kurs _ SAME
gursa N: kurs _ kurs _ SAME
gussa N: ku _ ku _ SAME
gutna N: aske _ aske _ SAME
guvžá N: sjøaure _ sjøaure, sjøørret
gužža N: urin _ tiss, urin
gáddenuohtti N: landnot _ landnot _ SAME
káffe N: kaffe _ kaffe _ SAME
gáffe N: kaffe _ kaffe _ SAME
gáhkku N: kake _ kake _ SAME
gáhttu N: katt _ hustak; katt
gáica N: geit _ geit _ SAME
ája N: kilde _ kilde _ SAME
gáldu N: kilde _ kilde _ SAME
gálla N: kål _ kål _ SAME
gálvobiila N: varebil _ varebil _ SAME
gámmár N: rom _ kammer, rom
áidi N: gjerde _ gjerde _ SAME
gárdi N: gjerde _ innhegning; gjerde; rypesnare med risgjerde
kárta N: kart _ kart _ SAME
gárta N: kart _ kart _ SAME
gásta N: dåp _ dåp _ SAME
gávppašeapmi N: handel; omsetning _ handel
gávpot N: by _ by _ SAME
bálkkašupmi N: pris _ pris, belønning, premie
haddi N: pris _ pris _ SAME
headjaskeaŋka N: bryllupsgave _ bryllupsgave _ SAME
heahpat N: skam _ skam _ SAME
heahtedoarjja N: krisehjelp _ krisehjelp _ SAME
heahti N: nød _ nød _ SAME
heasta N: hest _ hest _ SAME
vuoján N: hest; kjøretøy _ kjørerein; hest
hiida N: helvete _ helvete _ SAME
helvet N: helvete _ helvete _ SAME
hersko N: delikatesse _ delikatesse; god mat
hivsset N: do _ do, WC, toalett
hiŋggal N: bås _ bås _ SAME
hoahkan N: regle; rim _ regle
hoammá N: dreng _ same vestfra; dreng, arbeidskar
reaŋga N: dreng _ dreng _ SAME
homofiliija N: homofili _ homofili _ SAME
hutkáivuohta N: kreativitet _ kreativitet _ SAME
hábmen N: utforming _ utforming _ SAME
háhcci N: skritt _ skrev, skritt
lávki N: skritt _ løk; skritt, steg
háhtta N: hatt _ hatt _ SAME
hálddašanláhka N: forvaltningslov _ forvaltningslov _ SAME
hálddahusláhka N: forvaltningslov _ forvaltningslov _ SAME
hálddašeapmi N: forvaltning _ forvaltning _ SAME
hápman N: havn _ havn _ SAME
hástalus N: utfordring _ utfordring _ SAME
hávdi N: grav _ grav _ SAME
idja N: natt _ natt _ SAME
illu N: glede _ glede _ SAME
institušuvdna N: institusjon _ institusjon _ SAME
interneahtta N: internett _ internett _ SAME
internáhtta N: internat _ internat _ SAME
moarsi N: kjæreste _ kjæreste; brud
irgi N: kjæreste _ kjæreste; frier; brudgom
iđit N: morgen _ morgen _ SAME
jahkebealli N: halvår _ halvår _ SAME
jahkegeahččaleapmi N: årsprøve _ årsprøve _ SAME
jahkečoahkkin N: årsmøte _ årsmøte _ SAME
jahki N: år _ år _ SAME
jeaggi N: myr _ myr _ SAME
jeđđehus N: trøst _ trøst _ SAME
jiekŋa N: is _ is _ SAME
jienastanlihppu N: stemmeseddel _ stemmeseddel _ SAME
jietna N: stemme _ lyd; stemme
joavkobargu N: gruppearbeid _ gruppearbeid _ SAME
joavkočoahkkin N: gruppemøte _ gruppemøte _ SAME
journalista N: journalist _ journalist _ SAME
jođas N: kabel _ kabel _ SAME
šuvva N: sus _ sus _ SAME
julggaštus N: erklæring _ erklæring; manifest
juolgemihttu N: fot _ fot _ SAME
juovlafeasta N: julefest _ julefest _ SAME
juovlagoarta N: julekort _ julekort _ SAME
juovlakoarta N: julekort _ julekort _ SAME
juovlaluopmu N: juleferie _ juleferie _ SAME
juovlaruohtta N: julaften _ julaften _ SAME
juovlastállu N: julenisse _ julenisse _ SAME
jurdda N: tanke; ide; idé _ tanke
jáffu N: mel; melsekk _ mel
jáhkka N: jakke _ jakke _ SAME
kantuvra N: kontor _ kontor _ SAME
kloáhkka N: kloakk _ kloakk _ SAME
skuvlalatnja N: klasserom _ klasserom _ SAME
luohkkálatnja N: klasserom _ klasserom _ SAME
klássalatnja N: klasserom _ klasserom _ SAME
kommišuvdna N: kommisjon _ kommisjon _ SAME
konsearta N: konsert _ konsert _ SAME
risttalašvuohta N: kristendom _ kristendom _ SAME
kristtalašvuohta N: kristendom _ kristendom _ SAME
ruvdnu N: krone _ krone _ SAME
kruvdna N: krone _ krone _ SAME
ránnjá N: nabo _ nabo _ SAME
kránnjá N: nabo _ nabo _ SAME
siidaguoibmi N: nabo _ nabo _ SAME
kulturfoanda N: kulturfond _ kulturfond _ SAME
kultuvra N: kultur _ kultur _ SAME
kántorhoavda N: kontorsjef _ kontorsjef _ SAME
lagasbiras N: nærmiljø _ nærmiljø _ SAME
lagašbiras N: nærmiljø _ nærmiljø _ SAME
lahkki N: halvdel _ halvdel, halvpart
lassigollu N: merutgift _ merutgift _ SAME
lasseárvu N: merverdi _ merverdi _ SAME
lađas N: ledd _ ledd _ SAME
leansmánni N: lensmann _ lensmann _ SAME
leavga N: flagg _ flagg; fane
leavgastággu N: flaggstang _ flaggstang _ SAME
liepma N: buljong _ buljong _ SAME
lieđđi N: blomst _ blomst _ SAME
lihkku N: lykke _ lykke _ SAME
roassu N: ulykke _ ulykke; tap
lihkohisvuohta N: ulykke _ ulykke _ SAME
lihkuhisvuohta N: ulykke _ ulykke _ SAME
linjála N: linjal _ linjal _ SAME
loddi N: fugl _ fugl _ SAME
logeš N: tier _ titall, tier
logus N: lesestoff _ lesestoff _ SAME
lohkamuš N: lesestoff _ lesestoff _ SAME
lohku N: tall; antall _ tall, antall
láhka N: lov _ lov; lake
máddi N: sør _ sør _ SAME
lulli N: sør _ sør _ SAME
davvisápmi N: nordsame _ nordsame _ SAME
davvisápmelaš N: nordsame _ nordsame _ SAME
luondu N: natur; karakter _ natur; karakter _ SAME
árvosátni N: karakter _ karakter _ SAME
luopmu N: ferie _ ferie _ SAME
luossa N: laks _ laks _ SAME
luossabivdu N: laksefiske _ laksefiske _ SAME
láddelaš N: kven _ finne, kven; svenske
kvena N: kven _ kven _ SAME
láibevajahas N: brødskive _ brødskive _ SAME
láibi N: brød _ brød _ SAME
láivi N: skip _ skip _ SAME
skiipa N: skip; fartøy _ skip
lámpu N: lampe _ lampe _ SAME
lámpá N: lampe _ lampe _ SAME
lávdi N: scene; plattform _ scene; plattform; podium
lávvardat N: lørdag _ lørdag _ SAME
lávvordat N: lørdag _ lørdag _ SAME
ávju N: egg _ egg _ SAME
manni N: egg _ egg _ SAME
monni N: egg _ egg _ SAME
mašiidna N: maskin _ maskin _ SAME
mearaguolli N: saltvannsfisk _ saltvannsfisk _ SAME
mearraguolli N: saltvannsfisk _ saltvannsfisk _ SAME
mearkkašupmi N: betydning; merknad _ betydning; merknad _ SAME
mearra N: hav; sjø _ hav, sjø
áhpi N: hav _ vid myrstrekning, treløs slette; hav
mearrasápmi N: sjøsame _ sjøsame _ SAME
mearrasápmelaš N: sjøsame _ sjøsame _ SAME
skáhpi N: rogn _ rogn, rognetre
meađđen N: rogn _ rogn _ SAME
mehter N: meter _ meter _ SAME
oaivil N: mening _ mening _ SAME
meinnet N: mening _ mening _ SAME
miehkki N: sverd _ sverd _ SAME
mielki N: melk _ melk _ SAME
skoaddu N: tåke _ skodde, tåke
mierká N: tåke _ tåke, skodde
miessemánnu N: mai _ mai _ SAME
ministtar N: minister _ minister _ SAME
minuhtta N: minutt _ minutt _ SAME
modji N: smil _ smil _ SAME
mutuvra N: motor _ motor _ SAME
mohtor N: motor _ motor _ SAME
mátta N: rot _ rot; nederste del
moivi N: rot _ rot, grums
máddu N: rot _ rot; opprinnelse
ruohtas N: rot; opprinnelse _ rot
kulturmuitu N: kulturminne _ kulturminne _ SAME
muitu N: minne _ minne, hukommelse
nierra N: kinn _ kinn _ SAME
muohtu N: kinn _ kinn _ SAME
muorji N: bær _ bær _ SAME
musihkka N: musikk _ musikk _ SAME
vuossárga N: mandag _ mandag _ SAME
mánnodat N: mandag _ mandag _ SAME
mánáidboddu N: barnetime _ barnetime _ SAME
mánáidgárdi N: barnehage _ barnehage _ SAME
mánáidmánná N: barnebarn _ barnebarn _ SAME
áhkkut N: barnebarn _ barnebarn _ SAME
áddjut N: barnebarn _ barnebarn _ SAME
márfi N: pølse _ pølse _ SAME
čoahkkebáiki N: tettsted _ tettsted _ SAME
reaisu N: reise _ reise _ SAME
namma N: navn _ navn _ SAME
neavttár N: skuespiller _ skuespiller _ SAME
ráđđi N: råd _ råd _ SAME
neavva N: råd; anbefaling _ råd, formaning
niehkki N: nakke _ nakke _ SAME
niski N: nakke _ nakke _ SAME
niehku N: drøm _ drøm _ SAME
niibeboagán N: knivbelte _ knivbelte, belte med kniv
niibi N: kniv _ kniv _ SAME
nisu N: kvinne _ kvinne _ SAME
nissonolmmoš N: kvinne _ kvinne _ SAME
nisson N: kvinne _ kvinne _ SAME
njukčamánnu N: mars _ mars _ SAME
njunni N: nese _ nese _ SAME
njuovvanrusttet N: slakteri _ slakteri _ SAME
njuovahat N: slakteri _ slakteri _ SAME
njuovčča N: tunge _ tunge _ SAME
njárga N: nes _ nes; halvøy
nummir N: nummer _ nummer _ SAME
nummar N: nummer _ nummer _ SAME
nummár N: nummer _ nummer _ SAME
nuohtti N: not _ not _ SAME
nuoraidskuvla N: ungdomsskole _ ungdomsskole _ SAME
návet N: fjøs _ fjøs _ SAME
návste N: naust _ naust; skjul, skur
návstu N: naust _ naust _ SAME
oabbá N: søster; søsken _ søster
oahpahus N: undervisning; utdanning; opplæring _ undervisning
oaivegávpot N: hovedstad _ hovedstad _ SAME
oaivi N: hode _ hode _ SAME
oaksi N: grein; kvist _ grein, kvist
oamedovdu N: samvittighet _ samvittighet _ SAME
oarra N: snøre _ snøre, tau
olgoriika N: utland _ utlandet
olju N: olje _ olje _ SAME
organisašuvdna N: organisasjon _ organisasjon _ SAME
orgána N: organ _ organ _ SAME
ossodat N: avdeling; andel _ andel; avdeling
ovdamearka N: eksempel _ eksempel _ SAME
ođas N: nyhet _ nyhet _ SAME
ođđajagemánnu N: januar _ januar _ SAME
plána N: plan _ plan _ SAME
politihkka N: politikk _ politikk _ SAME
preassadieđáhus N: pressemelding _ pressemelding _ SAME
prográmma N: program _ program _ SAME
proseanta N: prosent _ prosent _ SAME
páhkka N: pakke _ pakke _ SAME
ragat N: brunst _ brunst _ SAME
ragatáigi N: brunst _ brunst _ SAME
raporta N: rapport _ rapport _ SAME
reahka N: slede _ slede _ SAME
riegádanbeaiskeaŋka N: bursdagsgave _ fødselsdagsgave, bursdagsgave
rievssat N: rype; lirype _ rype, lirype
rihppaskuvla N: konfirmasjonsskole _ konfirmasjonsskole _ SAME
riikkajoavku N: landslag _ landslag _ SAME
risku N: sølje _ sølje _ SAME
solju N: sølje _ sølje _ SAME
rista N: kors _ kors _ SAME
ristáhčči N: gudfar _ gudfar _ SAME
riššu N: dusj _ dusj _ SAME
rovvi N: bru _ enkel bru; bru; stoppskive
šaldi N: bru; bro _ bru
ruovdi N: jern _ jern _ SAME
ruovttusiidu N: hjemmeside _ hjemmeside _ SAME
ruošša N: russer _ russer _ SAME
ruvke N: gruve; verk _ gruve
rádji N: grense _ grense _ SAME
rádjá N: grense _ grense _ SAME
ráhkesvuohta N: kjærlighet _ kjærlighet _ SAME
ráhkisvuohta N: kjærlighet _ kjærlighet _ SAME
rávdi N: smed _ smed _ SAME
ráđđealmmái N: rådmann _ rådmann _ SAME
gielddahoavda N: rådmann _ rådmann _ SAME
ráđđeolmmái N: rådmann _ rådmann _ SAME
ráđđehus N: regjering _ regjering _ SAME
ráđđeviessu N: rådhus _ rådhus _ SAME
sahá N: sag _ sag _ SAME
sarrit N: blåbær _ blåbær _ SAME
seaidni N: vegg _ vegg _ SAME
sealgi N: rygg _ rygg _ SAME
searvi N: forening; selskap _ forening, selskap
seaŋga N: seng _ seng _ SAME
seminára N: seminar _ seminar _ SAME
sihkkel N: sykkel _ sykkel _ SAME
silba N: sølv _ sølv _ SAME
silki N: silke _ silke; silketørkle
sirpe N: sigd _ sigd _ SAME
siseana N: innland _ innland _ SAME
sudja N: årsak; grunn _ årsak, grunn; skyld
sivva N: årsak; grunn _ grunn, årsak
skuvla N: skole _ skole _ SAME
skuvlabeaivi N: skoledag _ skoledag _ SAME
skuvlatiibma N: skoletime _ skoletime _ SAME
skuvladiibmu N: skoletime _ skoletime _ SAME
skuvlafága N: skolefag _ skolefag _ SAME
skuvlajahki N: skoleår _ skoleår _ SAME
skuvlašillju N: skolegård _ skolegård _ SAME
skábmamánnu N: november _ november _ SAME
skárfa N: skarv _ skarv _ SAME
soabbi N: stav _ stav, kjepp
soahki N: bjørk _ bjørk _ SAME
šiehtadus N: avtale _ avtale _ SAME
soahti N: krig _ krig _ SAME
soalddát N: soldat _ soldat _ SAME
sohkabealli N: kjønn _ kjønn _ SAME
sohkar N: sukker _ sukker _ SAME
sotnabeaivi N: søndag _ søndag _ SAME
speadjal N: speil _ speil _ SAME
speajal N: speil _ speil _ SAME
speallu N: spill _ spill _ SAME
spábba N: ball _ ball _ SAME
spáiddar N: fakkel _ fakkel, bluss
spánnja N: spann _ spann _ SAME
stoagus N: leke; lek _ leke, leketøy
čuolda N: stolpe _ stolpe _ SAME
stoalpu N: stolpe _ stolpe _ SAME
viessogálvu N: møbel _ møbel _ SAME
strategiija N: strategi _ strategi _ SAME
studeanta N: student _ student _ SAME
stuollu N: stol _ stol _ SAME
stállja N: stall _ stall _ SAME
stávval N: stavelse _ stavelse _ SAME
summá N: sum _ sum _ SAME
submi N: sum; beløp _ sum
suddu N: synd _ synd _ SAME
suolu N: øy _ øy, holme
suomagiella N: finsk _ finsk _ SAME
suorbma N: finger _ finger _ SAME
sáidi N: sei _ sei _ SAME
sálbma N: salme _ salme _ SAME
sálbmagirji N: salmebok _ salmebok _ SAME
sámediggejoavku N: sametingsgruppe _ sametingsgruppe _ SAME
sámegielkursa N: samiskkurs _ samiskkurs _ SAME
sámeláhka N: samelov _ sameloven
sámepolitihkka N: samepolitikk _ samepolitikk _ SAME
sámil N: mose _ mose _ SAME
sápmi N: same _ same _ SAME
sápmelaš N: same _ same _ SAME
sátnegirji N: ordbok _ ordbok _ SAME
sátneluohkká N: ordklasse _ ordklasse _ SAME
sátni N: ord _ ord _ SAME
sátta N: sending _ sending _ SAME
sáttobábir N: sandpapir _ sandpapir _ SAME
sávdni N: dampbad _ dampbad, sauna
sávdnji N: søm _ søm; badstue
sávza N: sau _ sau _ SAME
teaksta N: tekst _ tekst _ SAME
tealtá N: telt _ telt _ SAME
teknihkkár N: tekniker _ tekniker _ SAME
telefovdna N: telefon _ telefon _ SAME
telegrámma N: telegram _ telegram _ SAME
teáhter N: teater _ teater _ SAME
toga N: tog _ tog _ SAME
linnjábiila N: tog _ rutebuss; tog
tráktor N: traktor _ traktor _ SAME
turista N: turist _ turist _ SAME
távval N: tavle _ tavle _ SAME
uksa N: dør _ dør _ SAME
ulbmil N: formål; mål _ mål, formål
universitehta N: universitet _ universitet _ SAME
universiteahtta N: universitet _ universitet _ SAME
uvja N: dun _ dun _ SAME
vahkku N: uke _ uke _ SAME
vahát N: skade; tap; uhell _ skade, tap; uhell, vanvare
varra N: blod _ blod _ SAME
vašši N: hat _ hat _ SAME
veahkki N: hjelp _ hjelp _ SAME
veaiki N: kobber _ kobber _ SAME
vealgi N: gjeld _ gjeld _ SAME
vearju N: våpen _ våpen _ SAME
vejolašvuohta N: mulighet _ mulighet _ SAME
vihtan N: vitne _ vitne _ SAME
vilba N: fetter _ fetter; tremenning
vilbealle N: fetter; søskenbarn _ fetter
virgi N: embete; stilling _ stilling, embete
vuodja N: smør _ smør, fett
vuokta N: hår _ hår _ SAME
vuolla N: øl _ øl _ SAME
vuola N: øl _ øl _ SAME
vuolgga N: avreise; opprinnelse _ opprinnelse; start; avreise
vuorbi N: skjebne _ lodd, skjebne
eallinvuorbi N: skjebne _ skjebne _ SAME
vuotna N: fjord _ fjord _ SAME
vuovdi N: skog _ skog _ SAME
vuođđoealáhus N: primærnæring _ basisnæring, primærnæring
vuođđoláhka N: grunnlov _ grunnloven
vuođđoskuvla N: grunnskole _ grunnskole _ SAME
váibmu N: hjerte _ hjerte _ SAME
váldoášši N: hovedsak _ hovedsak _ SAME
presideanta N: president _ president _ SAME
vástádus N: svar _ svar _ SAME
vásáhus N: opplevelse; erfaring _ opplevelse
áddjá N: bestefar _ bestefar; gammel mann
áhkku N: bestemor _ bestemor; eldre kvinne
áhčči N: far _ far _ SAME
áibmu N: luft _ luft _ SAME
áigi N: tid _ tid _ SAME
áitta N: trussel _ trussel _ SAME
ákšu N: øks _ øks _ SAME
álbmot N: folk; befolkning _ folk
álbmotmusihkka N: folkemusikk _ folkemusikk _ SAME
álbmotriekti N: folkerett _ folkerett _ SAME
álbmotčoahkkin N: folkemøte _ folkemøte _ SAME
álgu N: begynnelse; opprinnelse _ begynnelse
ámtamánni N: amtmann _ amtmann _ SAME
árba N: arr _ arr _ SAME
árbbolaš N: arving _ arving _ SAME
árbevierru N: tradisjon _ tradisjon _ SAME
árbi N: arv _ arv _ SAME
árbmu N: nåde _ nåde; amnesti
árgabeaivi N: hverdag _ hverdag _ SAME
árga N: hverdag _ hverdag _ SAME
árka N: ark _ ark _ SAME
ásodatbáiki N: boligfelt _ boligfelt _ SAME
ássandoarjja N: bostøtte _ bostøtte _ SAME
klieanta N: klient _ klient _ SAME
áššehas N: klient _ klient _ SAME
čakča N: høst _ høst _ SAME
čakčaluopmu N: høstferie _ høstferie _ SAME
čakčamánnu N: september _ september _ SAME
čalbmi N: øye _ øye; garnmaske, maske
šalbmi N: øye _ nåløye; øye
čeavrris N: oter _ oter _ SAME
čielgamielki N: helmelk _ helmelk _ SAME
čievra N: grus _ grus _ SAME
čoahkkinplána N: møteplan _ møteplan _ SAME
čoalus N: tarm _ tarm _ SAME
čoarveduodji N: hornsløyd _ hornsløyd _ SAME
čoavdda N: nøkkel _ nøkkel _ SAME
čoavddasátni N: stikkord _ nøkkelord, stikkord
čoavji N: mage _ mage _ SAME
čohkka N: fjelltopp; topp _ topp, fjelltopp
čuoiganbeaivi N: skidag _ skidag _ SAME
čuovgagovva N: lysbilde _ lysbilde, slide
čuoččuhus N: påstand _ påstand; pretensjon
čuvdi N: pekefinger _ pekefinger _ SAME
čuvla N: kjole _ kjole _ SAME
čájáhus N: utstilling _ utstilling _ SAME
čála N: skrift _ skrift; tegnsett
čállingoddi N: sekretariat _ sekretariat _ SAME
čállingursa N: skrivekurs _ skrivekurs _ SAME
čállinkursa N: skrivekurs _ skrivekurs _ SAME
čállinmašiidna N: skrivemaskin _ skrivemaskin _ SAME
čáppagirjjálašvuohta N: skjønnlitteratur _ skjønnlitteratur _ SAME
šibit N: husdyr _ husdyr, fe
šiehtadallan N: forhandling _ forhandling _ SAME
šiehtadallanvuorru N: forhandlingsrunde _ forhandlingsrunde _ SAME
šloahtta N: slott _ slott _ SAME
šárka N: sjark _ sjark _ SAME
duiskkagiella N: tysk _ tysk språk
dihtorfitnodat N: datafirma _ datafirma _ SAME
báŋkoloatna N: banklån _ banklån _ SAME
joganjálbmi N: elvemunning _ elvemunning _ SAME
ruvsu N: rose _ rose _ SAME
vearsa N: vers _ vers _ SAME
mearkabeaivi N: merkedag _ merkedag _ SAME
skuvlaskibir N: skolekamerat _ skolekamerat _ SAME
ovdagáddu N: fordom _ fordom _ SAME
guoddu N: holdning _ holdning _ SAME
miellaguoddu N: holdning; innstilling _ holdning, innstilling
bargoproseassa N: arbeidsprosess _ arbeidsprosess _ SAME
bargostipeanda N: arbeidsstipend _ arbeidsstipend _ SAME
boazodoalloagronoma N: reindriftsagronom _ reindriftsagronom _ SAME
boazodoallofoanda N: reindriftsfond _ reindriftsfond _ SAME
boazodoallofága N: reindriftsfag _ reindriftsfag _ SAME
boazodoalloguovlu N: reindriftsområde; reinbeiteområde _ reindriftsområde, reinbeiteområde
boazodoallopolitihkka N: reindriftspolitikk _ reindriftspolitikk _ SAME
buohkaidriekti N: allemannsrett _ allemannsrett _ SAME
buvttadanfitnodat N: produksjonsbedrift _ produksjonsbedrift _ SAME
bággovuovdin N: tvangssalg _ tvangssalg _ SAME
báikenammaprošeakta N: stedsnavnprosjekt _ stedsnavnprosjekt _ SAME
báktedáidda N: bergkunst _ bergkunst _ SAME
bálseduodji N: keramikk _ keramikk _ SAME
cára N: tsar _ tsar _ SAME
dahkkivuoigatvuohta N: opphavsrett _ opphavsrett _ SAME
diehtojuohkinkampánja N: informasjonskampanje _ informasjonskampanje _ SAME
diehtojuohkinčoahkkin N: informasjonsmøte _ informasjonsmøte _ SAME
dieđihandivat N: påmeldingsavgift _ påmeldingsavgift _ SAME
dieđihanskovvi N: påmeldingsskjema _ påmeldingsskjema _ SAME
diktáhtta N: diktat _ diktat _ SAME
direktoráhtta N: direktorat _ direktorat _ SAME
doaibmaboađus N: driftsresultat _ driftsresultat _ SAME
doaibmabušeahtta N: driftsbudsjett _ driftsbudsjett _ SAME
duopmostuolloláhka N: domstollov _ domstollov _ SAME
duottarguovlu N: fjellområde _ fjellområde _ SAME
dálááigi N: nåtid _ nåtid _ SAME
dásseárvopolitihkka N: likestillingspolitikk _ likestillingspolitikk _ SAME
dávdamearka N: sykdomstegn; symptom _ symptom, sykdomstegn
ealáhusdoaibma N: næringsvirksomhet; næringsliv _ næringsliv, næringsvirksomhet
ekspedišuvdnahoavda N: ekspedisjonssjef _ ekspedisjonssjef _ SAME
filbmafoanda N: filmfond _ filmfond _ SAME
fápmuiboahtin N: ikrafttredelse _ ikrafttredelse _ SAME
geaidnoláhka N: veglov _ veglov _ SAME
giellapolitihkka N: språkpolitikk _ språkpolitikk _ SAME
girjeprošeakta N: bokprosjekt _ bokprosjekt _ SAME
girkoláhka N: kirkelov _ kirkelov _ SAME
guolledávda N: fiskesykdom _ fiskesykdom _ SAME
guovllubuohcceviessu N: regionsykehus _ regionsykehus _ SAME
jahkedivat N: årsavgift _ årsavgift _ SAME
jearahallan N: intervju _ intervju, utspørring
kontoplána N: kontoplan _ kontoplan _ SAME
kulturhistorjá N: kulturhistorie _ kulturhistorie _ SAME
kulturpolitihkka N: kulturpolitikk _ kulturpolitikk _ SAME
lappekommišuvdna N: lappekommisjon _ lappekommisjon _ SAME
luopmoláhka N: ferielov _ ferielov _ SAME
láhkadiggi N: lagting _ lagting _ SAME
láhkaevttohus N: lovforslag _ lovforslag _ SAME
láhkaárvalus N: lovforslag _ lovforslag _ SAME
láhkavuođđu N: hjemmel _ hjemmel _ SAME
lávdegoddečoahkkin N: komitémøte _ komitémøte _ SAME
lášmmohallanlatnja N: gymnastikksal _ gymnastikksal _ SAME
meahcceguovlu N: utmarksområde _ utmarksområde _ SAME
miellahttočoahkkin N: medlemsmøte _ medlemsmøte _ SAME
mánáidláhka N: barnelov _ barnelov _ SAME
mánáidsuodjalus N: barnevern _ barnevern _ SAME
nammariekti N: namsrett _ namsrett _ SAME
njunuščoahkkin N: toppmøte _ toppmøte _ SAME
nominašunčoahkkin N: nominasjonsmøte _ nominasjonsmøte _ SAME
nominašuvdnačoahkkin N: nominasjonsmøte _ nominasjonsmøte _ SAME
nuoraidpolitihkka N: ungdomspolitikk _ ungdomspolitikk _ SAME
nuoraidprošeakta N: ungdomsprosjekt _ ungdomsprosjekt _ SAME
rasisma N: rasisme _ rasisme _ SAME
oahpahusossodat N: opplæringsavdeling _ opplæringsavdeling _ SAME
oahppodoarjja N: utdanningsstønad _ utdanningsstønad _ SAME
oahppolihttu N: studieforbund _ studieforbund _ SAME
oahpponeavvokataloga N: læremiddelkatalog _ læremiddelkatalog _ SAME
oahpponeavvopedagogihkka N: læremiddelpedagogikk _ læremiddelpedagogikk _ SAME
oaiveskálžu N: hodeskalle _ hodeskalle _ SAME
oasseprošeakta N: delprosjekt _ delprosjekt _ SAME
olggosmáksin N: utbetaling _ utbetaling _ SAME
orohatplána N: distriktsplan _ distriktsplan _ SAME
ovdaskuvla N: førskole _ førskole _ SAME
plánačoavddus N: planløsning _ planløsning _ SAME
preassadoarjja N: pressestøtte _ pressestøtte _ SAME
preassaguovddáš N: pressesenter _ pressesenter _ SAME
preassakonferánsa N: pressekonferanse _ pressekonferanse _ SAME
preassapolitihkka N: pressepolitikk _ pressepolitikk _ SAME
prevenšuvdna N: prevensjon _ prevensjon _ SAME
psykiatriija N: psykiatri _ psykiatri _ SAME
reaidadoarjja N: kontantstøtte _ kontantstøtte _ SAME
refušuvdnagáibádus N: refusjonskrav _ refusjonskrav _ SAME
rehketdoallu N: regnskap _ regnskap _ SAME
riebansilba N: kråkesølv _ kråkesølv _ SAME
riektegáldu N: rettskilde _ rettskilde _ SAME
riektejoavku N: rettsgruppe _ rettsgruppe _ SAME
riikkapolitihkka N: rikspolitikk _ rikspolitikk _ SAME
rámmašiehtadus N: rammeavtale _ rammeavtale _ SAME
ráŋggáštusovddasvástádus N: straffansvar _ straffansvar _ SAME
sadjásaš N: vikar _ vikar _ SAME
seksualitehta N: seksualitet _ seksualitet _ SAME
servodatdieđa N: samfunnsvitenskap _ samfunnsvitenskap _ SAME
servodatstruktuvra N: samfunnsstruktur _ samfunnsstruktur _ SAME
sisamáksin N: innbetaling _ innbetaling _ SAME
skuvlabiras N: skolemiljø _ skolemiljø _ SAME
skuvlagievkkan N: skolekjøkken _ skolekjøkken _ SAME
skuvlahoavda N: skolesjef _ skolesjef _ SAME
skuvlakantuvra N: skolekontor _ skolekontor _ SAME
skuvlaneahtta N: skolenett _ skolenett _ SAME
skuvlapolitihkka N: skolepolitikk _ skolepolitikk _ SAME
skuvlaservodat N: skolesamfunn _ skolesamfunn _ SAME
skuvlasáhttu N: skoleskyss _ skoleskyss _ SAME
sohkarbihttá N: sukkerbit _ sukkerbit _ SAME
statistihkka N: statistikk _ statistikk _ SAME
streaŋga N: streng _ streng _ SAME
sáivačáhcebiologiija N: ferskvannsbiologi _ ferskvannsbiologi _ SAME
sámekonvenšuvdna N: samekonvensjon _ samekonvensjon _ SAME
tearbmaprošeakta N: termprosjekt _ termprosjekt _ SAME
vearba N: verb _ verb _ SAME
virgáibidjan N: ansettelse _ ansettelse _ SAME
vuojadeapmi N: svømming _ svømming _ SAME
sekunda N: sekund _ sekund _ SAME
luonddufága N: naturfag _ naturfag _ SAME
mearridanváldi N: beslutningsmyndighet _ beslutningsmyndighet _ SAME
ohppiidráđđi N: elevråd _ elevråd _ SAME
soahtefáŋga N: krigsfange _ krigsfange _ SAME
musihkkár N: musiker _ musiker _ SAME
musihkar N: musiker _ musiker _ SAME
professor N: professor _ professor _ SAME
lágádus N: forlag _ forlag _ SAME
bievlavuodjin N: barmarkskjøring _ barmarkskjøring _ SAME
euro N: euro _ euro _ SAME
helikopter N: helikopter _ helikopter _ SAME
sámeskuvla N: sameskole _ sameskole _ SAME
ohcanskovvi N: søknadsskjema _ søknadsskjema _ SAME
sámesearvi N: sameforening _ sameforening _ SAME
jávkan N: fravær _ fravær _ SAME
studio N: studio _ studio _ SAME
sáddehat N: studio _ studio _ SAME
grámma N: gram _ gram _ SAME
mánáidgárdesadji N: barnehageplass _ barnehageplass _ SAME
jahkedieđáhus N: årsmelding _ årsmelding _ SAME
arena N: arena _ arena _ SAME
eallinahki N: levealder _ levealder _ SAME
váldosivva N: hovedårsak _ hovedårsak _ SAME
giellanjuolggadus N: språkregel _ språkregel _ SAME
fágareive N: fagbrev _ fagbrev _ SAME
veterána N: veteran _ veteran _ SAME
girkogárdi N: kirkegård _ kirkegård _ SAME
klubba N: klubb _ klubb _ SAME
sámegielda N: samekommune _ samekommune _ SAME
sámenisu N: samekvinne _ samekvinne _ SAME
bargobeaivi N: arbeidsdag _ arbeidsdag _ SAME
reserváhtta N: reservat _ reservat _ SAME
optimista N: optimist _ optimist _ SAME
drámá N: drama _ drama _ SAME
vuođđokursa N: grunnkurs _ grunnkurs _ SAME
mediaplána N: medieplan _ medieplan _ SAME
ambassadevra N: ambassadør _ ambassadør _ SAME
morála N: moral _ moral _ SAME
gaskamearri N: gjennomsnitt _ gjennomsnitt _ SAME
nubbigiella N: andrespråk _ andrespråk _ SAME
leavgabeaivi N: flaggdag _ flaggdag _ SAME
byrokráhta N: byråkrat _ byråkrat _ SAME
girjeráidu N: bokserie _ bokserie _ SAME
nuoraidorganisašuvdna N: ungdomsorganisasjon _ ungdomsorganisasjon _ SAME
duopmogirku N: domkirke _ domkirke _ SAME
koahkka N: kokk _ kokk _ SAME
goahkka N: kokk _ kokk _ SAME
ovdabargu N: forarbeid _ forarbeid _ SAME
viessobáŋku N: husbank _ husbank _ SAME
arkeologa N: arkeolog _ arkeolog _ SAME
nuoraidprográmma N: ungdomsprogram _ ungdomsprogram _ SAME
iežasoassi N: egenandel _ egenandel _ SAME
dollár N: dollar _ dollar _ SAME
náhkkegahpir N: skinnlue _ skinnlue _ SAME
vovdna N: vogn _ vogn _ SAME
olmmoš N: person; menneske _ menneske
persovdna N: person _ person _ SAME
fitnodat N: bedrift; selskap _ firma, foretak
giehta N: hånd _ hand; arm
stivra N: styre _ styre _ SAME
jođihangoddi N: ledelse _ ledelse, lederskap
proseassa N: prosess _ prosess _ SAME
hámádat N: profil; struktur _ profil
kontu N: konto _ konto _ SAME
ovttadat N: enhet _ enhet _ SAME
spiehkastat N: unntak _ unntak, avvik
doaba N: begrep _ fagord
smáhkka N: smak _ smak _ SAME
boddu N: pause _ pause _ SAME
dovdomearka N: symptom; kjennetegn _ kjennetegn
fállu N: meny _ tilbud; meny
mátkelihppu N: billett _ billett _ SAME
bileahtta N: billett _ billett _ SAME
rekláma N: reklame _ reklame _ SAME
rádio N: radio _ radio _ SAME
ohcan N: søk; søknad _ søknad; leting
našuvdna N: nasjon _ nasjon _ SAME
stáhtabušeahtta N: statsbudsjett _ statsbudsjett _ SAME
máŋggus N: kopi _ kopi _ SAME
válgagižžu N: valgkamp _ valgkamp _ SAME
nuohtta N: tone; melodi _ melodi; note
čeabet N: hals _ hals _ SAME
čeabát N: hals _ hals _ SAME
čotta N: hals _ svelg, hals
riekkis N: ring _ ring _ SAME
eanadat N: landskap _ terreng
matematihkka N: matematikk _ matematikk _ SAME
vuolláibáza N: underskudd _ underskudd _ SAME
veardádus N: sammenligning _ sammenligning; lignelse
ruovttueana N: hjemland _ hjemland _ SAME
ruovtturiika N: hjemland _ hjemland _ SAME
jápmin N: dødsfall; død _ døden
váikkuhus N: påvirkning; konsekvens _ virkning; påvirkning
stipeanda N: stipend _ stipend _ SAME
doavttergráda N: doktorgrad _ doktorgrad _ SAME
paragráfa N: paragraf _ paragraf _ SAME
biografiija N: biografi _ biografi _ SAME
stuorradiggeválga N: stortingsvalg _ stortingsvalg _ SAME
jearaldatmearka N: spørsmålstegn _ spørsmålstegn _ SAME
gažaldatmearka N: spørsmålstegn _ spørsmålstegn _ SAME
elfápmodoaimmahat N: kraftverk _ kraftverk _ SAME
olgoriikkapolitihkka N: utenrikspolitikk _ utenrikspolitikk _ SAME
bajásgeassin N: oppdragelse _ oppfostring
sosiologiija N: sosiologi _ sosiologi _ SAME
lihtar N: liter _ liter _ SAME
lihtter N: liter _ liter _ SAME
mastergráda N: mastergrad _ mastergrad _ SAME
oadju N: trygd _ trygd _ SAME
honnet N: honning _ honning _ SAME
oanádus N: forkortelse _ forkorting
subjeakta N: subjekt _ subjekt _ SAME
diibmoplána N: timeplan _ timeplan _ SAME
ađa N: marg _ marg, margbein
muorjemeastu N: syltetøy _ syltetøy _ SAME
duppallatnja N: dobbeltrom _ dobbeltrom _ SAME
johtolatsihkarvuohta N: trafikksikkerhet _ trafikksikkerhet _ SAME
ássanovttadat N: boenhet _ boenhet _ SAME
válgalatnja N: valglokale _ valglokale _ SAME
adjektiiva N: adjektiv _ adjektiv _ SAME
njuovvan N: slakting _ slakting _ SAME
nuoskkidanláhka N: forurensningslov _ forurensningslov _ SAME
bivdosadji N: fiskeplass _ fiskeplass _ SAME
skábma N: mørketid _ mørketid _ SAME
ovdahistorjá N: forhistorie _ forhistorie _ SAME
rahpansárdni N: åpningstale _ åpningstale _ SAME
váldošiehtadus N: hovedavtale _ hovedavtale _ SAME
lonuhangávpi N: byttehandel _ byttehandel _ SAME
rievdna N: gryn _ gryn _ SAME
surbmi N: gryn _ gryn _ SAME
eanaláhka N: jordlov _ jordlov _ SAME
substantiiva N: substantiv _ substantiv _ SAME
válgačoahkkin N: valgmøte _ valgmøte _ SAME
biilaboagán N: sikkerhetsbelte _ bilbelte
liššá N: ljå _ ljå _ SAME
ovddidanfoanda N: utviklingsfond _ utviklingsfond _ SAME
ovdánahttinfoanda N: utviklingsfond _ utviklingsfond _ SAME
riikkarevišuvdna N: riksrevisjon _ riksrevisjon _ SAME
skuter N: skuter _ skuter _ SAME
mohtorgielká N: skuter _ skuter _ SAME
sámediggeválga N: sametingsvalg _ sametingsvalg _ SAME
preposišuvdna N: preposisjon _ preposisjon _ SAME
geaidnogalba N: veiskilt _ veiskilt _ SAME
lieđđegavja N: pollen _ pollen, blomsterstøv
digaštallanfáddá N: debattema _ debattema _ SAME
luoddaguorra N: vegkant _ vegkant _ SAME
geaidnoravda N: vegkant _ vegkant _ SAME
geaidnoguorra N: vegkant _ vegkant _ SAME
guhkesáiggeperspektiiva N: langtidsperspektiv _ langtidsperspektiv _ SAME
lohkosátni N: tallord _ tallord _ SAME
giellakonsuleanta N: språkkonsulent _ språkkonsulent _ SAME
sámekultuvra N: samekultur _ samekultur _ SAME
vearroláhka N: skattelov _ skatteloven
fávli N: dyp _ dyp _ SAME
čikŋodat N: dyp _ dybde
čiekŋalas N: dyp _ dyp, dypt sted
heargi N: rein _ kjørerein
geahččoboazu N: rein _ sytingsrein
vuođđu N: grunn; plattform; grunnlag _ bunn, grunn, underside, fundament
vuoigatvuohta N: rett; rettighet _ rettighet
badjesápmi N: reindriftssame _ reindriftssame _ SAME
boazosápmi N: reindriftssame _ reindriftssame _ SAME
badjealmmái N: reindriftssame _ reindriftssame _ SAME
boazoalmmái N: reindriftssame _ reindriftssame _ SAME
badjenisu N: reindriftssame; reindriftskvinne _ reindriftssame
heargevuodjingilvu N: reinkappkjøring _ reinkappkjøring _ SAME
heargevuodjin N: reinkappkjøring _ reinkappkjøring _ SAME
heargegilvovuodjin N: reinkappkjøring _ reinkappkjøring _ SAME
heargegilvu N: reinkappkjøring _ reinkappløp
ovdáneaddjiriika N: utviklingsland _ utviklingsland _ SAME
skuvlaoabbá N: klassekamerat _ klassekamerat _ SAME
skuvlaviellja N: klassekamerat _ klassekamerat _ SAME
dárogiella N: norsk _ norsk språk
dárru N: norsk _ norsk språk
jiella N: trekk _ trekk, svakt luftdrag
skoađas N: trekk; isolasjon _ trekk, for, paneling; isolasjon
čáhcegiera N: overflate _ vannskorpe
gelbbolašvuođaguovddáš N: kompetansesenter _ kompetansesenter _ SAME
gealboguovddáš N: kompetansesenter _ kompetansesenter _ SAME
friddjavuohta N: frihet _ frihet _ SAME
doalloovttadat N: driftsenhet _ driftsenhet _ SAME
riddoguovlu N: kystområde _ kystområde _ SAME
eaiggáduššanvuoigatvuohta N: eiendomsrett _ eiendomsrett _ SAME
oamastanriekti N: eiendomsrett _ eiendomsrett _ SAME
eanaeaiggáduššanvuoigatvuohta N: eiendomsrett _ jordeiendomsrett
ovttasbargošiehtadus N: samarbeidsavtale _ samarbeidsavtale _ SAME
ovttasbargosoahpamuš N: samarbeidsavtale _ samarbeidsavtale _ SAME
justiisaministtar N: justisminister _ justisminister _ SAME
bivdu N: fiske; jakt; fangst _ jakt; fiske
guollebivdu N: fiske _ fiske _ SAME
minoritehta N: minoritet _ minoritet _ SAME
justiisadepartemeanta N: justisdepartement _ justisdepartement _ SAME
hálddašanorgána N: forvaltningsorgan _ forvaltningsorgan _ SAME
dearvvašvuođabálvalus N: helsetjeneste _ helsetjeneste _ SAME
oahppu N: utdanning; kunnskap; opplæring _ kunnskap
oahppa N: utdanning; kunnskap _ kunnskap; lære
alitoahppu N: utdanning _ høyere utdanning
skuvlen N: utdanning _ skolering
skuvlejupmi N: utdanning; skolegang _ utdanning
valáštallanlihttu N: idrettsforbund _ idrettsforbund _ SAME
eaiggátvuohta N: eierskap _ eierskap _ SAME
ođastus N: reform _ reform, fornyelse
čállingiella N: skriftspråk _ skriftspråk _ SAME
táhpa N: tap; tap _ tap
rutiidna N: rutine _ rutine _ SAME
ovdánanvejolašvuohta N: utviklingsmulighet _ utviklingsmulighet _ SAME
maŋŋelgaskabeaivi N: ettermiddag _ ettermiddag _ SAME
maŋŋágaskabeaivi N: ettermiddag _ ettermiddag _ SAME
veaigi N: ettermiddag _ skumring
ovttamielalašvuohta N: enighet _ enighet _ SAME
ovttaoaivilvuohta N: enighet _ enighet _ SAME
soabalašvuohta N: enighet _ fordragelighet
hušša N: stress _ ståk, stress
ássanbáiki N: bosted _ bosted _ SAME
orrunbáiki N: bosted _ bosted _ SAME
ássansadji N: bosted _ bosted _ SAME
orrunsadji N: bosted _ oppholdssone
náittosdilli N: ekteskap _ ekteskap _ SAME
náittus N: ekteskap _ vielse
guovllupolitihkka N: distriktspolitikk _ distriktspolitikk _ SAME
neahttabáiki N: nettsted _ nettsted _ SAME
ealáhusovdáneapmi N: næringsutvikling _ næringsutvikling _ SAME
oahpaheaddjeoahppu N: lærerutdanning _ lærerutdanning _ SAME
čearddalašvuohta N: etnisitet _ etnisitet _ SAME
luonddugeavaheapmi N: naturbruk _ naturbruk _ SAME
boazoeaiggát N: reineier _ reineier _ SAME
boazoisit N: reineier _ reineier _ SAME
servodatovdáneapmi N: samfunnsutvikling _ samfunnsutvikling _ SAME
álgoálbmotnisu N: urfolkskvinne _ urfolkskvinne _ SAME
giellaovdáneapmi N: språkutvikling _ språklig utvikling
árdna N: skatt _ skatt _ SAME
šiella N: skatt _ finnerlønn, fødselsgave
álbmotjoavku N: folkegruppe _ folkegruppe _ SAME
márkanšillju N: torg _ torg _ SAME
vearrosisaboahtu N: skatteinntekt _ skatteinntekt _ SAME
ossodatdirektevra N: avdelingsdirektør _ avdelingsdirektør _ SAME
lohkangelbbolašvuohta N: studiekompetanse _ studiekompetanse _ SAME
ruhtagáldu N: finansieringskilde _ finansieringskilde _ SAME
oadjoetáhtta N: trygdeetat _ trygdeetat _ SAME
vearrivuohta N: urett _ urett _ SAME
ovdánahttinbargu N: utviklingsarbeid _ utviklingsarbeid _ SAME
dálkkádatrievdan N: klimaendring _ klimaendring _ SAME
dadjamuš N: utsagn; innflytelse _ noe å si
dajahus N: utsagn; uttrykk _ uttrykk; joiketekst
sátnevuorru N: innlegg _ innlegg _ SAME
sáhkavuorru N: innlegg; tale _ innlegg
badjelmearebuvttadeapmi N: overproduksjon _ overproduksjon _ SAME
reaidu N: redskap; utstyr; verktøy; hjelpemiddel _ verktøy, hjelpemiddel
bargobierggas N: redskap; utstyr _ redskap, arbeidsredskap
bargoneavvu N: redskap; verktøy _ verktøy
bivddus N: redskap _ fangstredskap
bivdoneavvu N: redskap; fiskeredskap _ fiskeredskap
bargoviidodat N: arbeidsområde _ arbeidsområde _ SAME
bartaguovlu N: hytteområde _ hytteområde _ SAME
beaivebiebmu N: lunsj _ lunsj _ SAME
luovnnas N: lunsj _ lunsj _ SAME
beallelaš N: ektefelle _ ektefelle _ SAME
beavdegirji N: protokoll _ protokoll _ SAME
beloštus N: forsvar _ forsvar _ SAME
ávvir N: omsorg; oppmerksomhet _ oppmerksomhet, omsorg
fuolla N: omsorg _ omsorg _ SAME
biebmodoallu N: kosthold _ diett; kosthold
ritni N: rim _ rim _ SAME
bihci N: rim _ rimfrost, rim
birasoahppu N: orienteringsfag _ orienteringsfag, miljøfag
rohkos N: bønn _ bønn _ SAME
guollebivdobierggas N: fiskeredskap _ fiskeredskap _ SAME
boazodoallu N: reindrift _ reindrift _ SAME
gánda N: gutt _ gutt _ SAME
lunta N: gutt _ gutt _ SAME
bártnáš N: gutt _ liten gutt
gánddaš N: gutt _ liten gutt
jeavdi N: gutt _ gutt _ SAME
bárti N: uhell; problem _ uhell; knipe
giera N: topp _ topp; utspring
sisabahkken N: inngrep _ inntrenging
deaivvadansadji N: møteplass _ møteplass _ SAME
dievasčoahkkin N: plenum; plenumsmøte _ plenum
ollesčoahkkin N: plenum; plenumsmøte _ plenumsmøte
doaimmahus N: virksomhet; redaksjon _ redaksjon
doaibmaguovlu N: virkeområde _ virkeområde _ SAME
doaibmaviidodat N: virkeområde _ virkeområde, aksjonsradius
duodji N: håndarbeid; håndverk _ håndarbeid, håndverk
dipmaduodji N: håndarbeid _ myksløyd, håndarbeid med myke materialer
duovdda N: område _ område, flytte- og beiteområde, reinbeiteareal
dálolaš N: gårdbruker _ gårdbruker _ SAME
eahketborramuš N: kveldsmat _ kveldsmat, aftensmat
eahketbiebmu N: kveldsmat _ kveldsmat _ SAME
opmodat N: eiendom _ eiendom _ SAME
hávvi N: gang _ sår
vázzin N: gang _ gåing
feasta N: fest _ fest _ SAME
fierpmádat N: nettverk; nettverk _ nettverk
fierbmi N: nettverk; garn _ fiskegarn
fuomášupmi N: ide; oppmerksomhet; fokus _ ide
mális N: middag _ kokt mat; suppe
perspektiiva N: perspektiv _ perspektiv _ SAME
geahččanguovlu N: perspektiv _ perspektiv _ SAME
geahčču N: tilsyn; kontroll _ tilsyn, bevoktning
bearráigeahčču N: tilsyn; kontroll _ oppsyn
gelbbolašvuohta N: kompetanse _ kompetanse _ SAME
čehppodat N: kompetanse _ dyktighet
geardeviessu N: blokk _ blokk _ SAME
gielddaválga N: kommunevalg _ kommunevalg _ SAME
suohkanválga N: kommunevalg _ kommunevalg _ SAME
gierdilvuohta N: toleranse _ toleranse _ SAME
gierdevašvuohta N: toleranse _ tålmodighet
girdišillju N: flyplass _ flyplass _ SAME
mearri N: mål _ mål, mengde
mihttu N: mål; mål _ mål, målestokk
prinsihppa N: prinsipp _ prinsipp _ SAME
govvádus N: framstilling _ beskrivelse, framstilling
guoibmi N: kamerat; partner _ kamerat; livsledsager, ektemake; samboer
verdde N: kamerat _ kamerat; vert, gjestevenn
čielggadeapmi N: utredning; utredning _ utredning
čielggadus N: utredning _ forklaring
doaresbealli N: distrikt _ veggrøft; avsides sted
jáhkku N: tro; forestilling _ forestilling
gáibi N: hake _ hake, kjake
báddi N: bånd; bånd _ tau
čanas N: bånd; bånd _ bånd, bind
čanastat N: bånd; bånd _ band, bånd
gárastat N: bånd _ bånd _ SAME
historjá N: historie; historie _ historie
hálddašanguovlu N: forvaltningsområde; forvaltningsområde _ forvaltningsområde, administrativt område
iešmearrideapmi N: selvbestemmelse _ selvbestemmelse _ SAME
iežaskapitála N: egenkapital _ egenkapital _ SAME
isitgielda N: vertskommune _ vertskommune _ SAME
joatkkaoahppu N: videreutdanning _ videreutdanning _ SAME
lassioahppu N: videreutdanning; etterutdanning _ etterutdanning
johka N: elv _ bekk, elv
fielbmá N: elv _ lita stille elv, stille sted i ei lita elv
eatnu N: elv _ stor elv, flod
deatnu N: elv _ stor elv
johkafanas N: elvebåt _ elvebåt _ SAME
johtučálus N: rundskriv _ rundskriv _ SAME
johtučála N: rundskriv _ rundskriv _ SAME
jorgalus N: oversettelse _ oversettelse; omvendelse
čájálmas N: forestilling _ forestilling _ SAME
govahallan N: forestilling _ illusjon
jávohisvuođageasku N: taushetsplikt _ taushetsplikt _ SAME
kapihtal N: kapittel _ kapittel _ SAME
káija N: kai _ kai _ SAME
láhttu N: løype _ løype _ SAME
liemas N: løype _ løype _ SAME
lullisámegiella N: sørsamisk _ sørsamisk _ SAME
máttasámegiella N: sørsamisk _ sørsamisk _ SAME
luohti N: joik _ joik _ SAME
juoigan N: joik _ joiking
sáibma N: garn _ ørretgarn, småfiskgarn
láigu N: leie _ leie _ SAME
meahcci N: utmark _ utmark _ SAME
mearkkašeapmi N: merknad; kommentar _ kommentar, bemerkning
moraš N: sorg _ sorg _ SAME
máškitvuohta N: fleksibilitet _ fleksibilitet _ SAME
nagir N: søvn _ søvn _ SAME
nagirvárri N: søvn _ søvn _ SAME
namahus N: tittel _ tittel _ SAME
bajilčála N: tittel _ overskrift
nákca N: kraft; evne _ evne, kraft
oapman N: ovn _ ovn _ SAME
uvdna N: ovn _ peis, grue
omman N: ovn _ stekeovn
ohcamuš N: søknad _ søknad _ SAME
ovdáneapmi N: utvikling _ utvikling _ SAME
gárggiideapmi N: utvikling _ utvikling _ SAME
pulta N: pult _ pult _ SAME
rámma N: ramme _ ramme _ SAME
seaguhus N: blanding _ blanding _ SAME
segohus N: blanding _ blanding _ SAME
stoahka N: lek _ lek; leven
duhkoras N: lek _ leketøy
stoahkanhearva N: lek _ leketøy
sárdni N: tale _ preken, tale
sáhka N: tale _ tale, samtale
hállan N: tale _ bøy, li, skråning
sákta N: saft _ saft _ SAME
máihli N: saft _ sevje; juice
sáhppi N: saft _ galle
álvu N: fangst _ fangst _ SAME
sálaš N: fangst _ bytte, fangst
sámegiella N: samisk _ samisk _ SAME
urbi N: skudd _ knopp, skudd
virgeolmmoš N: tjenestemann _ tjenestemann _ SAME
vuodjingoarta N: førerkort _ sertifikat, førerkort
vuodjinkoarta N: førerkort _ sertifikat
vuorká N: arkiv _ arkiv; depot, oppbevaringsplass; oppbevaring
váhnen N: forelder _ forelder _ SAME
mánnáolmmoš N: forelder _ person med barn
várrelahttu N: varamedlem; vararepresentant _ varamedlem
čuolbma N: problem; problemstilling _ knute; problemstilling
váttisvuohta N: problem _ problem _ SAME
árran N: åre _ åre, ildsted
áiru N: åre _ åre _ SAME
suotna N: åre _ sene
álbmotmeahcci N: nasjonalpark _ nasjonalpark _ SAME
ásodat N: bolig _ bolig; leilighet
nálli N: art; art; bestand _ ætt; rase
čoahkkin N: møte _ møte, forsamling
deaivvadeapmi N: møte _ treff
čoavddalohku N: nøkkeltall _ nøkkeltall _ SAME
čuohpastat N: snitt _ snitt _ SAME
čuvgehus N: opplysning _ opplysning; belysning
šaddu N: vekst; vekst; plante _ vekst; plante
lassáneapmi N: vekst; økning _ økning
boazoguovlu N: reinbeiteområde _ reinbeiteområde _ SAME
bivdovuoigatvuohta N: fiskerettighet _ fiskerettighet _ SAME
boazoguohtonkonvenšuvdna N: reinbeitekonvensjon _ reinbeitekonvensjon _ SAME
bealljemearka N: reinmerke _ øremerke
boazomearka N: reinmerke _ reinmerke _ SAME
bušeahttaevttohus N: budsjettforslag _ budsjettforslag _ SAME
bággodoaibma N: tvangstiltak _ tvangstiltak _ SAME
bátnedikšunbálvalus N: tannhelsetjeneste _ tannhelsetjeneste _ SAME
doaibmadoarjja N: driftsstøtte _ driftsstøtte _ SAME
doallostruktuvra N: bruksstruktur _ bruksstruktur _ SAME
dássenmandáhta N: utjevningsmandat _ utjevningsmandat _ SAME
eanajuohkinriekti N: jordskifterett _ jordskifterett _ SAME
golloluoitu N: kostnadsoverslag _ kostnadsoverslag _ SAME
infrastruktuvra N: infrastruktur _ infrastruktur _ SAME
siskkáldasstruktuvra N: infrastruktur _ infrastruktur _ SAME
luondduriggodat N: naturressurs _ naturressurs _ SAME
kommentára N: kommentar _ kommentar _ SAME
mobiilatelefovdna N: mobiltelefon _ mobiltelefon _ SAME
mohtorjohtolat N: motorferdsel _ motorferdsel _ SAME
mátkegollu N: reiseutgift _ reiseutgift _ SAME
njuolggadusčálus N: regelverk _ regelverk _ SAME
oahppanbiras N: læringsmiljø _ læringsmiljø _ SAME
oasussearvi N: aksjeselskap _ aksjeselskap, andelslag
orohatdoarjja N: distriktstilskudd _ distriktstilskudd _ SAME
orohatstivra N: distriktsstyre _ distriktsstyre _ SAME
ovttasbargovuohki N: samarbeidsform _ samarbeidsform _ SAME
personsuodjalus N: personvern _ personvern _ SAME
regulerenplána N: reguleringsplan _ reguleringsplan _ SAME
servodatdilálašvuohta N: samfunnsforhold _ samfunnsforhold _ SAME
sierralohpi N: dispensasjon _ dispensasjon _ SAME
sohkabealperspektiiva N: kjønnsperspektiv _ kjønnsperspektiv _ SAME
spesialistadearvvašvuođabálvalus N: spesialisthelsetjeneste _ spesialisthelsetjeneste _ SAME
sáttagoddi N: delegasjon _ delegasjon _ SAME
telefonnummar N: telefonnummer _ telefonnummer _ SAME
virgelohpi N: permisjon _ permisjon _ SAME
vuoiŋŋasteapmi N: rekreasjon _ rekreasjon, hvile
skuvlavázzin N: skolegang _ skolegang _ SAME
rievdadus N: endring _ endring _ SAME
rievdadeapmi N: endring _ endring _ SAME
nuppástus N: endring _ forandring; omstilling
váldoulbmil N: hovedmål _ hovedmål _ SAME
fokus N: fokus _ fokus _ SAME
investeren N: investering _ investering _ SAME
anárašgiella N: enaresamisk _ enaresamisk språk
gonagasreabbá N: kongekrabbe _ kongekrabbe _ SAME
mearraguovlu N: havområde _ havområde _ SAME
boazodoallonisu N: reindriftskvinne _ reindriftskvinne _ SAME
dákse N: drosje _ taksi
rahčamuš N: kamp; innsats _ strev
vuolggasadji N: utgangspunkt _ innfallsvinkel
dálkkodeapmi N: behandling _ medisinsk behandling
iskkadeapmi N: undersøkelse _ undersøkelse _ SAME
arva N: energi _ energi, viljestyrke
alva N: energi _ energi _ SAME
čálamearka N: tegn _ skrifttegn
resursa N: ressurs _ ressurs _ SAME
riggodat N: ressurs _ rikdom
sisaboahtu N: inntekt _ inntekt _ SAME
dienas N: inntekt _ fortjeneste
riidu N: konflikt; strid _ trette, krangel
dahku N: handling _ gjerning; inngrep
veahkaváldin N: vold; overgrep _ vold, makt, overgrep
loahppajurdda N: konklusjon _ resonnement
menestus N: suksess _ suksess _ SAME
bagadallan N: veiledning _ regi; veiledning
ráva N: anbefaling _ formaning
siedja N: verk _ materie, verk, sårvæske
čohkkehus N: samling _ samling, sammensetning
čoakkáldat N: samling _ samling _ SAME
govus N: figur _ figur _ SAME
govadat N: figur _ riss
nággu N: strid _ krangel, disputt, ordstrid, tvistemål
vuostálat N: strid _ motbakke
kapasitehta N: kapasitet _ kapasitet _ SAME
vearredahku N: overgrep _ forbrytelse
girjáivuohta N: mangfold _ mangfold _ SAME
searvan N: deltakelse _ medvirkning
riedja N: støy; skrål _ skrål; bråk; høyrøystet snakk
váikkuhanfápmu N: innflytelse _ påvirkningskraft
váikkuhanváldi N: innflytelse _ påvirkingskraft
váikkuhanvejolašvuohta N: innflytelse _ påvirkningsmulighet
čanus N: tilknytning _ binding, sammenheng
oadjebasvuohta N: trygghet _ trygghet _ SAME
mohtorfievru N: kjøretøy _ motorkjøretøy
vieljaš N: søsken _ lillebror
oappáš N: søsken _ lillesøster
bajuš N: pålegg _ pålegg; garndupp
láibesuvli N: pålegg _ pålegg _ SAME
vearrogeahpádus N: skattelette _ skattelette _ SAME
geavahanguovlu N: bruksområde _ bruksområde _ SAME
váldobargu N: hovedoppgave _ hovedarbeid
rievdadusevttohus N: endringsforslag _ endringsforslag _ SAME
oambealle N: søskenbarn _ kusine
oarpmealle N: søskenbarn _ kusine
doaibmagollu N: driftsutgift _ driftsutgift _ SAME
šiehtadanlávdegoddi N: forhandlingsutvalg _ forhandlingskomité
rieibmu N: skrål _ skrål, leven
davviguovlopolitihkka N: nordområdepolitikk _ nordområdepolitikk _ SAME
duollji N: reinskinn _ reinskinn; elgskinn
gámas N: reinskinn _ leggskinn
