vuoigatvuođaášši N: rettighetsspørsmål; rettighetssak _ rettighetssak
fuođđu N: vilt; storvilt; småvilt _ vilt dyr, også hund og katt; småvilt
tunealla N: tunell; tunnel _ tunnel
beassi N: neve; never _ never
klássa N: klasse _ klasse _ SAME
burru N: okse _ okse _ SAME
adreassa N: adresse _ adresse _ SAME
šiehtadallanmodealla N: forhandlingsmodell _ forhandlingsmodell _ SAME
modealla N: modell _ modell _ SAME
soahkerissi N: bjørkeris _ bjørkeris _ SAME
biffa N: biff _ biff _ SAME
bissu N: gevær _ børse, gevær
fiellu N: bord _ fjøl, bord
cissa N: urin _ urin, tiss, piss
bussá N: katt _ katt _ SAME
tálla N: tall _ tall _ SAME
goallu N: lampe _ tranlampe, lampe
rolla N: rolle _ rolle _ SAME
spilla N: spill _ spill _ SAME
riebangolli N: kråkesølv _ kråkesølv _ SAME
gudneguossi N: æresgjest _ æresgjest _ SAME
pássa N: pass _ pass _ SAME
skuvlabusse N: skolebuss _ skolebuss _ SAME
gássa N: kasse; gass _ kasse; gass _ SAME
kássa N: kasse _ kasse _ SAME
guossi N: gjest; besøk _ gjest
busse N: buss _ buss; pose
girjebusse N: bokbuss _ bokbuss _ SAME
rišša N: svovel _ svovel; fyrstikk
golli N: gull _ gull _ SAME
guollejielli N: fiskehjell _ fiskehjell _ SAME
hotealla N: hotell _ hotell _ SAME
silli N: sil _ sil _ SAME
tabealla N: tabell _ tabell _ SAME
drošše N: drosje _ drosje _ SAME
