áššemeannudeaddji N: saksbehandlerstilling; saksbehandler _ saksbehandler
ossodatjođiheaddji N: etatsleder; avdelingsleder; avdelingsdirektør _ avdelingsleder
buohccidikšu N: sykesøster; sykepleier _ sykepleier
vearredahkki N: gjerningsmann _ forbryter
biebmoealli N: beitedyr _ kjæledyr
guldaleaddji N: lytter; tilhører _ tilhører
govvejeaddji N: illustratør; fotograf _ fotograf
bálvaleaddji N: servicepersonell; tjener _ tjener
vuoiti N: prisvinner; vinner _ vinner
šiehtadalli N: part _ forhandler
mánnageahčči N: barnetilsyn _ barnevakt
girjerájusbargi N: bibliotekar _ bibliotekar _ SAME
boazodoalli N: reindriftsutøver; reineier _ reindriftsutøver
ráđđeaddi N: rådgiver _ rådgiver _ SAME
dáksevuoddji N: drosjesjåfør _ drosjesjåfør, taksisjåfør
oahppi N: elev _ elev _ SAME
guoddi N: bærer _ bærer _ SAME
ságajođiheaddji N: ordfører _ ordfører, ordstyrer
sátnejođiheaddji N: ordfører _ ordfører _ SAME
čálli N: forfatter; sekretær _ forfatter; sekretær; skribent
girječálli N: forfatter _ forfatter _ SAME
girdi N: fly _ fly; flyver
generálačálli N: generalsekretær _ generalsekretær _ SAME
váldočálli N: generalsekretær _ hovedsekretær
mátkkošteaddji N: reisende _ reisende _ SAME
geavaheaddji N: bruker _ bruker _ SAME
konferánsaoasseváldi N: konferansedeltaker _ konferansedeltaker _ SAME
oktiiheiveheaddji N: koordinator _ koordinator _ SAME
šiehtadallanjođiheaddji N: forhandlingsleder _ forhandlingsleder _ SAME
kulturguoddi N: kulturbærer _ kulturbærer _ SAME
geahčči N: publikum; seer _ publikum
áššedovdi N: ekspert _ ekspert; sakkyndig
čoahkkinoasseváldi N: møtedeltaker _ møtedeltaker _ SAME
guolgaealli N: pelsdyr _ pelsdyr _ SAME
meahciealli N: rovdyr _ vilt dyr
buohcci N: pasient _ syk; pasient
sámegieloahpaheaddji N: samisklærer _ samisklærer _ SAME
stáhtačálli N: statssekretær _ statssekretær _ SAME
stádačálli N: statssekretær _ statssekretær _ SAME
bagadalli N: instruktør; konsulent _ instruktør; konsulent; rettleder
lášmmohallanhárjeheaddji N: instruktør _ instruktør _ SAME
oasseváldi N: deltaker _ deltaker _ SAME
oassálasti N: deltaker _ deltaker _ SAME
filbmadahkki N: filmskaper _ filmskaper _ SAME
vuoddji N: sjåfør _ sjåfør _ SAME
doaimmaheaddji N: redaktør _ redaktør _ SAME
ovdaskuvlaoahpaheaddji N: førskolelærer _ førskolelærer _ SAME
ohcci N: søker _ søker, skjerper
guollebivdi N: fisker _ fisker _ SAME
guolásteaddji N: fisker _ fisker _ SAME
čiekči N: fotballspiller _ fotballspiller _ SAME
spábbačiekči N: fotballspiller _ fotballspiller _ SAME
bivdi N: jeger _ jeger _ SAME
lohkki N: leser _ leser _ SAME
jođiheaddji N: leder _ leder, styrer
prošeaktajođiheaddji N: prosjektleder _ prosjektleder _ SAME
fabrihkkabargi N: fabrikkarbeider _ fabrikkarbeider _ SAME
ássi N: innbygger _ innbygger _ SAME
dutki N: forsker _ forsker _ SAME
oahpaheaddji N: lærer _ lærer _ SAME
báhtareaddji N: flyktning _ flyktning _ SAME
jienasteaddji N: velger _ velger _ SAME
jorgaleaddji N: oversetter _ oversetter _ SAME
oamasteaddji N: eier _ eier _ SAME
vuostálasti N: motstander _ motstander _ SAME
mánáidáittardeaddji N: barneombud _ barneombud _ SAME
fuolaheaddji N: forsørger _ forsørger _ SAME
fylkkasátnejođiheaddji N: fylkesordfører _ fylkesordfører _ SAME
luohkkájođiheaddji N: klassestyrer _ klassestyrer _ SAME
mánáidgárdejođiheaddji N: barnehagestyrer _ barnehagestyrer _ SAME
ovddasteaddji N: representant _ foresatt; representant
plánejeaddji N: planlegger _ planlegger _ SAME
čoahkkinjođiheaddji N: møteleder _ dirigent, møteleder
digaštalli N: debattant _ debattant _ SAME
diktačálli N: dikter _ dikter _ SAME
smávvafanasbivdi N: småbåtfisker _ småbåtfisker _ SAME
šuokŋadahkki N: komponist _ komponist _ SAME
vuostáiváldi N: mottaker _ mottaker _ SAME
jábmi N: død _ død, lik
vuotnaguolásteaddji N: fjordfisker _ fjordfisker _ SAME
láidesteaddji N: pådriver _ dirigent; pådriver
fidnooahppi N: lærling _ lærling _ SAME
ruhtadeaddji N: finansieringskilde _ finansiør
