dovdat V: kjennskap; føle; kjenne; kjenne _ kjenne; føle
čoahkkinastit V: ha møte _ holde møte
báidnit V: prege; påvirke _ farge av; påvirke
láhčit V: tilrettelegge _ re
áŋgiruššat V: satse _ ivre for
čájehit V: opptre; vise _ vise
láhttet V: opptre; agere _ bære seg at
áđđestallat V: mime; imitere _ herme
doapmat V: skynde _ skynde seg
jaskkodit V: stilne _ tie
boahtit V: møte frem; komme _ komme
hoigadit V: dytte; ekskludere; skyve _ skyve
vuostálastit V: gå i mot; bekjempe _ protestere; gjøre motstand
leaikkastallat V: skøye _ spøke
árvidit V: spekulere; skjønne; forutse; anta _ skjønne; gjette
vuortnuhit V: røyne; plage; tvinge; presse _ plage; tvinge, presse
hutkat V: uteksperimentere; skape _ finne på, dikte opp
vihahit V: vigsle; vie; innvie _ vie, innvie
govvidit V: portrettere; skissere; gjenspeile; beskrive; illustrere _ beskrive, illustrere
boarásmuvvat V: eldes _ bli gammel
reaškit V: gapskratte _ skratte
veaddit V: tjore _ holde i tjor
ahkiduššat V: mistrives; vantrives _ vantrives
váccašit V: rusle _ spasere
čiŋahit V: utsmykke; pynte _ pynte
gevret V: bortvise; utvise; pålegge _ kommandere
spežžet V: klappe _ daske
gaikkihit V: røske _ rykke
nimmorit V: murre; beklage _ beklage
árpmihit V: skåne _ forbarme seg
márrat V: strømme _ bruse, dure; innsige
ovttastit V: konsolidere; forene; kombinere _ forene
gáržudit V: avgrense; snevre; innskrenke; begrense _ innskrenke
ráddjet V: avgrense; begrense _ begrense
leavvat V: bre; spre _ bre seg
mearridit V: fastsette; vedta; bestemme _ bestemme
virgáibidjat V: tilsette; konstituere; ansette _ ansette
hilgut V: forkaste; avslå; avvise _ vrake; avslå, avvise
bajidit V: oppjustere; løfte; øke; heve _ løfte, heve
átnut V: begjære; be _ be, tigge
badjelgeahččat V: nedprioritere; neglisjere; overkjøre; overse _ forakte, nedvurdere
háddjet V: splitte; fragmentere; spre _ rote, spre
buoridit V: bedre; forbedre _ forbedre, rette på
čiehkat V: skjule; gjemme _ gjømme
čiegadit V: skjule; gjemme _ gjemme
goarrut V: sømme; sy _ sy
árvvoštallat V: evaluere; vurdere; kritisere _ bedømme; kritisere; vurdere
duhtat V: nøye _ være fornøyd
ođasmahttit V: modernisere; revidere; oppgradere; fornye; oppdatere _ oppdatere; fornye
joatkašuvvat V: vedvare; videreføre; fortsette _ fortsettes
dáhkidit V: forsikre; bekrefte; garantere; sikre _ garantere, bekrefte; forsikre om; kausjonere
fuomášuhttit V: fokusere; belyse _ gjøre oppmerksom på
duolbmat V: trå; undervurdere; overkjøre; tråkke; tråkke; trampe _ trø, tråkke
buokčalit V: dukke; dykke _ dykke
suokkardit V: utforske; granske; drøfte _ granske
muitalit V: informere; fortelle; omtale; opplyse _ fortelle
gulahit V: informere; kunngjøre; erklære _ kunngjøre
buohtastahttit V: jamføre; sammenligne; sammenlikne _ sammenlikne
veardidit V: jamføre; sammenligne; vurdere _ sammenligne
beahtahallat V: skuffe _ bli skuffet; bli bedratt
háhkat V: anskaffe; opparbeide; skaffe; rekruttere _ skaffe; rekruttere
ovttastahttit V: samordne; forene; inkorporere; kombinere; integrere; innlemme _ forene, inkorporere; kombinere
ođastit V: revidere; fornye; oppdatere _ fornye
dárkkistit V: revidere; kontrollere; overprøve; undersøke _ kontrollere, overprøve
guorahallat V: gjennomgå; undersøke; drøfte _ undersøke
cealkit V: fastslå; felle; nedfelle; si; uttale; erklære; omtale; uttrykke _ si, uttale
dovddastit V: tilkjenne; erkjenne _ innrømme, bekjenne
mieđihit V: tilkjenne; erkjenne _ bifalle; erkjenne
luoikat V: utlåne; låne _ låne bort
čavget V: skjerpe; stramme _ stramme, stramme inn; sette igang
dearvvahit V: hilse _ hilse på
váikkuhit V: bidra; påvirke _ virke; påvirke
veahkehit V: bidra; hjelpe _ hjelpe, assistere
dagahit V: bidra; føre _ forårsake
dieđihit V: rapportere; oppgi; orientere; melde; melde; kunngjøre; innmelde _ meddele, orientere
jorggihit V: vippe; snu _ snu, vende seg
sihkkut V: nulle; slette; sløyfe; tørke; stryke; fjerne _ tørke; stryke ut, fjerne
rehkenastit V: kalkulere; regne; beregne _ regne
šláttardit V: tyste _ sladre
sihkastit V: slette; viske; tørke; male _ tørke; male
oahpahit V: skolere; opplære; undervise; lære _ undervise, lære
dinet V: opptjene; tjene _ tjene
čollet V: sløye _ sløye fisk; gulpe
navdit V: synse; tro; kalle; anta; mene _ kalle; mene, tro
váidit V: politianmelde; påklage; klage; anklage _ klage, anklage; anmelde
ruostut V: rustne _ ruste, bli rusten
čilget V: spesifisere; skissere; avklare; forklare; definere _ forklare
geatnegahttit V: forplikte; pålegge _ plikte
čuohppat V: sakse; hugge; klippe _ skjære
sáddet V: oversende; sende _ sende
doaimmahit V: utøve; utføre; drive; drive _ utrette, utføre
cuoigut V: peke; påpeke _ påpeke, gjøre oppmerksom på
cuiget V: peke; påpeke _ påpeke
čujuhit V: peke; påvise; henvise; påpeke; vise; markere _ markere; utpeke
geiget V: avlevere; overlevere _ strekke ut, rekke fram
geahččalit V: utprøve; prøve; forsøke _ prøve
doalvut V: havne; bringe; eksportere _ bringe bort, føre bort; eksportere
beahttit V: svikte _ bedra, narre
hállat V: snakke; orde; snakke _ snakke
hupmat V: snakke; tale; snakke; uttrykke _ snakke
vákšut V: overvåke _ granske nøye
gozihit V: overvåke _ vokte
dohkkehit V: anerkjenne; akseptere; vedta; godkjenne _ godta, akseptere, bifalle, knesette; godkjenne
molsut V: rullere; bytte; skifte _ skifte, bytte
deattuhit V: vektlegge; understreke; fremheve; poengtere; påpeke _ betone, fremheve, poengtere
rávvet V: tilrå; anbefale _ formane
jienastit V: votere; nedstemme; stemme _ stemme
vuovdit V: omsette; selge _ selge
válddahit V: omhandle; beskrive _ beskrive
máinnašit V: omhandle; omtale _ omtale, rose
addit V: yte; levere; gi _ gi
dáhpáhuvvat V: foregå; forekomme; skje _ hende, skje
láittastuvvat V: kjede; vantrives _ vantrives
suorggahit V: ryste; skremme _ skremme
oaidnit V: øyne; se _ se
láitit V: fordømme; kritisere _ klandre, kritisere
čuollat V: hugge; hogge _ hogge
murret V: hugge _ sage eller hogge ved
láigohit V: innleie; leie _ leie av noen
ceahkkut V: tømre _ skjære hakk
ravgat V: ramle _ falle over ende; sprette
ráfehuhttit V: uroe; forstyrre _ forstyrre, sjenere
rihkkut V: overskride; bryte _ overtre, bryte, misligholde
rasttildit V: overskride; passere; krysse _ krysse
sirdit V: omdisponere; overføre; flytte _ flytte
ásaiduvvat V: bosette _ begynne å føle seg hjemme, slå seg ned
ássat V: bosette; bo _ bo
vuođđudit V: konstituere; oppnevne; bygge; etablere; opprette _ grunnlegge
ájihit V: forsinke; forhindre _ hefte bort
maŋŋonit V: forsinke _ bli forsinket
čiekŋudit V: utdype; fordype _ fordype
darvehit V: fange; klistre _ feste, klistre, klebe
lonohallat V: utveksle; bytte; skifte _ skifte; bytte med hverandre
lonuhit V: utveksle; bytte; skifte _ heve; bytte
oadjudit V: trygge _ gjøre trygg
duođaštit V: dokumentere; attestere; bekrefte _ bekrefte, bevitne, attestere; godtgjøre
rahčat V: anstrenge; slite; kjempe _ streve
beasahit V: sleppe; miste _ miste
bilidit V: skjemme; skade; ødelegge _ ødelegge
goallostit V: lenke _ binde sammen etter hverandre
vuodjat V: påkjøre; svømme _ svømme
bassat V: rundvaske; vaske _ vaske
ávkkuhit V: monne _ nytte, gagne
goddit V: felle; myrde; drepe _ drepe
báhčit V: felle; skyte; stikke _ skyte; stikke
njeaidit V: felle; sprenge; redusere _ velte
rivvet V: frata; røve _ røve, ta med makt; tackle
manahit V: frata; miste; fjerne _ miste
atnit V: anse; benytte; bruke _ bruke; anse for; inneha
cegget V: stille; etablere; opprette _ reise opp
luoitit V: overlate; slippe; løse _ slippe, løse
fievrridit V: overføre; videreføre; føre; frakte; eksportere _ frakte, ha med seg
luvvet V: frigi; frita; løse _ løse
sierranit V: separere; skilles; skille _ skilles, skille seg ut
vuoitit V: overkomme; vinne _ vinne
boradit V: lunsje; spise _ spise, ete, ha et måltid
guhkidit V: prolongere; forlenge _ forlenge
ságastit V: orde; tale; snakke _ samtale
álggahit V: iverksette; starte; opprette _ få i gang
vásihit V: oppleves; oppleve _ erfare, oppleve
smiehttat V: reflektere; tenke _ tenke, fundere
joatkit V: videreføre; fortsette _ skjøte; fortsette
vuolláičállit V: signere; underskrive _ underskrive
doahttalit V: overholde; respektere _ akte, ta hensyn til
čuovvut V: overholde; følge _ følge
doallat V: overholde; avholde; abonnere; holde; holde; holde _ holde
máksit V: utbetale; bety; belaste; betale _ betale; koste; bety
deavdit V: oppfylle; fylle _ fylle
ollašuhttit V: oppfylle; gjennomføre; fullføre _ fullføre
ollašuvvat V: oppfylle; oppnå _ gjennomføres
sárgut V: skissere; tegne _ streke, tegne, risse
seaivut V: ankomme; lande _ dale ned; sveve
dubmehallat V: domfelle _ bli dømt
dubmet V: domfelle; dømme _ dømme
dovddahit V: signalisere; uttrykke _ røpe
ipmirdit V: begripe; skjønne; oppfatte; forstå _ forstå, skjønne
buktit V: overlevere; bringe; medføre _ bringe
gaskkustit V: overlevere; formidle _ formidle
sirdašuvvat V: forskyve _ flytte på seg
sárdnidit V: forkynne; preke; tale _ preke, tale
čállit V: protokollføre; skrive _ skrive, notere; rispe; råskjære fisk
diđoštit V: befare _ innhente opplysninger, få klarhet i
barggahit V: aktivisere _ sysselsette
nágget V: insistere; påstå _ krangle; påstå
bissehit V: opphøre; stoppe; stanse; undergrave _ stoppe
bagadallat V: veilede; beskrive; instruere _ beskrive; instruere
bagadit V: veilede; oppdra; refse; instruere _ oppdra, rettlede; straffe, refse
heaittihit V: nedlegge; avslutte; avvikle; oppheve _ avslutte; avvikle
bávkalit V: sprenge; smelle _ smelle, fyre av
cuvket V: sprenge _ knuse; veksle
vurket V: arkivere; oppbevare; lagre _ oppbevare; lagre
nannet V: lovfeste; styrke; bekrefte; sikre _ styrke; bekrefte
jođihit V: ledes; føre; dominere; drive; lede _ lede, styre
guoddalit V: anke; påklage; anklage _ klage på, anklage
čatnat V: knyte; binde; knytte _ binde, forbinde, kople
vuolidit V: avkorte; redusere _ senke
áidut V: gjerde _ inngjerde
namuhit V: tilføre; omtale; nevne _ nevne
bálkáhit V: premiere; engasjere; leie; betale _ ansette; leie; betale
dásset V: balansere; utjevne; stabilisere _ jamne, jevne; stabilisere
molsašuddat V: variere _ bli forandret
čielggadit V: utrede; avklare; forklare _ forklare
jevdet V: utjevne _ jevne ut
ráhkadit V: utarbeide; lage; skape _ lage
ráhkadahttit V: utarbeide _ få noen til å lage
viššat V: tørre; tore; orke _ orke, gidde
duostat V: tørre; våge; tore _ våge, tore
geasehit V: transportere; kjøre; frakte _ kjøre, frakte
illastit V: torturere _ mishandle
deattašit V: taste; trykke _ trykke
goaridit V: svekke; tappe; undergrave _ vanskjøtte
hedjonit V: svekke _ bli svak
riidit V: stride; forhindre; nekte _ nekte; forhindre
njáhkat V: snike _ smyge
njágahit V: snike _ liste seg til noe
sivahallat V: skylde; påtale; beskylde; anklage _ anklage for, påtale
šiggut V: skjelle _ hysse på
lápmašuvvat V: skamslå; skade _ bli vanfør, bli skadet
buhtistit V: rengjøre; rense _ reingjøre, rense
čuohcat V: ramme; påvirke; berøre _ påvirke, berøre
jáhkihit V: overbevise _ få til å tro
eattehit V: opprøre _ bli sint
movttáskit V: oppløfte _ bli glad, bli oppmuntret
boltut V: oppkjøre; brøyte _ rote opp, grave opp
fáhtet V: oppfange _ få tak i
lahkanit V: nærme _ nærme seg
lahkonit V: nærme _ nærme seg
deaivat V: møte; treffe; treffe _ treffe
deaivvadit V: møte; treffe; møtes _ møtes
gávnnadit V: møte; møtes _ møtes
duostut V: møte _ ta imot
dustet V: møte; dempe _ dempe; ta imot
deaividit V: møte _ inntreffe
muittuhit V: minne _ påminne, minne om
nagadit V: makte; klare _ greie, klare
gielistit V: lyve; lyge _ lyge
ealihit V: livnære _ livberge
gillát V: lide; tåle _ tåle, holde ut
biidnašuvvat V: lide _ pines
gárrut V: kvie _ få seg til å gjøre noe
fuomášit V: konstatere; oppdage; merke _ oppdage
gávnnahit V: konstatere; finne _ finne ut
jávohuhttit V: kneble _ få til å tystne
gárvodit V: kle _ kle på seg
nuoladit V: kle _ kle av seg
čoalkit V: klapre; banke _ knakke, banke
bálkásit V: kassere _ gå til spille
sahet V: kappe; sage _ sage
áimmahuššat V: ivareta _ holde i hevd, ta vare på
vuhtiiváldit V: ivareta _ ta hensyn til
fuolahit V: ivareta; sørge _ sørge for
fátmmastit V: involvere; omfavne; omfatte _ omfavne
sorrat V: involvere _ vase sammen
hoahpuhit V: intensivere; forsere _ påskynde
huikit V: hoie; rope _ rope
hehttet V: hemme; forhindre; forebygge; holde; hindre _ hindre, forhindre
speadjalastit V: gjenspeile _ avspeile
buvttihit V: føre; nå; skape _ rekke, nå
vearránit V: forverre _ bli verre
hálddašit V: forvalte; beherske; betjene; administrere _ rå over; administrere; beherske; betjene
eaktudit V: forutsette _ ta forbehold
válbmet V: ferdigstille; fullføre _ gjøre ferdig
ohcalit V: etterspørre; etterlyse; søke; savne _ savne, lengte etter
jearahit V: etterspørre; intervjue; spørre _ intervjue, spørre
váillahit V: etterlyse; savne _ savne
smiehtadit V: dvele; tenke _ tenke, gruble
rámidit V: berømme _ rose, prise
rábmot V: berømme; skryte _ skryte; rose
mearkkašit V: bemerke; bety; innebære _ merke seg, notere; bety
váivašuvvat V: bekymre _ plages
vuorjašuvvat V: bekymre _ plages
vuosttaldit V: bekjempe _ protestere, motarbeide, opponere mot
illosit V: begeistre _ bli glad
várret V: avsette _ advare; sette av
čielgat V: avklare _ klarne, bli klar
vuoddját V: kjøre avsted _ kjøre av sted
girdit V: fly _ fly _ SAME
girdilit V: fly _ fly avgårde
nanosmahttit V: styrke; forsterke _ styrke, forsterke
vuorjat V: plage _ plage, sjenere
váivvidit V: plage _ plage, bry med
bieguhit V: plage _ plage _ SAME
givssidit V: plage; mobbe _ mobbe, plage, pine
iskat V: prøve; undersøke _ undersøke, prøve
viggat V: prøve; forsøke _ prøve, streve
geahččaladdat V: prøve; eksperimentere _ eksperimentere
suhkat V: ro _ ro; gynge
suvdit V: ro _ ferge, frakte i båt
páhkket V: pakke _ pakke _ SAME
šiehtadit V: avtale; forhandle _ avtale
šiehttat V: avtale _ få plass; bli enig
stoahkat V: leke _ støye; leke
duhkoraddat V: leke _ leke _ SAME
fierrat V: rulle _ rulle; rase ned
jorrat V: rulle _ dreie, gå rundt
fieradit V: rulle _ rulle, tumle
fierralit V: rulle _ rulle; dette, falle overende
čalmmustit V: synliggjøre _ synliggjøre _ SAME
čohkkát V: sitte _ sitte _ SAME
čohkohallat V: sitte _ holde på å sitte
čohkkádit V: sitte _ sitte _ SAME
jurddašit V: tenke; mene _ tenke
jurddahit V: tenke _ tenke _ SAME
jurdilit V: tenke _ tenke en tanke
almmuhit V: publisere; utgi; kunngjøre; opplyse _ publisere, gi ut; deklarere; bekjentgjøre
arvat V: våge _ våge _ SAME
bivdit V: anmode; fiske; be _ fiske, jakte; be, anmode
ávžžuhit V: anmode; oppfordre; utfordre; anbefale _ oppfordre
ordnet V: sortere; ordne _ ordne; sortere
sirret V: sortere; skille; isolere _ skille, sortere
čuoldit V: sortere; skille _ skille, sortere; veve bånd
boaibmut V: sortere; plukke _ plukke, pille; sortere
bovdet V: invitere _ invitere, innby
hástit V: invitere; oppfordre; utfordre _ utfordre, oppfordre
buhtadit V: kompensere; erstatte _ kompensere, refundere
buhttet V: kompensere; erstatte _ erstatte
buvttadit V: produsere _ produsere _ SAME
bágget V: tvinge; presse _ tvinge
bággehallat V: tvinge _ tvinges
caggat V: forhindre; hindre _ støtte opp; forhindre
heađuštit V: forhindre; avverge; undergrave; hindre _ forhindre, avverge
coggat V: putte _ putte, stappe; kle på seg
coggalit V: putte _ putte fort; kle på seg fort
nahkehit V: putte; stikke _ putte, stikke
cábadit V: makulere _ skjære i små biter; makulere
dahppat V: stenge _ stenge, lukke
giddet V: stenge; montere _ feste
liibmet V: klistre; lime _ lime
ovdandoallat V: fremheve _ anføre, framholde
doadjit V: knekke; bryte _ knekke, bryte
doaibmat V: fungere; utføre _ fungere
doaivut V: håpe; tro; anta _ håpe; tro
sávvat V: håpe; ønske _ ønske
doarrut V: stange; slåss; kjempe _ stange; slåss
nordat V: stange _ puffe, støte
duvdit V: fortrenge; skyve; tilsidesette _ støtte; puffe; fortrenge
muktit V: overprøve; forandre; endre _ endre, forandre
eastadit V: forebygge; unngå; hindre _ hindre; forebygge
gahččat V: falle _ falle _ SAME
galbmot V: fryse _ fryse _ SAME
goallut V: fryse _ fryse _ SAME
galmmihit V: fryse _ avkjøle
gallestallat V: besøke _ besøke _ SAME
gallet V: besøke _ besøke _ SAME
galledit V: besøke _ besøke _ SAME
finadit V: besøke _ stikke innom
gaskkalduhttit V: avbryte _ avbryte _ SAME
botket V: avbryte; bryte; skille _ bryte, slite av; slite seg løs
unnut V: minske; redusere _ minske, bli mindre
geahpedit V: minske; lette; redusere _ lette, minske
geahpidit V: minske; lette; redusere _ lette, minske
uhccut V: minske _ bli mindre, minske
hoahkat V: gjenta _ ymte om at en vil; gjenta
geardut V: gjenta _ gjenta; multiplisere
geardduhit V: gjenta _ repetere
vuodjit V: kjøre; drive _ kjøre; drive _ SAME
vuojihit V: kjøre; frakte _ frakte
gohččut V: innkalle; be; pålegge _ be, befale; innkalle; pålegge
golahallat V: fordrive _ forbruke
gudnejahttit V: hedre _ ære, hedre
gulahallat V: kommunisere _ forstå hverandre; kommunisere
gullot V: høres _ høres _ SAME
guldalit V: høres; lytte; høre _ lytte; kjenne etter; teste
guohcagit V: råtne _ råtne _ SAME
guossohit V: servere _ traktere, servere
gáldet V: gjelde; kastrere _ gjelde, kastrere
guoskat V: gjelde; berøre _ komme bort i; angå
gustot V: gjelde _ gjelde _ SAME
gádjut V: redde _ berge, redde
suddjet V: redde; beskytte _ beskytte
gáidat V: forsvinne _ vike, forsvinne
jávkat V: forsvinne _ forsvinne _ SAME
healbat V: forsvinne _ forbli
gálašit V: vasse _ vasse; bade
gáržžidit V: innskrenke; begrense; redusere _ innskrenke
gáržut V: innskrenke _ bli trang, innskrenket
heahpanit V: skjemmes _ skamme seg, skjemmes
luohpat V: slutte; gå _ slutte, gi opp
heaitit V: slutte _ slutte _ SAME
loahpahit V: avslutte; sluttføre _ avrunde, sluttføre
biehttalit V: avslå; avvise; nekte _ gi avslag; nekte for
máhttit V: beherske _ kunne
bálvalit V: betjene; tjene _ tjene
hárdit V: erte; terge; mobbe _ erte, terge
hárjehaddat V: øve; trene _ øve, trene
hárjehallat V: øve; trene _ trene
ijastallat V: overnatte; sove _ overnatte
ijastaddat V: overnatte _ overnatte _ SAME
idjadit V: overnatte _ overnatte _ SAME
ihtit V: fremkomme; synes _ vise seg, komme til syne, fremkomme
áddet V: skjønne; oppfatte; forstå _ forstå
jorgalit V: oversette _ oversette; snu noe; snu; omvende; gjøre et notkast
jorgalahttit V: oversette; snu _ få til å snu; få oversatt
máhccat V: snu; komme _ snu, vende tilbake
jápmit V: dø _ dø _ SAME
lohkat V: lese; telle; studere; si _ lese; telle; si
logadit V: lese; studere _ lese lenge
oalgguhit V: oppmuntre; stimulere _ oppmuntre, friste
movttiidahttit V: oppmuntre; inspirere; motivere; stimulere _ oppmuntre, motivere
muddet V: moderere; regulere; justere _ korrigere, moderere; regulere
njammat V: absorbere _ suge, patte, sutte; absorbere
njoarrat V: tappe; skjenke _ skjenke, tappe
nohkkat V: sovne _ sovne; sove
oađđit V: sove _ sove _ SAME
čaibmat V: le _ le, flire
boagustit V: le _ le, flire
bohkosit V: le _ sette i å le
ovddastit V: representere _ forestå; representere
ovddidit V: fremme; utvikle _ fremme; gå for fort
ovdanbuktit V: fremme; presentere; uttrykke _ legge fram, presentere
ruhtadit V: finansiere _ finansiere _ SAME
rádjat V: oppbevare; lagre; ordne _ ta vare på, oppbevare; ordne
ráfáiduhttit V: frede _ frede _ SAME
ráđđádallat V: konsultere; drøfte _ drøfte, konferere med, konsultere
vuoigŋat V: puste _ puste _ SAME
šohkut V: puste; blåse _ puste, blåse
sahkat V: puste _ puste, pese
bosihastit V: puste _ puste ut
sehkket V: blande _ blande _ SAME
seaguhit V: blande _ blande; legere
seahkanit V: blande _ bli blandet, rotet; bli sinnsforvirret
áššáskuhttit V: påtale; saksøke; anklage _ skylde på, anklage
sorbmet V: myrde; drepe _ myrde, drepe
stajidit V: herje _ herje, plyndre
speadjat V: herje _ plyndre, herje
rigeret V: herje _ bråke
sujahaddat V: beskylde _ beskylde _ SAME
suoládit V: stjele _ stjele _ SAME
rievidit V: stjele; røve _ røve
vajálduhttit V: overse; glemme _ overse, glemme
vavdat V: stamme; stotre _ stamme, stotre; bli sittende fast
viežžat V: hente; innhente _ hente; laste ned
viežžalit V: hente _ hente fort, hente noe som ikke er langt borte
vuojehit V: jage; drive _ drive, jage
ádjit V: jage; drive _ jage, drive
oaguhit V: jage; forfølge _ forfølge
vuoruhit V: prioritere _ prioritere _ SAME
ásahit V: innrette; ordne; etablere; opprette; innføre _ etablere; ordne, innrette
feret V: innrette; oppleve _ oppleve
čađahit V: gjennomføre _ gjennomføre _ SAME
čoagganit V: samles; samle _ samles
čoahkkanit V: samles; møtes; samle _ samles
čohkket V: samles; montere; innhente; samle _ samle; montere
čoavdit V: frita; løse _ løse, låse opp; frita
čálihit V: skrive; skrive; registrere; innmelde _ la skrive, skrive ut; la seg registrere; ta ut lysning
šaddadit V: dyrke; føde _ dyrke; føde _ SAME
gilvit V: dyrke; så; sette; spre _ så, plante
šiehtadallat V: forhandle _ forhandle _ SAME
ealáskahttit V: revitalisere _ revitalisere _ SAME
guovlladit V: kikke _ kikke, kaste et blikk på
guovlalit V: kikke _ titte i all hast
ájahallat V: oppholde _ oppholde _ SAME
buđaldit V: oppholde _ pusle
coahkkalit V: klikke; smelle _ smelle, klikke
deaddilit V: klikke; trykke _ trykke, klemme
álgit V: starte; begynne _ begynne
ohcat V: søke _ leite
geavahit V: benytte; bruke _ bruke
albmadit V: melde _ melde til øvrigheten
vikkahit V: forsøke _ forsøke, prøve å få til noe
nagodit V: bestå; klare _ klare
ceavzit V: bestå; bestå; holde seg; overleve _ holde seg, klare seg
seailut V: bestå; bevare; overleve _ bevares; klare seg
dohkket V: godkjenne _ duge
čuohpadit V: operere _ skjære seg, hogge seg
dihttot V: forekomme _ vise seg
čiehkádit V: gjemme _ gjømme seg
skirvehit V: svinge _ svinge brått
soardit V: såre; såre _ undertrykke; skamfere
láibut V: bake _ bake brød
gáhkket V: bake _ bake kake
bohčit V: pumpe; melke _ melke, klemme
goahcat V: bremse _ bremse _ SAME
staigat V: avta _ slå seg til ro; avta
diŋgot V: abonnere; bestille _ bestille
ovdošit V: forutse _ forutse _ SAME
divodit V: restaurere _ reparere
divvut V: restaurere; rette; justere _ reparere, rette på
jeđđet V: berolige; trøste _ trøste
garvit V: fravike; unngå _ unngå
dahkaluddat V: agere _ late som; gjøre seg til
liikot V: like _ like _ SAME
loktet V: løfte; heve _ løfte
loktestit V: løfte _ løfte _ SAME
lovttohallat V: løfte _ løfte _ SAME
váidalit V: klage; beklage _ klage, beklage
oaggut V: fiske _ fiske _ SAME
guolástit V: fiske _ fiske _ SAME
guohtut V: beite _ beite _ SAME
sihtat V: ønske; be _ ville ha, ønske
dáhttut V: ønske; be _ ville, ønske
gokčat V: dekke _ dekke _ SAME
bahčit V: melke _ melke; sentrifugere
jáhkkit V: tro; anta _ tro, anta
gáddit V: tro; anta _ tro, anta
oskut V: tro _ tro _ SAME
bindit V: vare; holde seg _ vare, holde seg
bistit V: vare _ vare _ SAME
láidet V: leie; lede _ leie
báhtarit V: rømme _ flykte, rømme
gárgidit V: rømme _ rømme _ SAME
sálket V: tømme _ tømme; tappe
gurret V: tømme _ tømme _ SAME
oljet V: olje _ olje _ SAME
vuoiŋŋastit V: hvile _ hvile _ SAME
vuojadit V: svømme _ svømme, bade
fuobmát V: oppdage _ oppdage _ SAME
áicát V: oppdage _ oppdage _ SAME
šearrát V: glitre; skinne; lyse _ lyse, skinne, glitre
šealgut V: glitre _ glitre _ SAME
muosehuhttit V: forstyrre _ forstyrre _ SAME
rievdadit V: forandre; endre _ forandre
muhttit V: forandre _ forandre _ SAME
nuppástuhttit V: forandre; tilpasse; endre _ forandre, omstille
hoavridit V: mase _ mase _ SAME
hoavrristit V: mase _ mase _ SAME
hoavrrestit V: mase _ mase _ SAME
fillehallat V: bli forledet _ bli forledet, bli narret
duolbmut V: tråkke _ tråkke, trø
šulšet V: tråkke _ tråkke, lage spor
čuovgat V: skinne; lyse _ skinne, lyse; belyse
báitit V: skinne _ skinne _ SAME
šealgát V: skinne _ glinse, skinne
báittašit V: skinne; lyse _ skinne, lyse
borrat V: spise _ spise, ete; etse
borastit V: spise _ spise _ SAME
ballat V: frykte _ frykte, være redd
baladit V: frykte _ frykte _ SAME
kártet V: kartlegge _ kartlegge _ SAME
gártet V: kartlegge _ kartlegge _ SAME
buorrestit V: omfavne _ klemme, omfavne
salastit V: omfavne _ omfavne _ SAME
sallut V: omfavne _ favne; omfavne
kommenteret V: kommentere _ kommentere _ SAME
bajásšaddat V: vokse opp; vokse _ vokse opp
plánet V: planlegge _ planlegge _ SAME
ovttasbargat V: samarbeide _ samarbeide _ SAME
skuvlet V: undervise _ undervise _ SAME
gažadit V: intervjue; spørre _ spørre, intervjue
jearahallat V: intervjue _ intervjue _ SAME
gahčat V: spørre _ spørre _ SAME
jearrat V: spørre _ spørre _ SAME
gulaskuddat V: spørre _ forhøre seg, spørre
jearadit V: spørre _ spørre _ SAME
lihkostuvvat V: lykkes _ lykkes _ SAME
menestuvvat V: lykkes _ lykkes _ SAME
meinnestuvvat V: lykkes _ lykkes _ SAME
goarránit V: vantrives _ vantrives, visne
arvit V: regne _ regne _ SAME
ráŋggáštit V: straffe _ straffe _ SAME
bargat V: arbeide; gjøre _ arbeide; gjøre _ SAME
hommát V: arbeide _ sysle, arbeide
dahkat V: gjøre; skape _ gjøre; lage
njoammut V: krype; smitte _ krype; smitte _ SAME
beahkit V: krype _ krype _ SAME
čákŋat V: krype _ krype, smyge inn i
guokkardit V: krype _ gå på alle fire - på hender og føtter
massit V: miste; tape _ miste
ribahit V: miste _ miste _ SAME
láhppit V: miste _ miste _ SAME
biestit V: miste; slippe _ miste; slippe _ SAME
bisánit V: stoppe _ stoppe; feste seg
orustit V: stoppe; stanse _ stanse, stoppe
čuoččastit V: stoppe _ reise seg; stoppe; stille seg
notkat V: stoppe _ stoppe, dytte igjen
bisuhit V: beholde; bevare; opprettholde _ beholde
bláđet V: bla _ bla _ SAME
buollit V: brenne _ brenne _ SAME
boaldit V: brenne _ brenne; svi
borgguhit V: røyke _ røyke _ SAME
suovastit V: røyke _ ryke; røyke
buokčat V: dykke _ dykke _ SAME
buressivdnidit V: velsigne _ velsigne _ SAME
goaivut V: grave _ grave, måke, spa
burgit V: grave _ rote, grave; demontere
skurbat V: grave _ pirke, grave
hávkadit V: kvele _ kvele _ SAME
buvihit V: kvele _ kvele _ SAME
bálkkašit V: belønne _ gjengjelde; belønne
lotnut V: betale _ betale, løse ut
bárgidit V: flette _ flette _ SAME
cahkkehit V: tenne; fyre _ tenne
vuodjut V: synke _ synke _ SAME
coahkut V: synke _ minke, synke
dearpat V: banke; slå _ slå, banke
huškut V: banke; slå _ slå, banke
cábmit V: banke; slå _ slå, banke
čoalkalit V: banke _ banke, knakke
goalkalit V: banke _ banke, knakke
darrat V: skjelve; riste _ skjelve, riste
libaidit V: skjelve _ bevre, skjelve; glimte
livzzistit V: skjelve _ vakle; skjelve
doarggistit V: skjelve _ skjelve _ SAME
dekoreret V: dekorere _ dekorere _ SAME
hervet V: dekorere _ dekorere _ SAME
diehtit V: vite; kjenne _ vite
diggot V: bestille; diskutere _ bestille; diskutere, trette; føre rettsak
diktit V: tillate _ la; tillate
suovvat V: tillate _ tillate, gi lov
doarridit V: forfølge _ forfølge _ SAME
doddjot V: brekke _ brekke, gå av
doidit V: skylle _ skylle _ SAME
doidilit V: skylle _ skylle, skylle fort
dulkot V: tolke; fortolke _ tolke; fortolke _ SAME
gierdat V: tåle _ tåle _ SAME
duoddut V: tåle _ tåle _ SAME
vuoššat V: koke _ koke _ SAME
duoldat V: koke _ koke _ SAME
dutkat V: granske; studere _ granske, forske
dánset V: danse _ danse _ SAME
dánsut V: danse _ danse _ SAME
dápmat V: temme _ temme _ SAME
dárbbahit V: trenge _ trenge _ SAME
dárbbašit V: trenge _ behøve, trenge
dávistit V: svare _ svare, gi gjenlyd, gi respons, reagere på
vástidit V: svare _ svare _ SAME
eallit V: leve _ leve _ SAME
fallehit V: angripe _ angripe _ SAME
rohkkáhit V: angripe _ angripe _ SAME
vanahit V: tøye; dra; strekke _ strekke, tøye
fanahit V: tøye _ tøye _ SAME
muosáhit V: oppleve _ smake; oppleve
heivet V: passe _ høve, passe
soahpat V: passe _ passe, høve; bli enig
fáktet V: passe _ passe, vokte
gazzut V: klore _ klore _ SAME
ruohkkat V: klore _ klø, klore
gaccastit V: klore _ spise en skjefull; klore
rámpostit V: skryte _ rose, skryte
gerret V: skryte _ rose, skryte
rámpot V: skryte _ rose; skryte
gieldit V: forby; nekte _ forby, nekte
giitit V: takke _ takke _ SAME
giitalit V: takke _ takke _ SAME
muollat V: brøle _ belje, brøle
rohkut V: brøle _ brøle _ SAME
gilljut V: brøle _ hyle, brøle
čeargut V: brøle; rope _ brøle; tordne
čerget V: brøle _ brøle; tordne
giljádit V: brøle _ hyle, brøle
veadjit V: orke _ orke, greie; kanskje
gillet V: orke _ orke _ SAME
gilvvohallat V: konkurrere _ konkurrere _ SAME
gilvalit V: konkurrere _ konkurrere _ SAME
gohcit V: våke _ våke _ SAME
gohčodit V: kalle; definere _ kalle, betegne
goikat V: tørke _ tørke _ SAME
goikadit V: tørke _ tørke; steke
sihkestit V: tørke; male _ tørke; male _ SAME
golgat V: renne; drive; drive _ renne; reke; drive
čierastit V: renne _ renne, ake
čierastallat V: renne _ renne, ake
govvet V: fotografere; illustrere _ fotografere
gođđat V: gyte _ gyte _ SAME
guoddit V: bære; føde _ bære; føde _ SAME
gáhtat V: angre _ angre _ SAME
gáibidit V: kreve _ kreve _ SAME
gásttašit V: døpe _ døpe _ SAME
gávdnot V: finnes _ finnes _ SAME
gávppahit V: handle _ handle _ SAME
gávppašit V: handle _ handle, drive handel
háisut V: lukte _ lukte, stinke
haksit V: lukte _ lukte _ SAME
háleštit V: prate; snakke _ prate, snakke sammen
humadit V: prate; snakke _ prate
hábmet V: utforme; skape _ utforme
hálahit V: overtale; påvirke _ overtale
hávdádit V: begrave; gravlegge _ begrave
čuodjat V: lyde; ringe _ klinge, ringe, lyde
jeagadit V: lyde _ lyde, lystre
jeđđedit V: trøste _ trøste _ SAME
juohkit V: dele; spre; fordele; tildele _ dele
juogadit V: dele; fordele; tildele _ dele; dele ut
juolludit V: bevilge; gi; tildele _ avse; bevilge
leiket V: skjenke _ skjenke, helle
njorret V: skjenke _ skjenke _ SAME
leaikut V: skjenke _ skjenke, helle
njorrestit V: skjenke _ skjenke _ SAME
loaktit V: trives _ forbruke; trives
lohpidit V: love _ love _ SAME
lágidit V: ordne; arrangere; lage _ stelle, ordne; arrangere
stellet V: ordne; plassere _ stelle, ordne, plassere
lávlut V: synge _ synge _ SAME
maŋidit V: utsette _ utsette; saktne
mieđuštit V: ledsage; følge _ ledsage, følge
mihtidit V: måle _ måle _ SAME
moddját V: smile _ smile _ SAME
muitit V: huske; minnes _ huske, minnes
muittašit V: minnes _ minnes _ SAME
máhccut V: brette _ brette; bukke
máhcastit V: brette _ brette _ SAME
niegadit V: drømme _ drømme _ SAME
áitit V: true _ true _ SAME
uhkidit V: true _ true _ SAME
nihttit V: true _ true _ SAME
vuohkadit V: true _ true _ SAME
šállošit V: beklage _ beklage _ SAME
nuvkkihit V: nikke _ nikke _ SAME
nivkalit V: nikke _ nikke _ SAME
nivkut V: nikke _ nikke _ SAME
njuovvat V: slakte _ slakte, flå
njuovadit V: slakte _ slakte _ SAME
vuoidat V: smøre _ smøre _ SAME
njuvdit V: smøre _ kline, smøre
nomineret V: nominere _ nominere _ SAME
čuoččuhit V: påstå; hevde _ hevde, påstå
náitalit V: gifte seg _ gifte seg _ SAME
návddašit V: nyte _ nyte, smake
oaffaruššat V: ofre _ ofre _ SAME
oastit V: kjøpe _ kjøpe _ SAME
vealahit V: diskriminere _ diskriminere; berøve
olgguštit V: diskriminere; tilsidesette _ diskriminere, tilsidesette
orrut V: bo; synes _ være, bli; bo; synes
rasttidit V: krysse _ krysse _ SAME
organiseret V: organisere _ organisere _ SAME
šaddat V: fødes; komme; vokse _ vokse; fødes; bli; komme til å
riegádit V: fødes; føde _ fødes
riepmat V: begynne _ begynne _ SAME
viehkat V: løpe; springe _ løpe
ruohttat V: løpe; springe _ løpe
ráhkistit V: elske _ elske, være glad i
sihkkelastit V: sykle _ sykle _ SAME
sojahit V: bøye _ bøye _ SAME
stirdut V: stivne _ stivne _ SAME
stávet V: stave _ stave _ SAME
suodjalit V: beskytte; bevare; verne; sikre _ verne, beskytte
várjalit V: beskytte; forsvare _ forsvare, beskytte
suoskat V: tygge _ tygge _ SAME
sáltet V: salte _ salte _ SAME
tennjet V: tegne _ tegne _ SAME
tevdnet V: tegne _ tegne _ SAME
vajáldahttit V: glømme; glemme _ glømme
vardit V: blø _ blø _ SAME
vuoksit V: spy _ spy _ SAME
vuovssadit V: spy _ spy _ SAME
áibbašit V: lengte _ lengte _ SAME
ánssášit V: fortjene _ fortjene _ SAME
árbet V: arve _ arve _ SAME
ávvudit V: feire; markere _ feire; fryde seg
gođđit V: binde; knytte _ strikke; veve; binde, knytte
čiekčat V: sparke _ spenne, sparke
čievččastit V: sparke _ sparke, spenne
čábbudit V: pynte _ gjøre penere, pynte
čorget V: rydde _ gjøre reint, rydde, stelle
šliipet V: slipe _ slipe _ SAME
šluhttet V: avlyse _ avlyse _ SAME
ákkastallat V: argumentere; begrunne _ argumentere
filbmet V: filme _ filme _ SAME
levget V: flagge _ flagge _ SAME
dáruiduhttit V: fornorske _ fornorske _ SAME
libardit V: vaie _ flagre, vaie
bombet V: bombe _ bombe _ SAME
lásset V: låse _ låse _ SAME
fállat V: tilby _ tilby, by på
doarjut V: støtte _ støtte, gi tilslutning til
doarjalit V: støtte _ støtte _ SAME
čuožžilit V: oppstå _ reise seg
beroštit V: interessere _ bry seg om
seastit V: spare; redusere _ spare
bealuštit V: forsvare _ forsvare; forfekte; ta part
olggosaddit V: utgi _ utgi _ SAME
málet V: male _ male _ SAME
ferdnet V: male _ male, kverne
bossut V: blåse _ blåse _ SAME
bosádit V: blåse _ blåse _ SAME
bieggat V: blåse _ blåse _ SAME
analyseret V: analysere _ analysere _ SAME
márkanastit V: markedsføre _ markedsføre _ SAME
suddat V: smelte _ smelte, tine
suddadit V: smelte _ smelte _ SAME
vuohčut V: smelte _ piple; smelte
guođđit V: forlate _ forlate, etterlate
guođđilit V: forlate _ forlate, etterlate
gaivát V: glane; se _ glane, glo
gávkat V: glane _ glane, glo
olahit V: nå; nå; oppnå _ rekke, nå
joksat V: nå; nå; innhente; oppnå _ innhente
juksat V: nå; nå; oppnå _ nå igjen
ollit V: nå; strekke _ nå, rekke
noddet V: nå _ nå, rekke
eaiggáduššat V: eie _ eie _ SAME
oamastit V: eie _ tilegne seg; eie
riegádahttit V: føde _ føde, nedkomme
beaskidit V: klippe _ klippe _ SAME
vadjat V: klippe _ klippe, skjære; lokke
ofelastit V: følge _ vise veg, guide
gávdnat V: finne _ finne _ SAME
dádjadit V: finne _ finne fram
merket V: merke _ merke _ SAME
mearkut V: merke _ merke _ SAME
merkot V: merke _ legge merke til
dárkot V: merke; undersøke; observere _ betrakte, undersøke
vávjit V: merke; mistenke; kritisere _ mistenke; kritisere
vuohttit V: merke _ finne spor, følge spor
mannat V: reise; dra; gå _ gå, dra, reise
johtit V: reise; flytte _ bevege seg; reise; flytte
vuolgit V: reise; dra _ dra, reise av sted
mátkkoštit V: reise; ferdes _ reise, ferdes
čuoččahit V: reise _ reise seg; stille seg
oahppat V: lære _ lære; se etter fangst
badjánit V: stige _ stige _ SAME
goargŋut V: stige; øke _ klatre; stige; stake elvebåt
lassánit V: stige; øke _ øke
časkit V: slå; slå _ slå
speažžut V: slå _ daske, slå
huškkastit V: slå _ slå _ SAME
ravkit V: slå _ slå _ SAME
meaidit V: slå; hogge _ slå, hogge, meie
šávget V: slå _ slå, helle
šávgut V: slå _ slå, helle
roaškut V: slå; smelle _ slå, smelle
sárdnut V: tale; snakke _ tale
ságastallat V: tale; diskutere _ snakke sammen
vahágahttit V: skade; ødelegge _ skade
roasmmuhuvvat V: skade _ bli skadet, skade seg
deaddit V: presse; veie; trykke _ trykke, presse; veie
bahkket V: presse _ trenge på, trenge seg fram; presse; være nærgående
geahččat V: se _ se, se på
geahčadit V: se _ forhåndsgranske
guovlat V: se _ kike, titte
rahpat V: åpne _ åpne, lukke opp
rabastit V: åpne _ åpne, lukke opp
rabestit V: åpne _ åpne, lukke opp
leahkkut V: åpne _ åpne, lukke opp
leahkastit V: åpne _ åpne, lukke opp
rahpasit V: åpne _ åpne seg
guoskkahit V: røre; berøre; omtale _ røre, berøre
lihkahit V: røre; røre _ røre, bevege
lihkastit V: røre _ bevege, røre
njuorasmahttit V: røre _ ydmyke
bávkit V: smelle _ smelle _ SAME
beaškit V: smelle _ smelle; slamre
spoahkkit V: smelle _ smelle _ SAME
beaškkihit V: smelle _ smelle; kollidere
spoahkkalit V: smelle _ smelle, smekke
bávkkihit V: smelle _ smelle _ SAME
bidjat V: sette; sette; sette; plassere _ sette; legge
bidjalit V: sette _ legge, sette
bordit V: sette _ stable
baldit V: skremme _ skremme _ SAME
baldalit V: skremme _ skremme _ SAME
balddáhallat V: skremme _ skremme _ SAME
surgehit V: skremme _ skremme _ SAME
gárvvistit V: forberede _ forberede, gjøre klar
ráhkkanahttit V: forberede _ utruste, forberede
ráhkkanit V: forberede _ gjøre seg klar
hásttuhit V: oppfordre; utfordre _ oppfordre, utfordre
hástalit V: utfordre _ utfordre _ SAME
guorahaddat V: undersøke _ undersøke _ SAME
iskkadit V: undersøke _ undersøke, holde på å forsøke
vihkket V: veie _ veie _ SAME
studeret V: studere _ studere _ SAME
vealtat V: unngå _ unngå _ SAME
dollet V: holde; stanse _ gripe, ta et tak; stanse; konfiskere; dra
doalahit V: holde; opprettholde _ holde, fortsette; la være
mielddisbuktit V: medføre; innebære _ medføre
ovdánahttit V: utvikle _ utvikle _ SAME
gárget V: utvikle _ vikle opp, rekke opp
ovdánit V: utvikle _ utvikle seg, gå framover, avansere
skeŋket V: gi _ forære, gi
lávet V: bruke _ pleie, bruke
golahit V: bruke _ bruke, forbruke
ávkkástallat V: bruke; utnytte _ utnytte
balahit V: mistenke _ engste seg for noe; mistenke
biehtadit V: nekte _ nekte; benekte
bihtit V: klare _ klare _ SAME
birget V: klare; overleve _ greie seg
biđget V: ødelegge; spre _ ødelegge; spre _ SAME
billistit V: ødelegge; undergrave _ ødelegge
billašuvvat V: ødelegge _ bli ødelagt
bissut V: holde seg; fortsette _ forbli, holde seg
bisihit V: stanse _ stanse _ SAME
rohkadallat V: be _ be _ SAME
lávdat V: spre _ spre seg utover
soaitit V: komme _ kanskje; tilfeldigvis komme til å
ollet V: komme _ nå fram
joavdat V: komme _ nå fram
ilbmat V: komme _ utkomme
čoaggit V: plukke; samle _ plukke
gaskit V: plukke _ ribbe, plukke
navvit V: plukke _ pirke, plukke
murjet V: plukke _ plukke bær
lubmet V: plukke _ plukke molter
gággat V: bryte _ bryte, velte
fággádit V: bryte _ bryte, ta tak
heaibut V: bryte _ bryte, ta tak
boatkanit V: bryte _ bryte sammen; slites av
botnjat V: vri _ vri _ SAME
bonjastit V: vri _ vri _ SAME
jorahit V: vri _ rotere
čugget V: stikke _ stikke _ SAME
čuoggut V: stikke _ stikke _ SAME
čuggestit V: stikke _ stikke _ SAME
viehkalit V: stikke; springe _ løpe avgårde
čuohcit V: påvirke; berøre _ påvirke, berøre
bálkestit V: kaste _ kaste _ SAME
suhppet V: kaste; kaste _ kaste; sette ut
bálkut V: kaste _ kaste _ SAME
suohpput V: kaste; kaste _ kaste; sette ut garn, line, not
njoarostit V: kaste _ kaste lasso
cancut V: springe _ springe, sprette
dadjat V: si _ si _ SAME
jietnadit V: si; uttale _ gi lyd fra seg
jienádit V: si _ ytre, ymte
dadjalit V: si _ si fort
čárvet V: klype _ klype, klemme
čárvut V: klype _ klype, klemme
cikcut V: klype _ klype, knipe
cibmut V: klype _ knuge; klype
cuiggodit V: påpeke; kritisere _ formane, advare
savdnjit V: riste _ riste _ SAME
savdnjilit V: riste _ riste _ SAME
šluvgit V: riste _ riste, slenge
dállet V: riste _ riste _ SAME
náđđut V: trykke _ krype sammen; trykke
prentet V: trykke _ prente
oaidnalit V: treffe _ sees
digaštallat V: diskutere; drøfte _ debattere
diggedit V: diskutere _ diskutere, krangle
duddjot V: lage; skape _ lage, gjøre håndarbeid, utføre håndverk
duššindahkat V: undergrave _ annullere, undergrave
geavvat V: skje; gå _ heve seg; gå
dáncat V: trampe _ trampe _ SAME
earránit V: skilles; skille _ skilles
earuhit V: differensiere; skille _ differensiere, skjelne
evttohit V: foreslå; anbefale _ foreslå, avgi innstilling; ta til orde for
árvalit V: foreslå _ foreslå; ymte
fihttet V: oppfatte _ oppfatte, komme på
gaikut V: rive; slite _ rive, slite
njaskut V: rive _ gnage, rive
ravget V: slite _ rykke, slite
rundit V: slite _ slite, slepe
gaikkehit V: slite _ rykke til, slite
ravgut V: slite _ rykke, slite
váibadit V: slite _ trøtte ut
geassit V: dra; trekke _ dra, trekke
vázzit V: gå _ gå, spasere
vássit V: gå _ svinne, gå
hurgit V: gå _ ile, legge i veg
gollat V: gå _ gå, svinne
vázzilit V: gå _ begynne å gå
meannudit V: behandle _ oppføre seg; behandle
gieđahallat V: behandle _ bearbeide, behandle
dálkkodit V: behandle _ behandle for sykdom, medisinere
cielahit V: mobbe _ gjø på noen; skjelle ut
rievdat V: drive; endre _ drive, reke; forandre seg
gullat V: høre _ høre; tilhøre
gullostit V: høre _ plutselig høres; føles svakt
lihkahallat V: berøre _ berøre; bevege
einnostit V: anta; anslå; forvente _ forutsi, spå, antisipere
gáhttet V: bevare; verne _ vokte, ta vare på, bevare
sorját V: henge _ henge _ SAME
heaŋgát V: henge _ henge _ SAME
heŋget V: henge _ henge opp
heaŋgut V: henge _ henge opp
sorjalit V: henge _ henge _ SAME
harcet V: henge _ henge _ SAME
heivehit V: tilpasse _ tilpasse _ SAME
hoallat V: snakke _ snakke _ SAME
dárustit V: snakke _ snakke norsk
sámástit V: snakke _ snakke samisk
hoigat V: skyve _ skyve, puffe
hovdet V: lede _ lede, styre
čuorvut V: rope _ rope _ SAME
čurvet V: rope _ rope _ SAME
doahput V: skaffe _ gripe
áittardit V: skaffe _ passe på saker; skaffe; sørge for
geasuhit V: rekruttere _ tiltrekke
áddehaddat V: forstå _ forstå hverandre
šuvvat V: suse _ suse _ SAME
šoavvat V: suse _ suse, bruse
juhcat V: suse _ suse, bruse
julggaštit V: erklære _ erklære _ SAME
juoigat V: joike _ joike _ SAME
juoiggastit V: joike _ joike litt
jáddadit V: slukke _ slukke _ SAME
čáskadit V: slukke _ slukke _ SAME
jáddat V: slukke _ slukne
njávkkadit V: stryke _ stryke _ SAME
njávkat V: stryke _ stryke med handa
liktet V: stryke _ pusse; stryke
veallát V: ligge _ ligge _ SAME
livvadit V: ligge _ ligge _ SAME
vealládit V: ligge _ ligge _ SAME
veallánit V: ligge _ legge seg
gárvet V: sluttføre _ gjøre ferdig
geargat V: sluttføre _ bli ferdig
lonet V: låne _ låne _ SAME
luoikkahit V: låne _ låne hos noen
moaitit V: kritisere _ klage over
čuolastit V: hogge _ hogge _ SAME
njáskat V: hogge _ kviste; rydde mark
meroštit V: definere; anslå; beregne _ anslå; definere
molssodit V: skifte _ skifte _ SAME
moraštit V: sørge _ sørge _ SAME
máinnastit V: fortelle _ fortelle, fortelle eventyr
nuppástuvvat V: endre _ forandre seg
namahit V: omtale; nevne; oppnevne _ nevne
nammadit V: omtale; oppnevne _ oppnevne; omtale
jođašit V: ferdes _ bevege
vánddardit V: ferdes _ vandre, streife
vádjolit V: ferdes _ vandre
johtalit V: ferdes _ rikle, slarke; ferdes
oaivvildit V: mene _ mene, ta stilling til
oidnot V: synes _ synes _ SAME
vuhttot V: synes _ spores
speallat V: spille _ spille; spille kort
neaktit V: spille _ se ut som; spille
čuojahit V: ringe _ ringe; spille
riŋget V: ringe _ ringe _ SAME
riŋgestit V: ringe _ ringe _ SAME
sivdnidit V: skape _ skape, signe
soahtat V: kjempe _ kjempe, krige
vajálduvvat V: glemme _ glemmes
vuordit V: vente; forvente _ vente
vuorddašit V: vente _ vente lenge
veavdit V: vente _ vente, hale med seg
viiddidit V: utvide _ utvide _ SAME
stuoridit V: utvide; øke _ forstørre
viidánit V: utvide _ spre seg; utvide seg
vuosehit V: vise _ vise _ SAME
čájáhallat V: vise _ framvise
válljet V: velge _ velge _ SAME
čierrut V: gråte _ gråte _ SAME
čalmmustahttit V: markere; belyse _ fokusere på, gjøre synlig
čuolbmadit V: knytte _ knytte _ SAME
čadnot V: knytte _ knyttes til
čatnasit V: knytte _ bli bundet
čuvget V: belyse; opplyse _ opplyse, belyse
čuožžut V: stå; stå _ stå
ceaggát V: stå _ stå oppreist
čuččodit V: stå _ bli stående
stuorrut V: vokse; øke _ bli stor
sisttisdoallat V: inneholde; omfatte _ inneholde
oasálastit V: delta _ delta _ SAME
oassálastit V: delta _ delta i
searvat V: delta _ slutte seg sammen
dolastit V: fyre _ fyre, ha bål
ligget V: fyre _ varme
laskat V: øke _ øke, formere seg
lasihit V: øke _ legge til, øke
hukset V: bygge _ bygge _ SAME
rávdat V: trekke _ trekke _ SAME
jiellat V: trekke _ trekke, blåse svakt
geassádit V: trekke _ trekke seg
rohttet V: trekke _ rykke; komme på
vuorbádit V: trekke _ kaste lodd, trekke lodd
sihkkarastit V: sikre _ sikre _ SAME
fárret V: flytte _ flytte _ SAME
unnidit V: redusere _ forminsk
uhcidit V: redusere _ forminske
registreret V: registrere _ registrere _ SAME
áicat V: registrere; observere _ oppdage
vuoittáhallat V: tape _ tape _ SAME
láhppot V: tape _ gå seg vill
oažžut V: motta; oppnå _ få
vuostáiváldit V: motta _ ta imot
njulget V: rette _ rette ut, glatte ut
gálgat V: løse _ løse _ SAME
rátkit V: skille _ skille, skille rein
rátkkašit V: skille _ skille _ SAME
imaštit V: overraske _ forundre seg
hirpmástuvvat V: overraske _ bli forskrekket
hirpmahuvvat V: overraske _ bli forskrekket
divustit V: justere _ rette på
divaštallat V: drøfte _ diskutere
dovddiidit V: identifisere _ erfare, lære å kjenne
lahttudit V: innlemme _ innlemme, inkorporere
duogŋat V: bøte _ lappe
čiktit V: bøte _ bøte garn; bøye en skitupp
fearrat V: meisle _ telje
gomihit V: oppheve _ velte; avvise; gjendrive
