telefonoktavuohta N: telefonforbindelse N; telefonkontakt N _ telefontilknytning N _ m
máksinnákca N: betalingsevne N; likviditetsforvaltning N; likviditet N _ likviditet N _ m
festiváladoarjja N: festivaltilskudd N; festivalstøtte N _ festivalstønad N _ m
oljoopmodat N: oljeformue N _ oljeressurser N _ m
fuolkevuođanamahus N: slektskapsbenevnelse N _ slektsskapsbenevnelse N _ m
rámmadoarjja N: rammetilskudd N _ rammestøtte N _ m
riikkasearvi N: landsforbund N; riksforbund N _ landsforening N _ m
investerendoarjja N: investeringstilskudd N; investeringsstøtte N _ investeringsstønad N _ m
deaivvadanbáiki N: møtested N; møteplass N _ treffsted N _ m
lassiealáhus N: tilleggsnæring N _ attåtnæring N, bierverv N _ m
lohkkiidčálus N: leserinnlegg N _ leserbrev N _ m
bealdu N: jordbearbeiding N; innmark N _ åker N _ m
kulturdoarjja N: kulturstøtte N _ kulturstønad N _ m
boazodoallošiehtadallan N: reindriftsavtaleforhandling N; reindriftsforhandling N _ reindriftsforhandling N _ m
niitu N: utmarksslått N _ natureng N _ m
giehtaduodji N: håndverksprodukt N; håndarbeid N; håndverk N _ håndarbeid N _ m
oahppodilli N: undervisningssituasjon N; opplæringssituasjon N _ læresituasjon N _ m
birasgáhttenossodat N: miljøvernavdeling N _ miljøvernenhet N _ m
čearda N: stammefolk N; art N _ art N _ m
oahppofálaldat N: opplæringstilbud N; studietilbud N; utdanningstilbud N; undervisningstilbud N _ undervisningstilbud N _ m
bargoeaktu N: arbeidsvilkår N _ arbeidsbetingelse N _ m
galmmihanrusttet N: fryseanlegg N _ kjøleanlegg N _ m
vázzinsoabbi N: spaserstokk N _ gåstav N _ m
váikkuheapmi N: medvirkning N; påvirkning N; innflytelse N _ påvirkning N _ m
opmodatvearru N: formuesskatt N; formueskatt N _ formueskatt N _ m
stohpogálvu N: innbo N; inventar N; møbel N _ møbel N _ m
eallineaktu N: livsvilkår N; levevilkår N; levekår N _ levevilkår N _ m
bázahus N: avfall N; rest N; levning N; slam N _ rest N _ m
guhkkodat N: lengde N _ utstrekning N _ m
finnmárkulaš N: finnmarking N _ finnmarksværing N _ m
duktásadji N: tuft N; hustuft N _ hustuft N; tomt N _ m
fággi N: ankerfeste N _ ryggtak N _ m
mearrabivdu N: sjøfiske N; fiske N _ fiske N _ m
fievru N: transportmiddel N; framkomstmiddel N; kjøretøy N _ framkomstmiddel N _ m
davvisámegiella N: nordsamisk N _ nordsamisk A _ m
muorraduodji N: tresløyd N _ sløyd N _ m
rehkenastin N: oppgjør N; beregning N; regning N _ det å regne sammen N _ m
oljobohkan N: oljeproduksjon N; oljevirksomhet N; oljeutvinning N _ oljeboring N _ m
gaskaoapmi N: virkemiddel N; middel N; redskap N; verktøy N _ middel N _ m
čulku N: tvangstrøye N _ kubbe N _ m
báhčinguovlu N: skytefelt N _ skyteområde N _ m
vearrogeasus N: skattefradrag N; skattetrekk N _ skattetrekk N _ m
áššesuorgi N: saksområde N; saksfelt N _ saksområde N _ m
riektedilli N: rettsforhold N; rettsstilling N _ rettsstilling N, rettslig stilling N _ m
geahpádus N: reduksjon N; lettelse N _ lettelse N, minskning N _ m
oasálaš N: part N; aktør N; deltaker N _ medvirkende N, partisipant N, deltaker N; deleier N _ m
lášmmohallan N: opptrening N; kroppsøving N; kroppsøvning N; gymnastikk N _ gymnastikk N _ m
dieđihangaskaoapmi N: medium N _ media N _ m
oahppaplána N: læreplan N _ læreplanverk N _ m
oahppoplána N: læreplan N; studieplan N; læreplanverk N _ studieplan N _ m
ovttadássásašvuohta N: likeverdighet N; likeverd N; likestilling N _ likestilling N _ m
láigosoahpamuš N: leieavtale N _ leiekontrakt N _ m
fápmojođas N: kraftledning N _ strømledning N _ m
gáma N: kommag N; sko N _ fottøy N; komag N, skalle N _ m
badjelgeahččanvuohta N: intoleranse N _ overlegenhet N _ m
gohččun N: innkalling N; kommando N; pålegg N _ innkallelse N; reskript N _ m
siibma N: håndsnøre N _ fortom N _ m
šibitdoallu N: husdyrhold N _ storfehold N _ m
čoarbbealli N: hoft N; lår N _ lår N, hofte N _ m
astoáiggeortnet N: fritidsordning N _ skolefritidsordning N _ m
várra N: fare N; risiko N _ forsiktighet N _ m
bivdoroggi N: fangstgrop N _ dyregrav N _ m
oassemáksu N: delutbetaling N _ avdrag N _ m
ágga N: begrunnelse N; argument N; grunn N _ unnskyldning N; argument N _ m
bargoduogáš N: yrkeserfaring N; arbeidserfaring N; praksis N _ praksis N _ m
bargovásihus N: yrkeserfaring N; arbeidserfaring N _ arbeidserfaring N _ m
heahteveahkki N: nødhjelp N; førstehjelp N _ førstehjelp N _ m
birasgáhttendepartemeanta N: miljøverndepartement N _ miljødepartement N _ m
bálká N: honorar N; betaling N; lønn N _ betaling N _ m
girdijohtolat N: flytrafikk N _ lufttrafikk N _ m
dávvir N: gjenstand N; eiendel N; skatt N; verdi N; utstyr N _ eiendel N, skatt N, verdi N _ m
latiinnagiella N: latin N _ latinsk N _ m
olmmošlohku N: innbyggertall N; folketall N _ innbyggertall N _ m
gávpi N: butikk N; salg N; handel N _ handel N; forretning N _ m
luonddugáhttensearvi N: naturvernforbund N _ miljøvernforening N _ m
geavahanvuoigatvuohta N: bruksrettighet N; bruksrett N _ bruksrettighet N _ m
náittosgovva N: bryllupsbilde N _ brudebilde N, bryllupsbilde N _ m
bealgi N: tommelfinger N _ tommelfinger N, tommel N; stortå N _ m
čeahborbeaska N: pesk N _ pesk N, tykk pesk N, pesk av tykt høstskinn N _ m
gielis N: løgn N _ løgn N; løgner N _ m
vuoján N: hest N; kjøretøy N _ kjørerein N; hest N _ m
jurdda N: tanke N; ide N; idé N _ tanke N _ m
jápmin N: dødsfall N; død N _ døden N _ m
váikkuhus N: påvirkning N; konsekvens N _ virkning N; påvirkning N _ m
fierbmi N: nettverk N; garn N _ fiskegarn N _ m
báddi N: bånd N; bånd N _ tau N _ m
govadat N: figur N _ riss N _ m
biebmogálvu N: matprodukt N; matvare N; næringsmiddel N _ næringsmiddel N _ m
vuorrádus N: engstelse N; uro N _ knipe N _ m
oalli N: dimensjon N _ djupål N; bakstykke N _ m
siskkoš N: innmat N _ det indre N _ m
joavku N: familie N; husstand N; flokk N; gruppe N _ flokk N, gruppe N; lag N; husstand N _ m
čoarvi N: gevir N; horn N _ horn N _ m
diehtu N: informasjon N; beskjed N; kunnskap N; opplysning N _ kunnskap N, viten N; informasjon N _ m
leaika N: humor N; spøk N _ spøk N _ m
dáidu N: sans N; kunnskap N; evne N _ kunnskap N; forstand N _ m
resursaváili N: ressursknapphet N _ ressurssvak A _ m
linnjábiila N: tog N _ rutebuss N; tog N _ m
badjenisu N: reindriftssame N; reindriftskvinne N _ reindriftssame N _ m
giellaovdáneapmi N: språkutvikling N _ språklig utvikling N _ m
fuomášupmi N: ide N; oppmerksomhet N; fokus N _ ide N _ m
bearráigeahčču N: tilsyn N; kontroll N _ oppsyn N _ m
sáhppi N: saft N _ galle N _ m
riidu N: konflikt N; strid N _ trette N, krangel N _ m
