SME lemma pos: fad NOB lemma pos _ gt NOB lemma pos _ placeholder for action tag
njuoras A: ydmyk A; mild A; svak A _ øm A, mild A, svak A _ 
jábálaš A: velstående A; rik A _ rik A _ 
oahppováillat A: utdanningsskadelidt A; utdanningsskadelidende A _ uten utdanning A _ 
hilbat A: uskikkelig A; rampet A _ vilter A, skøyeraktig A _ 
balddihahtti A: urovekkende A; skremmende A _ skremmende A _ 
boasttu- A: uriktig A _ feil A, uriktig A _ 
oahppameahttun A: uoppdragen A _ ulærd A _ 
dohkketmeahttun A: uholdbar A; uakseptabel A _ ubrukelig A, udugelig A, uakseptabel A _ 
ávdin A: ubebodd A; øde A _ øde A _ 
eahpečielggas A: uavklart A; uklar A _ uklar A _ 
áddjái A: tidkrevende A; sein A _ sein A, tidkrevende A _ 
váibbas A: søvnig A; trøtt A _ trøtt A _ 
seaggi A: sped A; smal A; tynn A _ tynn A, spinkel A _ 
bahánihkkán A: slem A _ uskikkelig A _ 
árvvas A: sjenerøs A; gavmild A _ generøs A, gavmild A _ 
starggas A: robust A; stiv A _ stiv A, stø A _ 
válmmaš A: rede A; ferdig A _ ferdig A _ 
mearkkalaš A: pussig A; merkelig A _ merkelig A _ 
oktageardán A: primitiv A; naiv A; enkel A _ enkel A _ 
ebmui A: prektig A; flott A _ flott A _ 
nággár A: opposisjonell A; gjenstridig A _ sta A, stridig A _ 
jierbmái A: oppegående A; intelligent A; klok A; smart A _ klok A _ 
návccaheapme A: næringssvak A; svak A _ svak A, veik A _ 
dárogielat A: norsktalende A; norsk A; norskspråklig A _ norskspråklig A _ 
dárogiel A: norsk A; norskspråklig A _ norskspråklig A _ 
šlundi A: nedslått A _ motløs A, bedrøvet A _ 
suohtas A: moro A; morsom A; hyggelig A _ morsom A, hyggelig A _ 
hállái A: meddelsom A _ pratsom A _ 
máŋggabealat A: mangeartet A; allsidig A _ allsidig A, mangesidig A _ 
vigiheapme A: lytefri A; uskyldig A _ uskyldig A _ 
lágalaš A: lovmessig A; rettslig A; lovlig A _ lovlig A; rettsgyldig A _ 
eleš A: livskraftig A _ kvikk og livlig A; livsdyktig A; lengelevende A _ 
beakkálmas A: legendarisk A; kjent A _ kjent A, berømt A _ 
riikkaviidosaš A: landsomfattende A; landsdekkende A; nasjonal A _ riksdekkende A _ 
gelbbolaš A: kompetent A; verdig A _ dugelig A; verdig A _ 
vuoiŋŋalaš A: immateriell A; åndelig A; religiøs A; mental A _ åndelig A _ 
muittoheapme A: glemsk A _ glømsk A, glemsom A, distre A _ 
várrugas A: føre var A; var A _ forsiktig A _ 
máđoheapme A: formidabel A _ forskrekkelig A _ 
dáláš A: eksisterende A _ nåtidens N _ 
dálá A: eksisterende A _ nåtidig A _ 
láiki A: doven A _ lat A _ 
jállu A: djerv A; modig A _ modig A _ 
njuolgat A: direkte A; rett A _ rett A, bein A _ 
njálggat A: deilig A _ velsmakende A, søt A _ 
šealgat A: blinkende A _ blank A _ 
mearrideaddji A: avgjørende A _ bestemmende A _ 
anihahtti A: anvendelig A; anvendbar A _ brukbar A _ 
falli A: sportslig A; rask A _ rask A _ 
roastil A: uredd A _ dristig A _ 
dábálaš A: allmenn A; ordinær A; normal A; standard A; vanlig A _ vanlig A, alminnelig A _ 
erenoamáš A: særlig A; særskilt A; spesiell A _ spesiell A, ekstra A _ 
vásedin A: særlig A; særskilt A _ særskilt A _ 
ahkit A: trist A; kjedelig A _ kjedelig A, utrivelig A _ 
ovttaskas A: enkelt A _ enslig A _ 
eaŋkil A: enkelt A; enkel A _ enkel A _ 
duhtavaš A: tilfreds A; fornøyd A _ fornøyd A _ 
geasuheaddji A: attraktiv A _ tiltrekkende A _ 
bivnnut A: attraktiv A; populær A _ omsvermet A, godt likt A _ 
jearggalaš A: konsekvent A; fornuftig A; rasjonell A _ fornuftig A _ 
garas A: streng A; sterk A; voldsom A; hard A _ hard A _ 
čavgat A: streng A _ stram A _ 
goavvi A: streng A; vanskelig A _ hensynsløs A _ 
áddehahtti A: brukervennlig A; forståelig A _ forståelig A _ 
udju A: beskjeden A _ sjenert A _ 
girjái A: variert A; mangfoldig A _ spraglet A, flekket A _ 
dohkálaš A: forsvarlig A _ høvelig A, tjenlig A _ 
ráfálaš A: harmonisk A; fredelig A _ fredelig A _ 
soabalaš A: harmonisk A; fredelig A _ fredelig A, forsonlig A _ 
olgguldas A: ekstern A; ytre A _ ytre A, utvendig A _ 
roahkkat A: utadvendt A; åpen A _ freidig A _ 
čorgat A: ryddig A _ renslig A _ 
ovddit A: fremre A; foregående A _ tidligere A, foregående A, forrige A; fremre A _ 
ovddimus A: fremre A; første A _ først A, fremst A _ 
bargonávccalaš A: yrkesaktiv A _ arbeidsfør A _ 
heivvolaš A: hensiktsmessig A; egnet A; passelig A _ passelig A _ 
ávkkálaš A: hensiktsmessig A; nyttig A _ nyttig A; formålstjenlig A _ 
ovttalágan A: lik A _ samme slags A _ 
seammalágan A: lik A; tilsvarende A _ likedan A _ 
dárbbašmeahttun A: unødig A; unødvendig A _ unødvendig A _ 
soddjil A: dynamisk A; fleksibel A _ bøyelig A _ 
bistevaš A: permanent A; fast A; langvarig A _ varig A, fast A _ 
bissovaš A: permanent A; kronisk A; fast A _ vedvarende A _ 
njoahci A: sakte A; sein A; treg A; sen A _ sein A, langsom A _ 
ođđaáigásaš A: tidsriktig A; moderne A _ moderne A _ 
moivvas A: forvirrende A; uklar A _ uklar A, grumset A _ 
báhkas A: opphetet A; varm A _ varm A _ 
viiddis A: omfattende A; vid A; bred A _ vid A, utstrakt A _ 
alvvalaš A: offensiv A _ energisk A _ 
bahá A: ond A; alvorlig A _ sint A _ 
gutneheapme A: uverdig A; frekk A _ frekk A _ 
árvvoheapme A: uverdig A; vanskelig A _ vanskelig A, brysom A; verdiløs A _ 
hearki A: utsatt A; sårbar A; svak A _ øm A, følsom A _ 
seammasullasaš A: tilsvarende A; lignende A _ lignende A _ 
sullasaš A: tilsvarende A; liknende A; lignende A _ liknende A _ 
oskkáldas A: trofast A; lojal A _ pålitelig A _ 
ruđalaš A: finansiell A; økonomisk A; rik A _ pengemessig A; rik A _ 
gánnáhahtti A: bærekraftig A; lønnsom A _ lønnsom A _ 
bajimuš A: overordnet A _ øverst A _ 
bajit A: overordnet A; øvre A _ øvre A _ 
válddálaš A: uttrykkelig A; mektig A; myndig A _ mektig A, myndig A _ 
váilevaš A: mangelfull A; manglende A _ manglende A _ 
sámegielat A: samisk A _ samiskspråklig A _ 
vuosttaš A: første A; første A _ først A _ 
vuosttas A: første A; første A _ først A _ 
ovddemus A: første A _ først A _ 
vuosttamuš A: første A _ først A _ 
fiinnis A: flott A; fin A _ fin A _ 
almmolaš A: offisiell A; offentlig A _ offentlig A, offisiell A _ 
beaktil A: næringsrik A; effektiv A _ næringsrik A _ 
álbmái A: næringsrik A _ kraftig A _ 
boahtteáigásaš A: fremtidsrettet A; fremtidig A; framtidig A _ fremtidsrettet A, fremtidig A _ 
liekkus A: varm A; hyggelig A _ hyggelig A, koselig A _ 
dearvvaš A: sunn A; frisk A _ frisk A _ 
dárki A: viss A; sikker A _ viss A, sikker A _ 
dihto A: viss A; bestemt A _ viss A _ 
vissis A: viss A; bestemt A; sikker A _ sikker A; bestemt A, viss A _ 
duihmi A: dum A _ dum A, tungnem A _ 
duođalaš A: alvorlig A; høytidelig A; reell A _ alvorlig A _ 
ovddolaš A: underlig A; merkelig A _ underlig A, merkelig A _ 
ártet A: underlig A; merkelig A; rar A _ rar A, merkelig A _ 
eaimmaskas A: underlig A _ snodig A, underlig A _ 
ealas A: livlig A; kvikk A; levende A _ livlig A, kvikk A, energisk A _ 
virkui A: livlig A; kvikk A; vital A _ kvikk A, livlig A _ 
vitmat A: kvikk A; skarp A; dyktig A _ lærenem A, skarp A _ 
áŋgir A: flittig A; ambisiøs A; ivrig A _ ivrig A, flittig A _ 
viššal A: flittig A; aktiv A _ flittig A _ 
ealjár A: flittig A; dyktig A _ flittig A _ 
fasti A: stygg A; fæl A _ stygg A, fæl A _ 
čáppat A: fin A; pen A; vakker A _ pen A _ 
luovus A: fri A; løs A _ løs A, laus A _ 
veaittalas A: fri A _ fri A, på egen hånd A _ 
headju A: dårlig A; svak A; negativ A _ dårlig A, skral A _ 
heittot A: dårlig A; svak A _ dårlig A, svak A _ 
fuotni A: dårlig A; svak A; negativ A _ dårlig A _ 
čoaskkis A: kald A _ kjølig A _ 
geatnegas A: ansvarlig A _ pliktig A; ansvarlig A _ 
návccalaš A: sterk A; dyktig A _ sterk A, dyktig A _ 
searalaš A: sterk A; dyktig A; selvstendig A _ sterk A, dyktig A _ 
gievra A: sterk A; sterk A; sterk A _ sterk A _ 
nanus A: sterk A _ solid A, sterk A _ 
gárži A: smal A; trang A _ trang A, smal A _ 
hiđis A: sein A; sen A _ sein A _ 
siivui A: lydig A; rolig A; snill A _ snill A, rolig A _ 
suvrris A: sur A; sur A _ sur A _ 
jiesas A: sur A _ sur A, blåsur A _ 
lihkolaš A: heldig A; lykkelig A _ lykkelig A, heldig A _ 
lámis A: ufør A _ vanfør A, ufør A, lam A _ 
lášmat A: smidig A; snar A _ smidig A, snar A _ 
movttet A: optimistisk A; glad A _ i godt humør A, optimistisk A _ 
mášoheapme A: urolig A _ rastløs A, urolig A _ 
riekta A: rett A; riktig A; korrekt A _ riktig A _ 
ollislaš A: fullverdig A; total A _ fullverdig A _ 
ovttageardán A: naiv A; ensidig A; enkel A _ enfoldig A, naiv A _ 
rabas A: åpen A; ledig A _ åpen A _ 
rehálaš A: hederlig A; ærlig A; rettferdig A _ ærlig A, hederlig A _ 
sierra A: særskilt A _ særskilt A; adskilt A _ 
villas A: vill A _ vill A, vilter A _ 
vilddas A: vill A _ ustyrlig A, vilter A _ 
bastil A: skarp A; kvass A _ kvass A _ 
unni A: lav A; liten A _ liten A _ 
váivái A: vanskelig A; ubehagelig A _ vanskelig A, ubehagelig A _ 
váigat A: vanskelig A; kjedelig A _ kjedelig A, vanskelig A _ 
čavddis A: urørt A _ tett A, uten hull A; urørt A _ 
čielggas A: tydelig A; klar A _ klar A, tydelig A _ 
olmmošlaš A: høflig A; folkelig A; menneskelig A; grei A _ høflig A; menneskelig A _ 
iešdáhtolaš A: frivillig A _ forsettlig A _ 
oktonas A: ensom A _ alene A _ 
buiga A: ekte A _ ekte A, virkelig A _ 
ilolaš A: glad A; gledelig A _ gledelig A _ 
almmus A: tilgjengelig A; offentlig A _ offentlig A _ 
mearkkašahtti A: betydelig A; påfallende A; vesentlig A _ betydningsfull A _ 
issoras A: enorm A _ forferdelig A _ 
máŧoheapme A: enorm A; umulig A _ umulig A _ 
áibmadas A: enorm A _ kolossal A _ 
gaskaboddosaš A: foreløpig A; midlertidig A _ midlertidig A _ 
jeagoheapme A: tverr A _ ulydig A _ 
govdat A: stolt A; bred A _ brei A, bred A _ 
čeavlái A: stolt A _ overlegen A, hoven A _ 
vuovdnái A: stolt A _ pågående A, energisk A; staselig A _ 
ilgat A: voldsom A _ nifs A _ 
stáđis A: stabil A; fast A _ stø A, fast A _ 
otná A: dag N _ dagens N _ 
otnáš A: dag N _ dagens N _ 
mávssolaš A: verdifull A; viktig A _ dyrebar A; viktig A _ 
muttát A: moderat A; passelig A; rimelig A _ passelig A _ 
rašši A: sårbar A; svak A _ veik A, skjør A _ 
agálaš A: uendelig A; evig A _ evig A _ 
jáhkehahtti A: troverdig A _ trolig A, sannsynlig A _ 
vuollásaš A: underliggende A _ underlagt A _ 
imaš A: påfallende A; merkelig A; rar A _ merkelig A _ 
risttalaš A: kristelig A; kristen A _ kristen A _ 
kristtalaš A: kristelig A; kristen A _ kristen A _ 
jaskat A: stille A; rolig A; taus A _ rolig A, stille A, taus A _ 
boahttevaš A: kommende A; fremtidig A; framtidig A _ kommende A _ 
albma A: skikkelig A _ ordentlig A, skikkelig A _ 
allat A: høy A _ høy A, høg A _ 
amas A: fremmed A; ukjent A _ fremmed A, ukjent A _ 
njárbat A: tynn A _ tynn A; glissen A _ 
goiddas A: tynn A; svak A _ tynn A, svak A _ 
rihča A: bitter A _ besk A, bitter A _ 
bealjeheapme A: døv A _ døv A, tunghørt A _ 
bávččas A: vond A _ vond A, smertefull A _ 
diehttalas A: naturlig A _ viss A, naturlig A _ 
dimis A: myk A; mjuk A _ myk A, mjuk A _ 
divrras A: dyr A; kostbar A _ dyr A, kostbar A _ 
doaŋgi A: stiv A _ stiv A, støl A, slapp A _ 
sieiva A: vanlig A; ren A _ vanlig A, alminnelig A _ 
dárkil A: grundig A _ nøyaktig A, grundig A _ 
vuđolaš A: grundig A; grunnleggende A _ grundig A, grunnleggende A _ 
earálágan A: annerledes A; ulik A; forskjellig A _ ulik A, forskjellig A, annerledes A _ 
nuppelágan A: annerledes A; forskjellig A _ annerledes A, forskjellig A _ 
unohas A: ubehagelig A; uheldig A _ uhøvelig A, ubehagelig A _ 
eatnjehas A: ubehagelig A _ ubehagelig A, nifs A _ 
gallji A: vid A _ vid A, rommelig A _ 
suohkat A: tykk A; frodig A _ tjukk A, tett A _ 
assái A: tykk A _ tjukk A _ 
gassat A: tykk A; dyp A; dyp A; grov A _ tykk A; dyp A; dyp A, grov A _ 
váfi A: tykk A; svær A; trygg A; sikker A; frodig A _ svær A, tjukk A; sikker A, trygg A _ 
čieŋal A: dyp A _ dyp A, djup A _ 
roakkas A: dyp A; grov A _ dyp A, grov A _ 
roattus A: dyp A; grov A _ grov A, dyp A _ 
roavis A: grov A; rå A _ grov A _ 
healpu A: lett A _ lett A, lettvint A _ 
álki A: lett A; enkel A _ lett A, lettvint A _ 
gillil A: utrettelig A _ utrettelig A, tålmodig A _ 
árjjalaš A: ivrig A; aktiv A _ ivrig A, energisk A _ 
givas A: ivrig A; modig A _ ivrig A, modig A _ 
guorus A: tom A; ledig A _ tom A _ 
válmmas A: ferdig A; klar A _ ferdig A, klar A _ 
gárvvis A: ferdig A; klar A _ ferdig A _ 
hávski A: morsom A; hyggelig A _ morsom A, hyggelig A _ 
hearvái A: morsom A _ herlig A, morsom A _ 
hávskái A: morsom A; hyggelig A _ hyggelig A, morsom A _ 
somá A: morsom A; artig A _ morsom A, artig A _ 
vuogas A: passelig A _ høvelig A, passelig A, behagelig A _ 
hálbi A: billig A; rimelig A _ billig A _ 
smáđáhkis A: hyggelig A; grei A _ hyggelig A _ 
iešlágan A: merkelig A _ merkelig A, noe for seg selv A _ 
jahkásaš A: årlig A _ årsgammel A; årlig A _ 
lodji A: rolig A _ tam A, rolig A _ 
viissis A: klok A _ klok A, vis A _ 
joavdelas A: unødvendig A _ unyttig A, unødvendig A _ 
loažžat A: løs A _ slapp A, løs A _ 
vejolaš A: mulig A; eventuell A _ mulig A _ 
njuoskkas A: våt A; rå A _ våt A, bløt A _ 
oppalaš A: generell A; total A _ generell A _ 
obbalaš A: generell A; total A _ generell A, fullstendig A _ 
vuoigat A: riktig A _ åpenhjertig A; riktig A _ 
ráhpat A: flink A _ bra A, flink A _ 
čeahppi A: flink A; dyktig A _ flink A _ 
siskkáldas A: intern A _ det indre A, innbyrdes A, intern A _ 
sitkat A: seig A _ seig A, utholdende A _ 
áššálaš A: skyldig A; saklig A _ skyldig A, tiltalt A _ 
sáhkkái A: nysgjerrig A _ nysgjerrig A; snakkesalig A _ 
sáhkkii A: nysgjerrig A _ nysgjerrig A; snakkesalig A _ 
vielgat A: hvit A _ kvit A, hvit A _ 
čalmmeheapme A: svaksynt A _ blind A, svaksynt A _ 
čihččet A: sjuende A; syvende A _ sjuende A _ 
čáppis A: pen A; vakker A _ pen A, vakker A _ 
eanaš A: mange A _ det meste A, de fleste A _ 
eanas A: mange A _ det meste A _ 
fávru A: vakker A _ skjønn A, vakker A _ 
hámálaš A: vakker A _ staselig A, vakker A _ 
láđis A: mild A _ mild A, blid A _ 
láivi A: mild A; svak A; svak A _ svak A _ 
ovddeš A: gammel A; tidlig A _ tidligere A _ 
dološ A: gammel A _ gammeldags A _ 
ollis A: full A; hel A _ hel A, full A _ 
dievaslaš A: full A _ fullstendig A _ 
dievas A: full A _ full A, fullstendig A _ 
oadjebas A: trygg A; trygg A _ trygg A _ 
dorvvolaš A: trygg A; trygg A; sikker A _ trygg A, tillitsfull A _ 
sihkar A: trygg A; trygg A; sikker A; sikker A _ sikker A _ 
vealtameahttun A: nødvendig A _ uunngåelig A _ 
geamus A: uklar A _ uklar A, disig A _ 
iešguđetlágan A: ulik A; forskjellig A _ forskjellige slags A _ 
sierranas A: forskjellig A _ atskilt A _ 
jođán A: rask A; snar A _ hurtig A, rask A _ 
johtil A: rask A; snar A _ hurtig A _ 
valli A: rask A _ hurtig A, rask A _ 
stánddalaš A: dyktig A; stødig A _ stødig A, dyktig A _ 
fávdnát A: dyktig A _ bra A, dyktig A _ 
geahnoheapme A: svak A _ udugelig A, svak A _ 
čuorbi A: svak A _ klønete A, udugelig A _ 
šiervi A: svak A _ spinkel A, svak A _ 
sealvi A: klar A _ klar A, normal A _ 
šearrat A: klar A _ blank A, klar A _ 
girkat A: klar A _ klar A, skinnende A _ 
oppa A: hel A _ hel A, all A _ 
duostil A: modig A _ dristig A _ 
gummá A: rar A _ rart A _ 
háhppil A: snar A _ kjapp A, snar A _ 
iešráđálaš A: selvstendig A; uavhengig A _ egenmektig A, selvstendig A _ 
jalgat A: jevn A _ slett A, jevn A _ 
lagas A: nær A _ nærliggende A, nær A _ 
ráinnas A: ren A _ rein A, ren A _ 
buhtis A: ren A _ rein A _ 
eallilan A: voksen A _ godt voksen A, som har levd en stund A _ 
stuorebuš A: stor A _ litt større A _ 
luohttevaš A: stødig A _ tillitsfull A _ 
vuoiggalaš A: rettferdig A _ redelig A _ 
vánhurskkis A: rettferdig A _ gudfryktig A; rettferdig A _ 
positiivvalaš A: positiv A; positiv A _ positiv A _ 
positiiva A: positiv A; positiv A _ positiv A _ 
negatiiva A: negativ A; negativ A _ negativ A _ 
dorvvuheapme A: usikker A _ motløs A _ 
nationála A: nasjonal A; nasjonal A _ nasjonal A _ 
maŋit A: sist A _ bakre A _ 
hillján A: sen A _ langsom A, makelig A _ 
áigeguovdil A: aktuell A _ tidsaktuell A _ 
guoskevaš A: aktuell A _ angående A _ 
oskkolaš A: religiøs A _ troende A _ 
duohta A: reell A _ sann A _ 
lihkoheapme A: uheldig A _ ulykkelig A _ 
dávggas A: fleksibel A _ elastisk A, spenstig A _ 
juohkelágan A: allsidig A _ allslags A _ 
dássásaš A: likeverdig A _ jevnbyrdig A; jevnhøy A _ 
bolffas A: frodig A _ lodden A _ 
