SME lemma pos: fad NOB lemma pos _ gt NOB lemma pos _ placeholder for action tag
rohkki N: avdød A _ avdød N _ 
čoahkkináigi N: møtesekvens N; møtetidspunkt N _ møtetid N _ 
njiŋŋálas N: hunnlaks N _ hunndyr N, av hunkjønn N _ 
šibitdállu N: gardsdrift N _ gårdsbruk med husdyr N _ 
prográmmafálaldat N: programtjeneste N; programtilbud N _ programtilbud N _ 
oahpahusguovddáš N: utdanningsenhet N; utdanningssentral N; utdanningssentrum N; utdanningssenter N _ undervisningssenter N _ 
mánáidgárdeláhka N: barnehagetjeneste N; barnehagelov N _ barnehagelov N _ 
beaivedikšu N: omsorgsdøgn N _ dagpleie N _ 
badjemánná N: reindriftsunge N; flyttsamebarn N; reindriftsbarn N _ reindriftsbarn N _ 
telefonoktavuohta N: telefonforbindelse N; telefonkontakt N _ telefontilknytning N _ 
máksinnákca N: betalingsevne N; likviditetsforvaltning N; likviditet N _ likviditet N _ 
johtolatplána N: jernbanebevilgning N _ trafikkplan N _ 
dáiddaoahppu N: kunstutdannelse N; kunstutdanning N _ kunstutdanning N _ 
duodječájáhus N: sløydutstilling N _ duodjiutstilling N _ 
festiváladoarjja N: festivaltilskudd N; festivalstøtte N _ festivalstønad N _ 
diibmu N: lønnsslipp N; time N _ time N; ur N, klokke N _ 
njealjejuvllat N: terrengsykkel N; firhjuling N _ firehjulssykkel N _ 
oalgecealkka N: leddsetning N _ bisetning N _ 
lotnolasealáhus N: næringskombinasjonsavtale N; næringskombinasjon N _ næringskombinasjon N _ 
boazu N: miniatyrrein N; reinsdyr N; rein N _ rein N, reinsdyr N _ 
oljoopmodat N: oljeformue N _ oljeressurser N _ 
prinsihppadigaštallan N: prinsippdiskusjon N _ prinsippdebatt N _ 
gihpa N: studiehefte N; brosjyre N; hefte N _ hefte N _ 
luonddunamahus N: naturbetegnelse N _ naturbenevnelse N _ 
fuolkevuođanamahus N: slektskapsbenevnelse N _ slektsskapsbenevnelse N _ 
rámmajuolludeapmi N: rammetilskudd N; rammeoverføring N _ rammebevilgning N _ 
rámmadoarjja N: rammetilskudd N _ rammestøtte N _ 
jienastuslohku N: samemanntall N; manntall N; valgmanntall N _ manntall N, valgmanntall N _ 
válljenmunni N: valgmulighet N; utvalg N _ utvalg N _ 
oahpposadji N: læreplass N; studieplass N; plass N _ studieplass N _ 
riikkasearvi N: landsforbund N; riksforbund N _ landsforening N _ 
giellabeassi N: språkleir N; språkreir N _ språkreir N _ 
ovddasvástádussuorgi N: ansvarsområde N _ ansvarsfelt N _ 
kulturlávdegoddi N: kulturkomite N _ kulturkomité N _ 
servodatsuorgi N: samfunnsområde N; samfunnssektor N _ samfunnssektor N _ 
iskkus N: prøveuttak N; prøve N; undersøkelse N _ prøve N _ 
válgalávdegoddi N: valgkomite N _ valgkomité N _ 
bargomátki N: tjenestereise N _ arbeidsreise N _ 
doarjja N: støttespiller N; tilskudd N; bidrag N; støtte N; støtte N _ stønad N; støtte N _ 
dáiddaguovddáš N: kunstnersenter N _ kunstsenter N _ 
badjesápmelaš N: reindriftsame N; reindriftssame N _ reindriftssame N _ 
boazosápmelaš N: reindriftsame N; reindriftssame N _ reindriftssame N _ 
ealáhuslávdegoddi N: næringskomite N; næringskomité N _ næringsutvalg N, næringskomité N _ 
guovllukantuvra N: regionkontor N; områdekontor N; underkontor N; distriktskontor N _ distriktskontor N, regionskontor N _ 
rápmaeaktu N: rammevilkår N; rammebetingelse N _ rammebetingelse N _ 
rámmaeaktu N: rammevilkår N; rammebetingelse N _ rammebetingelse N _ 
ovttasbargoguoibmi N: samarbeidspart N; samarbeidspartner N _ samarbeidspartner N _ 
prošeaktadoarjja N: prosjektstøtte N _ prosjektstønad N _ 
ássanguovlu N: bosettingsområde N; bosetningsområde N _ bosetningsområde N _ 
oktasaščoavddus N: pakkeløsning N; fellesløsning N _ fellesløsning N _ 
biebmoávnnas N: næringsstoff N; næringsmiddel N _ næringsmiddel N _ 
bivdokultuvra N: fangstkultur N _ jaktkultur N _ 
veahkaváldi N: voldsutøver N; makt N; vold N; overgrep N _ vold N, makt N, overgrep N _ 
gámasuoidni N: sennagress N; sennegras N _ sennegress N _ 
valáštallansuorgi N: idrettsgren N; idrettsområde N _ idrettsgrein N _ 
bearjjas N: vindskjul N _ røykskjerm N _ 
kulturdeaivvadeapmi N: kulturmøte N _ kulturtreff N _ 
gávpotstivra N: bystyregruppe N; bystyre N _ bystyre N _ 
fápmodilli N: maktstilling N; kraftsituasjon N _ styrkeforhold N _ 
leansmánnibálvá N: lensmannsfullmektig N _ lensmannsbetjent N _ 
govvačájáhus N: bildeutstilling N _ billedutstilling N _ 
boazodávda N: reinsjukdom N; reinsykdom N _ reinsykdom N _ 
jugešvuohta N: misbruksproblem N; alkoholmisbruk N _ drukkenskap N _ 
investerendoarjja N: investeringstilskudd N; investeringsstøtte N _ investeringsstønad N _ 
matematihkkagirji N: matematikkverk N _ matematikkbok N _ 
álgoálbmotguovlu N: urfolksregion N; urfolksområde N _ urbefolkningsområde N _ 
vealaheapmi N: forskjellsbehandling N; diskriminering N _ diskriminering N _ 
deaivvadanbáiki N: møtested N; møteplass N _ treffsted N _ 
stáhtadoarjja N: statstilskudd N _ statsstøtte N _ 
buvttadandoarjja N: produksjonstilskudd N; produksjonsstøtte N _ produksjonsstøtte N _ 
bargovuohki N: arbeidsform N; arbeidsmåte N; arbeidsmetode N; prosedyre N _ arbeidsmetode N; prosedyre N _ 
lassiealáhus N: tilleggsnæring N _ attåtnæring N, bierverv N _ 
orohatjuohkin N: distriktsinndeling N _ reinbeitedistriktsinndeling N _ 
gáicadoallu N: geitbruk N; geitehold N _ geitebruk N _ 
lohkkiidčálus N: leserinnlegg N _ leserbrev N _ 
prográmmadoaibma N: programaktivitet N; programvirksomhet N _ programvirksomhet N _ 
oamastanvuoigatvuohta N: eierrettighet N; eiendomsrett N _ eiendomsrett N _ 
bealdu N: jordbearbeiding N; innmark N _ åker N _ 
kulturdoarjja N: kulturstøtte N _ kulturstønad N _ 
gássabohkan N: gassutvinning N _ gassboring N _ 
oahpahusministtar N: utdanningsminister N _ undervisningsminister N _ 
ovddidandoarjja N: utviklingstilskudd N _ utviklingsstønad N _ 
oahpahuspolitihkka N: opplæringspolitikk N; utdanningspolitikk N _ utdanningspolitikk N _ 
eamiálbmotguovlu N: urfolksområde N _ urbefolkningsområde N _ 
dárkkistanlávdegoddi N: revisjonsutvalg N; kontrollkomité N _ kontrollkomité N _ 
nákkosgirji N: doktorgradsavhandling N; doktoravhandling N _ doktoravhandling N _ 
giellaváttisvuohta N: språkvanske N; språkproblem N _ språkproblem N _ 
boazodoallošiehtadallan N: reindriftsavtaleforhandling N; reindriftsforhandling N _ reindriftsforhandling N _ 
lohkanmearri N: pensumlitteratur N; pensum N _ pensum N _ 
bivdoguovlu N: fiskeområde N _ fangstområde N _ 
niitu N: utmarksslått N _ natureng N _ 
buohccedivššár N: sykesøster N; sykepleier N _ sykepleier N _ 
jienastanvuohki N: avstemningsmåte N _ voteringsprosedyre N _ 
doarjjaortnet N: tilskuddsordning N; støtteordning N _ støtteordning N _ 
giehtaduodji N: håndverksprodukt N; håndarbeid N; håndverk N _ håndarbeid N _ 
mánáidgárdefálaldat N: barnehagedekning N; barnehagetilbud N _ barnehagetilbud N _ 
oahppodilli N: undervisningssituasjon N; opplæringssituasjon N _ læresituasjon N _ 
sátnegeavaheapmi N: begrepsbruk N _ ordbruk N _ 
birasgáhttenossodat N: miljøvernavdeling N _ miljøvernenhet N _ 
konvoluhtta N: omslagskonvolutt N; konvolutt N _ konvolutt N _ 
ovdanamma N: personnavn N; fornavn N _ fornavn N _ 
álgoálbmotguovddáš N: urfolksenter N; urfolkssenter N _ urfolkssenter N _ 
čearda N: stammefolk N; art N _ art N _ 
oahppofálaldat N: opplæringstilbud N; studietilbud N; utdanningstilbud N; undervisningstilbud N _ undervisningstilbud N _ 
oktasašskuvla N: fellesskole N; enhetsskole N _ enhetsskole N _ 
válgavuohki N: valgordning N _ valgprosedyre N _ 
kulturviessu N: kulturbygg N; kulturhus N _ kulturhus N _ 
bággonjuovvan N: tvangsslakting N _ tvangsslaktning N _ 
giellaruhta N: språkmiddel N _ språkpenger N _ 
eamiálbmotvuoigatvuohta N: urfolksrettighet N _ urbefolkningsrettighet N _ 
álgoálbmotvuoigatvuohta N: urfolksrettighet N _ urbefolkningsrettighet N _ 
boazodoallohálddahus N: reindriftsforvaltning N _ reindriftsadministrasjon N _ 
oahppolávdegoddi N: utdanningskomite N _ studieutvalg N _ 
eamiálbmot N: urfolk N _ urbefolkning N _ 
álgoálbmot N: urfolk N _ urbefolkning N _ 
bargoeaktu N: arbeidsvilkår N _ arbeidsbetingelse N _ 
oahpahusdepartemeanta N: undervisningsdepartement N _ utdanningsdepartement N _ 
muohtačalbmi N: snøkrystall N _ snøfnugg N _ 
turistabáiki N: turistattraksjon N _ turiststed N _ 
datneárpu N: metalltråd N _ tinntråd N _ 
riikkarádji N: landegrense N _ riksgrense N _ 
njuovvanboazu N: slaktedyr N; slakt N _ slakterein N _ 
skuvlavisti N: skolehus N; skolebygg N; skolebygning N _ skolebygning N _ 
skuvlamátki N: skoleveg N; skoletur N _ skoletur N _ 
dálkkas N: medikament N; legemiddel N; medisin N _ medisin N _ 
bealljelasta N: øreflipp N _ det ytre øre N _ 
juovlanigá N: nisse N; julenisse N _ julenisse N _ 
báikkálašsearvi N: lokallag N; lokalforening N _ lokalforening N _ 
garraduodji N: trearbeid N; tresløyd N _ sløyd N _ 
lihkusávaldat N: gratulasjon N _ lykkeønskning N _ 
láhttenvuohki N: handlemåte N; adferd N _ oppførsel N _ 
riikkačoahkkin N: riksmøte N; landsmøte N _ landsmøte N _ 
čuohtejahki N: hundreår N; århundre N _ århundre N _ 
fágaolmmoš N: fagfolk N _ fagperson N _ 
luonddugáhtten N: naturvern N; miljøvern N _ miljøvern N _ 
politiijabálvá N: politimann N _ politibetjent N _ 
dutkkus N: studie N; eksamen N _ eksamen N _ 
niesti N: skolemat N _ niste N _ 
guohtuneana N: beiteområde N _ beiteland N, beiteareal N _ 
ámmát N: verv N; embete N; stilling N _ embete N, stilling N _ 
bargodilli N: arbeidssituasjon N; arbeidsliv N; arbeidsforhold N _ arbeidsforhold N _ 
spiidni N: purk N; gris N; svin N _ gris N, svin N _ 
viellja N: storebror N; søsken N _ bror N _ 
moarri N: affekt N _ vrede N, raseri N _ 
njálggis N: godteri N _ slikkeri N _ 
čoalli N: innvoll N; tarm N _ tarm N; lengden på garnets øverste del N _ 
sáttu N: singel N; sand N _ sand N _ 
unnimusmearri N: minimumsfaktor N; minstestandard N _ minimum N; minstestandard N _ 
biergobihttá N: kjøttbit N; kjøttstykke N _ kjøttstykke N _ 
dákti N: knokkel N; bein N _ bein N _ 
šlápma N: ståhei N; støy N _ støy N, larm N _ 
bátni N: tannsett N; tann N _ tann N _ 
ođđabeairuohtta N: nyttårskveld N _ nyttårsaften N _ 
vađđa N: sletteland N; slette N _ åpen slette med skog rundt N _ 
máttaráddjá N: tippoldefar N _ oldefar N, stamfar N _ 
jumeš N: tvillingpar N; tvilling N _ tvilling N _ 
lubma N: lom N _ lomme N _ 
hearva N: pryd N _ stas N, pynt N _ 
biebmodilli N: ernæringssituasjon N; matsituasjon N; kosthold N _ matsituasjon N _ 
lavdnjegoahti N: jordgamme N; torvgamme N _ torvgamme N _ 
lávka N: ryggsekk N _ ransel N; bag N _ 
sieđga N: vier N _ vidje N _ 
boradanboddu N: matpause N _ spisepause N _ 
boaresbárdni N: ungkar N _ gammelungkar N _ 
náhkkebivttas N: pels N _ skinnplagg N _ 
galmmihanrusttet N: fryseanlegg N _ kjøleanlegg N _ 
bárehuoš N: guttunge N _ halvvoksen gutt N _ 
visti N: paviljong N; hus N; bygning N _ hus N, bygning N _ 
soggi N: ytterkant N _ plass innerst ved veggen N _ 
mearrajohtolat N: skipsfart N; sjøfart N; sjøtransport N _ sjøtrafikk N _ 
vázzinsoabbi N: spaserstokk N _ gåstav N _ 
váikkuheapmi N: medvirkning N; påvirkning N; innflytelse N _ påvirkning N _ 
láhtti N: gulv N; golv N _ golv N _ 
inuihtta N: inuitt N _ inuit N _ 
lassá N: terskel N; dørstokk N _ dørstokk N; firkantet ramme av tre N _ 
uksabealis N: terskel N _ dørkarm N, plassen ved siden av døra N _ 
šielbmá N: terskel N; dørstokk N _ dørstokk N _ 
bealátkeahtesvuohta N: habilitet N _ ugildhet N _ 
hehttehus N: hinder N; ulempe N; hindring N _ hindring N _ 
gonagas N: kong N _ konge N _ 
geinnodat N: trase N _ flyttevei N _ 
šillju N: tun N; plass N _ gårdsplass N; plass N _ 
oalgi N: nisje N _ skulder N _ 
feaskkir N: korridor N; gang N _ bislag N, entre N, gang N _ 
vuoibmi N: kondisjon N; makt N; styrke N _ styrke N, makt N _ 
hivvodat N: volum N; masse N _ mengde N, masse N _ 
opmodatvearru N: formuesskatt N; formueskatt N _ formueskatt N _ 
dearvvuohta N: hilsen N _ hilsning N _ 
materiála N: materiell N; materiale N _ materiale N _ 
ruonas N: grønt N _ grønnsak N _ 
caggi N: barriere N; bærebjelke N; støtte N _ støtte N, avstiver N _ 
bagadeapmi N: instruksjon N; veiledning N _ rettledning N _ 
ávvu N: jubileum N; begeistring N _ fryd N _ 
suohkanbáhppa N: sogneprest N; sokneprest N _ sokneprest N _ 
almmuheapmi N: utgivelse N _ offentliggjøring N _ 
beavdeliidni N: duk N _ bordduk N _ 
suhttu N: aggresjon N; sinne N _ sinne N _ 
veajet N: yngel N _ fiskeyngel N _ 
stohpogálvu N: innbo N; inventar N; møbel N _ møbel N _ 
soadji N: ving N _ vinge N; erme N; fløy N _ 
oktavuohta N: samhold N; forbindelse N; fellesskap N; tilknytning N _ forbindelse N, kontakt N _ 
eallineaktu N: livsvilkår N; levevilkår N; levekår N _ levevilkår N _ 
ođđajahki N: nyår N _ nyttår N _ 
bázahus N: avfall N; rest N; levning N; slam N _ rest N _ 
guhkkodat N: lengde N _ utstrekning N _ 
oaivvuš N: utløp N _ elveos N, elveutløp N _ 
duođalašvuohta N: virkelighet N; alvor N _ alvorlighet N _ 
finnmárkulaš N: finnmarking N _ finnmarksværing N _ 
huksen N: utbygging N; bygg N; bygging N _ bygging N _ 
čilgehus N: redegjørelse N; definisjon N _ forklaring N _ 
dihtor N: pc N; data N; datamaskin N _ datamaskin N, computer N _ 
beaggin N: omdømme N _ rykte N _ 
áigemearri N: frist N _ tidsfrist N _ 
dieđihanáigemearri N: frist N; påmeldingsfrist N _ påmeldingsfrist N _ 
duktásadji N: tuft N; hustuft N _ hustuft N; tomt N _ 
márkanbáiki N: markedsplass N; kirkested N _ kirkested N _ 
fidnodoaibma N: yrkesaktivitet N _ yrkesforetak N _ 
mearreáigi N: åremål N _ termin N _ 
meardi N: merd N _ ruse N _ 
láse N: glas N; vindu N; glass N _ glass N, vindusrute N _ 
oaivámuš N: høvding N _ overhode N _ 
giliviessu N: grendehus N _ bygdehus N _ 
herven N: dekorasjon N; ornamentikk N _ ornamentikk N _ 
neahpi N: nevø N _ onkelbarn N; manns nevø eller niese N _ 
gárvu N: klær N _ klesplagg N _ 
bivttas N: klær N _ klesplagg N _ 
oktiigullevašvuohta N: solidaritet N; samhørighet N _ tilhørighet N _ 
ovttaseallin N: sameksistens N; samliv N _ samliv N _ 
einnostus N: preg N; spådom N; prognose N _ spådom N; prognose N _ 
gollu N: bekostning N; kostnad N; slitasje N; utgift N _ kostnad N; slitasje N _ 
stašuvdna N: base N _ stasjon N _ 
jeagil N: lav N _ reinlav N _ 
gorži N: vannfall N; foss N _ foss N _ 
čálgu N: velvære N; trivsel N; velferd N _ trivsel N; velferd N _ 
siepman N: spir N; sæd N _ frø N, sæd N _ 
prentehus N: trykkeri N; trykking N; opplag N _ trykking N _ 
váldolávdegoddi N: hovedutvalg N _ hovedkomité N _ 
boallu N: tast N _ knapp N _ 
noaidi N: noaide N _ sjaman N _ 
válla N: vald N; skrål N _ bråk N, skrål N _ 
báikegoddi N: lokalsamfunn N _ grend N; landdistrikt N _ 
ráŋggáštus N: sanksjon N; straff N _ straff N _ 
álbmotallaskuvla N: folkehøyskole N _ folkehøgskole N _ 
nammačuorvun N: opprop N; navneopprop N _ navneopprop N _ 
čikŋa N: dekor N _ pynt N, stas N _ 
gávpegálvu N: konsern N _ handelsvare N _ 
mánná N: småbarn N; barn N _ barn N _ 
lastamuorra N: lauvskog N _ løvtre N _ 
šibitdoavttir N: veterinær N; dyrlege N _ dyrlege N _ 
diggeriekti N: tingsrett N; tingrett N _ tingrett N _ 
sátnevájas N: ordspråk N; ordtak N _ ordtak N _ 
earru N: skille N; skilsmisse N; avskjed N _ avskjed N; skilsmisse N _ 
gihppu N: sett N _ bunt N, klase N _ 
ládju N: slått N; høyslått N _ slåttonn N _ 
fággi N: ankerfeste N _ ryggtak N _ 
fális N: hval N _ kval N _ 
kruvdno N: kr. N; krone N _ krone N _ 
dávvirvuorká N: musé N; museum N _ museum N; lager N, oppbevaringssted N _ 
musea N: musé N; museum N _ museum N _ 
johtolat N: ferdsel N; trafikk N _ flyttevei N; trafikk N _ 
vuodjin N: ferdsel N; kjøring N _ kjøring N _ 
buhtadus N: kompensasjon N; godtgjørelse N; erstatning N _ erstatning N _ 
mátki N: reis N; reise N _ reise N _ 
snihkkár N: håndverker N; snekker N _ snekker N _ 
rihtu N: ras N; storm N _ skred N _ 
uđas N: ras N _ snøskred N _ 
kilomehter N: km N; kilometer N _ kilometer N _ 
guovddáš N: sentral N; senter N _ sentrum N, senter N _ 
rievssatbivdu N: rypefangst N _ rypejakt N _ 
riegádanbeaivi N: fødselsdato N; fødselsdag N _ fødselsdag N _ 
servodatoahppu N: samfunnskunnskap N; samfunnsfag N _ samfunnsfag N _ 
mánnabiigá N: barnepass N _ barnevakt N _ 
dáhpi N: sedvane N _ skikk N _ 
vierru N: sedvane N; rutine N _ skikk N, vane N; rutine N _ 
ovttaskasolmmoš N: enkeltperson N; enkeltmenneske N _ enkeltmenneske N _ 
eaŋkilolmmoš N: enkeltperson N; enkeltmenneske N _ enkeltmenneske N _ 
čállinvuohki N: ortografi N; skrivemåte N _ skrivemåte N _ 
mearrabivdu N: sjøfiske N; fiske N _ fiske N _ 
fievru N: transportmiddel N; framkomstmiddel N; kjøretøy N _ framkomstmiddel N _ 
erenoamášvuohta N: spesialitet N; særpreg N _ eiendommelighet N; særpreg N _ 
ruhtadeapmi N: finans N _ finansiering N _ 
muorra N: trevirke N; brensel N; tre N _ tre N; ved N _ 
davvisámegiella N: nordsamisk N _ nordsamisk A _ 
dokumentára N: dokumentarfilm N; dokumentar N _ dokumentar N _ 
areálageavaheapmi N: arealbruk N _ arealdisponering N _ 
bargoveahka N: stab N; personell N _ arbeidsstyrke N _ 
bánno N: kjele N; kjel N _ steikepanne N _ 
teáhterčájálmas N: teaterstykke N; teaterforestilling N _ teaterforestilling N _ 
fágadoaba N: faguttrykk N; fagterm N _ fagterm N _ 
háhkan N: anskaffelse N; rekruttering N _ erverv N; rekruttering N _ 
muorraduodji N: tresløyd N _ sløyd N _ 
dállu N: småbruk N; gård N; hus N _ gård N; hus N _ 
goikket N: skalle N _ skalle sydd av leggskinn N _ 
nuvttot N: skalle N _ skalle sydd av leggskinn N _ 
finánsalávdegoddi N: finanskomité N _ finansutvalg N _ 
rehkenastin N: oppgjør N; beregning N; regning N _ det å regne sammen N _ 
geatnegasvuohta N: forpliktelse N; plikt N; ansvar N _ plikt N; ansvar N _ 
allaskuvlaoahppu N: høyskoleutdanning N; høgskoleutdanning N _ høgskoleutdanning N _ 
oljobohkan N: oljeproduksjon N; oljevirksomhet N; oljeutvinning N _ oljeboring N _ 
válgaboađus N: valgoppgjør N; valgresultat N _ valgresultat N _ 
vuođđooahppu N: grunnopplæring N; grunnutdanning N _ grunnutdanning N _ 
astoáiggedoaibma N: fritidsinteresse N; fritidsaktivitet N _ hobby N, fritidssyssel N _ 
giellaoahpahus N: språkopplæring N _ språkundervisning N _ 
hárjehallan N: øving N; øvelse N; prøve N; trening N _ trening N; prøve N _ 
fidnooahppu N: yrkesutdanning N; yrkesopplæring N _ yrkesopplæring N _ 
gaskaoapmi N: virkemiddel N; middel N; redskap N; verktøy N _ middel N _ 
joatkka N: videreføring N _ forlenger N _ 
njuikun N: vevgrind N _ hopping N; grindvev N _ 
árvolassáneapmi N: verdiskapning N; verdiskaping N _ verdiskaping N _ 
árvu N: verdighet N; status N; verdi N _ verdi N, verd N; status N _ 
buresbirgejupmi N: velstand N; velferd N _ velferd N _ 
geaidnočuovga N: vegbelysning N _ gatelys N _ 
gáivo N: vannbrønn N; brønn N _ brønn N _ 
dorvvuhisvuohta N: utrygghet N _ motløshet N _ 
eretfárren N: utflytting N; fraflytting N _ fraflytting N _ 
stuibmi N: urolighet N; opprør N _ bråk N; opprør N _ 
bargonávccahisvuohta N: uførhet N _ arbeidsuførhet N _ 
unohasvuohta N: ubehag N _ ubehagelighet N _ 
hirsa N: tømmer N _ tømmerstokk N _ 
dimbbar N: tømmer N _ tømmerstokk N _ 
čulku N: tvangstrøye N _ kubbe N _ 
bárru N: tsunami N; bølge N _ bølge N _ 
smáhkkomuorra N: trestamme N _ hoggestabbe N _ 
guovttegielalašvuođaruhta N: tospråklighetsmiddel N _ tospråklighetspenger N _ 
lohpádus N: tilsagn N _ løfte N _ 
heiveheapmi N: tilrettelegging N; tilpasning N _ tilpassing N _ 
leahttu N: tempo N _ fart N _ 
leaktu N: tempo N _ fart N, hastighet N _ 
govvaráidu N: tegnefilm N; tegneserie N _ tegneserie N _ 
duostilvuohta N: tapperhet N; mot N _ mot N _ 
báhčinguovlu N: skytefelt N _ skyteområde N _ 
báhčinšillju N: skytefelt N _ skytebane N _ 
huikkas N: skrik N; skrål N _ vedvarende roping N _ 
earráneapmi N: skillsmisse N; skilsmisse N _ skilsmisse N _ 
vearrogeasus N: skattefradrag N; skattetrekk N _ skattetrekk N _ 
vuotta N: skallebånd N; komagbånd N _ komagbånd N _ 
iešgovva N: sjølbilde N; selvbilde N _ selvbilde N _ 
iešstivrejupmi N: selvstyre N; autonomi N _ autonomi N _ 
iešdieđáhus N: selvangivelse N; egenerklæring N _ egenmelding N _ 
oktiibidjan N: sammensetning N _ sammenføyning N _ 
áššesuorgi N: saksområde N; saksfelt N _ saksområde N _ 
boraspirevahát N: rovvilttap N; rovdyrskade N _ rovdyrskade N _ 
riektedilli N: rettsforhold N; rettsstilling N _ rettsstilling N, rettslig stilling N _ 
vuorru N: rekkjefølgje N; omgang N; rekkefølge N _ tur N, omgang N; skift N _ 
mátkeealáhus N: reiseliv N; turistnæring N _ turistnæring N _ 
geahpádus N: reduksjon N; lettelse N _ lettelse N, minskning N _ 
rehálašvuohta N: redelighet N _ redelighet N, ærlighet N _ 
nállevealaheapmi N: rasediskriminering N; rasisme N _ rasisme N _ 
cuiggodeapmi N: påpekning N; merknad N; kritikk N _ påpeking N, kritikk N _ 
muittuhus N: påminnelse N _ påminning N _ 
áŋgirvuohta N: pågangsmot N; innsatsvilje N; iver N; motivasjon N _ iver N _ 
hearvabáddi N: pyntebånd N; pynteband N _ pynteband N _ 
uvssot N: portal N _ teltdør N _ 
máŋggaidlohku N: pluralitet N; pluralis N; flertall N _ flertall N, pluralis N _ 
čuokkis N: pkt. N; punkt N _ prikk N, punkt N, punktum N; poeng N _ 
geađgejuolgi N: pilar N; plattform N _ grunnmur N _ 
searvevuohta N: partnerskap N; fellesskap N _ fellesskap N _ 
bealli N: part N; del N _ del N, halvpart N _ 
oasálaš N: part N; aktør N; deltaker N _ medvirkende N, partisipant N, deltaker N; deleier N _ 
geahčastat N: oversikt N _ blikk N, øyekast N _ 
sátneriggodat N: ordrikdom N; ordforråd N _ ordforråd N _ 
lášmmohallan N: opptrening N; kroppsøving N; kroppsøvning N; gymnastikk N _ gymnastikk N _ 
lohkan N: opptelling N; lesing N _ lesing N _ 
bargojuohku N: oppgavefordeling N; arbeidsdeling N _ arbeidsdeling N _ 
bargojuogadeapmi N: oppgavefordeling N _ arbeidsfordeling N _ 
heahtedilli N: nødsituasjon N; krise N _ krise N, nødssituasjon N _ 
váimmus N: nav N; kjerne N _ marg i tre N; kjerne N _ 
moalla N: målstrek N; mål N _ mål N, blink N _ 
njálbmi N: munning N _ munn N _ 
multimedia N: multimedium N _ multimedia N _ 
balaheapmi N: mistenksomhet N _ sjalusi N _ 
muitoboddu N: minnemarkering N; minnestund N _ minnestund N _ 
meassut N: messe N _ festlighet N _ 
dieđihangaskaoapmi N: medium N _ media N _ 
biebmogálvu N: matprodukt N; matvare N; næringsmiddel N _ næringsmiddel N _ 
biebmogoallus N: matkjede N; næringskjede N _ næringskjede N _ 
lastagoahti N: løvhytte N _ løvløe N _ 
oahppaplána N: læreplan N _ læreplanverk N _ 
oahppoplána N: læreplan N; studieplan N; læreplanverk N _ studieplan N _ 
geahpesdávda N: lungelidelse N; kols N _ lungesykdom N _ 
ovttadássásašvuohta N: likeverdighet N; likeverd N; likestilling N _ likestilling N _ 
dásseárvu N: likeverd N; likestilling N _ likestilling N _ 
fuollameahttunvuohta N: likegyldighet N _ grov uaktsomhet N _ 
leaksoveahkki N: leksehjelper N; leksehjelp N _ leksehjelp N _ 
láigošiehtadus N: leieavtale N; festekontrakt N _ leiekontrakt N; festekontrakt N _ 
láigosoahpamuš N: leieavtale N _ leiekontrakt N _ 
bargguhisvuohta N: ledighet N; arbeidsledighet N _ arbeidsløshet N _ 
čoarvegiella N: lassoløkke N _ lassoring av horn N, hornøgle N _ 
riikkadássi N: landsbasis N _ riksplan N _ 
earri N: kvote N _ mengde N _ 
bivdoearri N: kvote N _ jaktkvote N _ 
almmuhus N: kunngjøring N; deklarasjon N _ annonse N; deklarasjon N _ 
kulturbargu N: kulturutøvelse N; kulturarbeid N _ kulturarbeid N _ 
kulturdoaibma N: kulturtiltak N _ kulturaktivitet N _ 
kulturruhta N: kulturmiddel N _ kulturpenger N _ 
gáranasruitu N: kråkebolle N _ sjøpinnsvin N, sjøpinnsvin N _ 
allodat N: kroppshøyde N; høyde N _ høyde N _ 
fápmojođas N: kraftledning N _ strømledning N _ 
ruvdna N: kr N; krone N _ krone N _ 
ruvdno N: kr N; krone N _ krone N _ 
kruvdnu N: kr N; krone N _ krone N _ 
gáma N: kommag N; sko N _ fottøy N; komag N, skalle N _ 
lávdegoddi N: komite N; utvalg N _ komité N, utvalg N; nemnd N _ 
komitea N: komite N _ komité N _ 
gáktegoarrun N: koftesying N; koftesøm N _ koftesøm N _ 
juotna N: knep N _ list N, intrige N; disposisjon N _ 
eanaspábba N: klode N; jordklode N; jord N _ jordklode N _ 
biergobuvttadeapmi N: kjøttavkastning N; kjøttproduksjon N _ kjøttproduksjon N _ 
guoddalus N: kjæremål N; anmeldelse N _ anklage N, anmeldelse N _ 
miessemearkun N: kalvemerking N _ reinkalvmerking N _ 
giehtaváđđu N: juksamaskin N _ jukse N _ 
bargovejolašvuohta N: jobbmulighet N; arbeidsmulighet N _ arbeidsmulighet N _ 
fuolaheapmi N: ivaretakelse N; omsorg N _ omsorg N _ 
badjelgeahččanvuohta N: intoleranse N _ overlegenhet N _ 
jierbmi N: intelligens N; hjerne N _ forstand N, fornuft N _ 
čuojanas N: instrument N _ musikkinstrument N _ 
bagadus N: instruks N; veiledning N _ rettledning N _ 
vuosteháhku N: innvending N; motstand N _ motstand N _ 
cealkámuš N: innspill N; resolusjon N; utsagn N; uttalelse N _ uttalelse N; resolusjon N _ 
hutkkus N: innovasjon N _ påfunn N _ 
sáivaguolásteapmi N: innlandsfiske N; ferskvannsfiske N _ ferskvannsfiske N _ 
sáivaguolli N: innlandsfisk N; ferskvannsfisk N _ ferskvannsfisk N _ 
oastinšiehtadus N: innkjøpsavtale N; kjøpekontrakt N _ kjøpekontrakt N _ 
gohččun N: innkalling N; kommando N; pålegg N _ innkallelse N; reskript N _ 
gulaskuddan N: høring N _ forespørsel N _ 
guolga N: hårlag N _ pelshår N; kroppshår N _ 
siibma N: håndsnøre N _ fortom N _ 
ruovttudoallu N: husholdning N; heimkunnskap N _ heimkunnskap N _ 
dállodoallu N: hushold N; gårdsbruk N; husstand N _ husstand N _ 
šibitdoallu N: husdyrhold N _ storfehold N _ 
váldodoaibma N: hovedfunksjon N; hovedoppgave N _ hovedbeskjeftigelse N _ 
váldocealkka N: hovedbudskap N; helsetning N _ hovedsetning N _ 
čoarbbealli N: hoft N; lår N _ lår N, hofte N _ 
ruovttubargu N: hjemmelekse N _ hjemmearbeid N _ 
aisttonmearka N: hermetegn N _ anførselstegn N _ 
ruovttudoallooahppu N: heimstadlære N; heimkunnskap N _ heimkunnskap N _ 
eanahálddašeapmi N: grunnforvaltning N _ jordforvaltning N _ 
šibitbiebmu N: fôr N; dyrefor N _ dyrefor N _ 
ovttastupmi N: fusjon N _ sammenslutning N; koalisjon N _ 
astoáiggeortnet N: fritidsordning N _ skolefritidsordning N _ 
ráfáiduhttinmearrádus N: fredningsvedtak N; fredningsbestemmelse N _ fredningsbestemmelse N _ 
govva N: foto N; bilde N; fotografi N _ bilde N _ 
ovdakantuvra N: forværelse N _ forkontor N _ 
ovdamunni N: fortrinn N; fordel N; privilegium N _ fordel N; privilegium N _ 
dáruiduhttinpolitihkka N: fornorskingspolitikk N; fornorskningspolitikk N _ fornorskningspolitikk N _ 
dáruiduhttin N: fornorsking N; fornorskning N _ fornorskning N _ 
dajaldat N: formulering N; setning N; uttrykk N _ setning N, uttrykk N _ 
soahpamuš N: forlik N; konvensjon N; kontrakt N; avtale N _ avtale N; kontrakt N _ 
ovdagihtiijienasteapmi N: forhåndsstemmegivning N; forhandsstemmegivning N _ forhåndsstemming N _ 
buorredáhttu N: forgodtbefinnende N; velvilje N _ velvilje N _ 
veadju N: forfatning N; kraft N; evne N _ kraft N; evne N _ 
sáhkku N: forelegg N _ mulkt N _ 
juohku N: fordeling N _ deling N _ 
cuvccas N: folkesagn N; myte N; eventyr N _ sagn N, eventyr N, myte N _ 
TV-prográmma N: fjernsynsprogram N; TV-program N _ TV-program N _ 
guollešládja N: fiskeslag N _ fiskeart N _ 
guolleearri N: fiskerikvote N; fiskekvote N _ fiskekvote N _ 
sámemiššuvdna N: finnemisjon N; samemisjon N _ samemisjon N _ 
sorbmi N: fare N; død N _ noe livsfarlig N; dødsulykke N _ 
várra N: fare N; risiko N _ forsiktighet N _ 
bivdoroggi N: fangstgrop N _ dyregrav N _ 
rehket N: faktura N; regning N _ regning N _ 
guite N: faktura N _ kvittering N _ 
árvvoštallan N: evaluering N; anmeldelse N; vurdering N; kritikk N _ anmeldelse N, kritikk N, vurdering N _ 
ovttaidlohku N: entall N _ entall N, singularis N _ 
vuorrádus N: engstelse N; uro N _ knipe N _ 
náitaleapmi N: ekteskapsinngåelse N _ giftemål N _ 
eallinvuođđu N: eksistensgrunnlag N; livsgrunnlag N _ livsgrunnlag N _ 
birgenláhki N: eksistensgrunnlag N; levekår N; livsgrunnlag N _ levekår N _ 
iešvuohta N: egenart N; egenskap N _ egenskap N _ 
duodjedoaibma N: duodjivirksomhet N; formingsaktivitet N _ formingsaktivitet N _ 
hádja N: duft N; lukt N _ lukt N _ 
readdju N: dress N; frakk N; jakke N _ jakke N, frakk N _ 
skearru N: diskos N; plate N _ rund skive N; grammofonplate N _ 
oalli N: dimensjon N _ djupål N; bakstykke N _ 
oassemáksu N: delutbetaling N _ avdrag N _ 
bursa N: børs N _ pengepung N _ 
čalbmeláset N: brille N _ briller N _ 
bielká N: bordtak N _ bjelke N _ 
govvadáidda N: billedkunst N _ bildekunst N _ 
báktedoaibma N: bergverksvirksomhet N; bergverk N _ bergverk N _ 
gálssot N: belling N _ vinterbelling N _ 
biddu N: belling N _ vinterbelling for kvinner N; leggvarmer N _ 
noađđi N: belastning N; byrde N _ bør N, byrde N _ 
ágga N: begrunnelse N; argument N; grunn N _ unnskyldning N; argument N _ 
buorádus N: bedring N; forbedring N _ forbedring N; omvendelse N _ 
vuojadanálddis N: basseng N _ svømmebasseng N _ 
jienastanortnet N: avstemmingsmåte N; avstemningsordning N _ voteringsrekkefølge N _ 
bargolohpi N: arbeidstilltalelse N; arbeidstillatelse N _ arbeidstillatelse N _ 
bargoráfi N: arbeidsro N _ arbeidsfred N _ 
bargodienas N: arbeidsinntekt N; arbeidsfortjeneste N _ arbeidsfortjeneste N _ 
áppes N: abc-bok N _ ABC-bok N _ 
bargoduogáš N: yrkeserfaring N; arbeidserfaring N; praksis N _ praksis N _ 
bargovásihus N: yrkeserfaring N; arbeidserfaring N _ arbeidserfaring N _ 
lullisápmi N: sørsameområde N; sørsame N _ sørsame N _ 
oppalašárvosátni N: standpunktvurdering N; standpunktkarakter N _ standpunktkarakter N _ 
gielladoaibma N: språktiltak N; språkarbeid N _ språkaktivitet N _ 
njuolggadus N: retningslinje N; regel N _ regel N _ 
boazodoallovuoigatvuohta N: reindriftsrett N; reindriftsrettighet N _ reindriftsrettighet N, rett til å utøve reindrift N _ 
ovdasiidogovva N: omslagsbilde N; forsidebilde N _ forsidebilde N _ 
heahteveahkki N: nødhjelp N; førstehjelp N _ førstehjelp N _ 
birasgáhttendepartemeanta N: miljøverndepartement N _ miljødepartement N _ 
eanavuovdinláhka N: jordslagslov N _ jordsalgslov N _ 
álgosátni N: innledning N; forord N _ forord N _ 
bálká N: honorar N; betaling N; lønn N _ betaling N _ 
ovdasátni N: føreord N; forord N _ forord N _ 
girdijohtolat N: flytrafikk N _ lufttrafikk N _ 
fágasuorgi N: fagområde N _ fagfelt N _ 
sohkardávda N: diabetes N _ sukkersyke N _ 
bázzi N: skulptur N; støtte N _ monument N, støtte N _ 
biire N: krets N; reinbeitedistrikt N _ reinbeitedistrikt N _ 
bierggas N: gjenstand N; ting N; sak N; utstyr N _ ting N, sak N; genitalia N _ 
dávvir N: gjenstand N; eiendel N; skatt N; verdi N; utstyr N _ eiendel N, skatt N, verdi N _ 
juhkamuš N: drikke N _ drikk N _ 
siskkoš N: innmat N _ det indre N _ 
galba N: skilt N _ nederste del av reinhorn N; skilt N; skjold N _ 
skuvlamánná N: elev N; skolebarn N _ skolebarn N _ 
návdi N: pelsdyr N; rovdyr N; ulv N _ rovdyr N; ulv N _ 
preterihtta N: fortid N _ preteritum N, fortid N _ 
suorgi N: sektor N; linje N; område N _ forgreining N, linje N; felt N _ 
mihtilmasvuohta N: særpreg N _ særegenhet N, særtrekk N _ 
dánsun N: dans N _ dansing N _ 
latiinnagiella N: latin N _ latinsk N _ 
njuorjju N: kobbe N; sel N _ sel N, kobbe N _ 
njuorju N: kobbe N; sel N _ sel N, kobbe N _ 
čoavddus N: fasit N; løsning N _ fasit N, løsning N _ 
badjeolmmoš N: flyttsame N; reindriftssame N; reineier N _ reindriftssame N _ 
hommá N: tiltak N _ tiltak N, gjøremål N _ 
doaibma N: tiltak N; drift N; funksjon N; virksomhet N; aktivitet N; oppgave N; handling N; oppdrag N _ virksomhet N, gjøremål N, aktivitet N; drift N; tiltak N _ 
olmmošlohku N: innbyggertall N; folketall N _ innbyggertall N _ 
váidalus N: klage N _ klage N, anklage N _ 
moaitámuš N: klage N; kritikk N _ bebreidelse N, klage N _ 
moaitta N: klage N; kritikk N _ klage N _ 
váidda N: klage N _ anklage N _ 
gávpi N: butikk N; salg N; handel N _ handel N; forretning N _ 
el-rávdnji N: elektrisitet N; strøm N _ elektrisitet N _ 
elrávdnji N: elektrisitet N; strøm N _ elektrisitet N, strøm N _ 
šleađga N: elektrisitet N; strøm N _ strøm N; elektrisitet N _ 
luonddugáhttensearvi N: naturvernforbund N _ miljøvernforening N _ 
boahttevuohta N: framtid N; fremtid N _ framtid N _ 
boahtteáigi N: framtid N; fremtid N _ fremtid N _ 
vihki N: sykdom N; feil N _ feil N; sykdom N _ 
jávohisvuohta N: stillhet N; taushet N _ taushet N _ 
jahkeduhát N: tusenår N _ årtusen N _ 
eananvuoigatvuohta N: landrettighet N _ jordrettighet N _ 
geavahanvuoigatvuohta N: bruksrettighet N; bruksrett N _ bruksrettighet N _ 
geavahanriekti N: bruksrettighet N; bruksrett N _ bruksrett N _ 
valáštallan N: idrett N _ sport N, idrett N _ 
lasáhus N: tillegg N; økning N _ tillegg N _ 
lassi N: tillegg N _ tillegg N; aksessorisk A _ 
oamastus N: eie N; eierskap N _ eie N _ 
johtu N: bevegelse N; gang N _ fart N, bevegelse N, gang N _ 
lihkadus N: bevegelse N _ rørelse N, åndelig bevegelse N _ 
máŋggabealatvuohta N: mangfoldighet N; mangfold N _ mangfoldighet N _ 
giitámuš N: takk N _ noe å takke for N _ 
gudneáŋgirvuohta N: ambisjon N _ ambisjon N, ærgjerrighet N _ 
almmolašvuođaláhka N: offentlighetslov N _ offentlighetsloven N _ 
aláš N: bakketopp N; høyde N _ høyde N, bakketopp N _ 
várrečohkka N: bakketopp N; fjelltopp N _ fjelltopp N _ 
arvedálki N: regn N _ regnvær N _ 
atnu N: bruk N; nytte N _ bruk N, nytte N _ 
geavahus N: bruk N; konsum N; praksis N _ bruk N; konsum N _ 
doallu N: bruk N; drift N; driftsenhet N _ driftsenhet N; drift N _ 
atnubierggas N: bruksting N _ bruksgjenstand N _ 
dušši N: skit N; tull N _ ingenting N, bagatell N _ 
bargohárjáneapmi N: arbeidserfaring N; erfaring N _ arbeidserfaring N _ 
bargovásáhus N: arbeidserfaring N; erfaring N _ arbeidserfaring N _ 
bargu N: arbeid N; oppgave N; oppdrag N _ arbeid N _ 
bassi N: helg N; helligdag N _ helligdag N; helg N _ 
oassi N: del N; utdrag N; passus N; andel N _ del N; passus N; akt N; lodd N _ 
gáhppálat N: del N; eksemplar N _ stykke N, del N _ 
oasáš N: del N _ liten del N _ 
veahka N: familie N; makt N; styrke N _ styrke N, makt N; mannskap N; familie N _ 
joavku N: familie N; husstand N; flokk N; gruppe N _ flokk N, gruppe N; lag N; husstand N _ 
fuolki N: familie N; slektning N _ slektning N _ 
beroštupmi N: interesse N; omsorg N; engasjement N _ omsorg N, interesse N; engasjement N _ 
bihttá N: lekse N; utdrag N; bit N _ stykke N, bit N; lekse N; utdrag N _ 
ruovttubihttá N: lekse N _ hjemmeoppgave N _ 
orohat N: reinbeitedistrikt N; distrikt N _ boplass N; oppholdssted N; reinbeitedistrikt N _ 
biras N: miljø N; omslag N _ miljø N, omgivelse N; del av mannslue N; kulisse N; omslag N _ 
bivdda N: anmodning N; bønn N _ bønn N; anmodning N _ 
ávžžuhus N: anmodning N; anbefaling N _ oppfordring N, anbefaling N _ 
bláđđi N: magasin N; blad N _ blad N, magasin N _ 
boaldámuš N: brensel N; drivstoff N _ brensel N; brennstoff N, drivstoff N _ 
čoahkkinortnet N: dagsorden N; forretningsorden N _ dagsorden N, forretningsorden N _ 
áššelistu N: dagsorden N; saksliste N _ saksliste N, dagsorden N, møtekart N _ 
bohcci N: rør N _ rør N, sugerør N; nålfutteral N _ 
náhkki N: skinn N _ skinn N, hud N _ 
sisti N: skinn N _ garvet skinn N _ 
buhtadas N: godtgjørelse N _ erstatning N, godtgjørelse N, vederlag N _ 
báhkka N: varme N _ varme N, hete N _ 
deaddu N: press N; vekt N _ tyngde N, vekt N; press N, trykk N _ 
deatta N: press N _ vekt N, trykk N, press N _ 
deappu N: tare N _ brunalge N, tare N _ 
tiida N: overtro N; forestilling N _ forestilling N, overtro N _ 
dikšu N: terapi N; behandling N _ pleie N; terapi N _ 
dilli N: forhold N; situasjon N _ forhold N, tilstand N _ 
dilálašvuohta N: forhold N; anledning N; situasjon N; omstendighet N _ anledning N; forhold N, tilstand N _ 
gaskavuohta N: forhold N; relasjon N _ forhold N, relasjon N _ 
gorri N: forhold N; relasjon N _ proporsjon N; relasjon N _ 
liiba N: anledning N _ sjanse N, høve N _ 
doahkki N: klump N _ klump N; fugleflokk N _ 
dávgi N: fjær N _ bue N; fjær N _ 
duođaštus N: attest N; dokumentasjon N; bekreftelse N _ bekreftelse N, bevitnelse N; attest N; bevis N, dokumentasjon N _ 
bargoduođaštus N: attest N _ arbeidsattest N _ 
dáhpáhus N: tilfelle N; hendelse N _ hendelse N _ 
dáhttu N: ønske N; vilje N _ ønske N, vilje N _ 
árji N: ønske N _ ønske N, trang N _ 
háliidus N: ønske N _ lengsel N, lyst N _ 
oapmi N: eiendel N; ting N _ eiendel N, ting N; kreatur N _ 
eallinvuohki N: levesett N; levemåte N; livsstil N _ levesett N, levemåte N, livsstil N _ 
ealáhus N: næringsvei N; næring N; næringsliv N _ næring N, næringsvei N _ 
eana N: land N; jord N; eiendom N _ jord N, jorde N; land N, mark N; eiendom N _ 
nannán N: land N; fastland N _ fastland N; kontinent N _ 
rávdnji N: strøm N; strøm N _ strøm N _ 
erohus N: forskjell N; avvik N _ forskjell N _ 
evttohas N: kandidat N _ kandidat N; kandidatur N _ 
árvalus N: forslag N; tanke N; innstilling N _ tanke N; forslag N _ 
eŋgelasgiella N: engelsk N _ engelsk språk N _ 
eaŋgalasgiella N: engelsk N _ engelsk språk N _ 
fidnu N: yrke N _ yrke N, beskjeftigelse N _ 
gárri N: fat N _ fat N; trau N _ 
lihtti N: fat N; kar N _ kjørel N, kar N, kopper N _ 
fárru N: følge N; reisefølge N _ følge N, reisefølge N _ 
čuovus N: følge N; følgeskriv N; konsekvens N _ følgeskriv N; følge N _ 
garra N: skall N _ skall N, skorpe N _ 
skálžu N: skall N; skjell N _ skjell N _ 
gaska N: mellomrom N; opphold N; avstand N _ mellomrom N, avstand N _ 
loapmi N: mellomrom N; åpning N _ åpning N, mellomrom N _ 
ruhta N: middel N _ penge N _ 
geaidnu N: vei N; veg N _ vei N, veg N _ 
luodda N: vei N; veg N _ spor N, vei N _ 
máđidja N: vei N; løype N _ vei N, fast løype N _ 
máđii N: vei N _ vei N, fast løype N _ 
raŧŧi N: vei N; veg N _ vei N, veg N, vintervei N _ 
bálggis N: vei N; veg N _ sti N; veg N _ 
geardi N: etasje N; generasjon N; gang N _ gang N; etasje N; aldersklasse N _ 
giella N: språk N _ språk N; snare N _ 
sámegielgursa N: språkkurs N; samiskkurs N _ samiskkurs N _ 
gievdni N: kjel N; bøtte N _ bøtte N, kjel N _ 
váivi N: plage N _ besvær N, plage N _ 
giksi N: plage N; bryderi N _ plage N _ 
šuokŋa N: klang N; tone N; melodi N _ klang N _ 
skádja N: klang N _ ekko N; etterklang N _ 
lávvomuorra N: teltstang N _ teltstang til lavvo N _ 
goahti N: gamme N _ gamme N; vintertelt N _ 
goalmmádas N: tredjedel N _ tredjedel N, tredel N _ 
goargu N: heder N; etternavn N _ stas N, heder N; familienavn N _ 
gudni N: heder N; ære N _ ære N _ 
goavki N: gløtt N; åpning N _ gløtt N, åpning N _ 
goldin N: drivgarnfiske N _ drivgarnsfiske N _ 
gudji N: gate N; passasje N _ gate N, passasje N _ 
guolbba N: slette N _ slette N, mo N _ 
guolástus N: fiskeri N; fiske N _ fiske N _ 
guovlu N: reinsogn N; retning N; område N; distrikt N; region N; areal N; territorium N _ trakt N, distrikt N; område N; reinsogn N; retning N _ 
boazosuohkan N: reinsogn N; reindriftskommune N _ reindriftskommune N _ 
kaféa N: kafe N _ kafé N _ 
gáibádus N: fordring N; krav N _ krav N; fordring N _ 
miessi N: kalv N _ reinkalv N _ 
gálvu N: vare N; produkt N _ vare N, bagasje N _ 
gáržžideapmi N: begrensning N; restriksjon N _ begrensning N, restriksjon N _ 
hoavda N: sjef N; leder N _ leder N, sjef N _ 
njunuš N: sjef N; ledelse N _ tet N, ledelse N, fortropp N _ 
áddejupmi N: forståelse N; oppfatning N; syn N _ syn N, forståelse N _ 
ipmárdus N: forståelse N; oppfatning N _ forståelse N _ 
jahkodat N: årgang N; årssyklus N _ årstid N; årssyklus N; årgang N _ 
jorbodat N: sirkel N _ runding N, sirkel N _ 
gierdu N: sirkel N; ring N _ ring N, runding N; linebøyel N; spektrum N _ 
spábbačiekčan N: fotball N _ fotballkamp N _ 
juovlabeahci N: juletre N _ julefuru N _ 
boradanlatnja N: kantine N _ spiserom N _ 
jietnabáddi N: kassett N _ lydbånd N _ 
kulturmuitoláhka N: kulturminnelov N _ kulturminneloven N _ 
latnja N: sprekk N; rom N; lokale N; åpning N _ rom N; sprekk N; åpning N _ 
sálvu N: sprekk N _ sprekk N; fuge N _ 
vággi N: dal N _ dal N, liten dalsenkning N _ 
leahpu N: fred N; ro N _ fred N, ro N _ 
luohkká N: klasse N _ klasse N; bakke N; skåkbue N _ 
ceahkki N: klasse N; grad N; trinn N _ trinn N; grad N _ 
luođđa N: kule N; skudd N _ kule N _ 
šládja N: slag N; type N; art N; art N _ slag N, sort N _ 
lávlu N: sang N; sanger N _ sang N _ 
lávlun N: sang N _ synging N _ 
olmmái N: venn N; mann N; kamerat N _ mann N; venn N, kamerat N _ 
lávvi N: venn N _ god kjenning N, venn N _ 
skihpár N: venn N; kamerat N _ kamerat N, venn N _ 
skibir N: venn N; kamerat N _ venn N, kamerat N _ 
ustit N: venn N; kamerat N _ venn N, kamerat N _ 
mearka N: merke N; signal N; reinmerke N; tegn N; tegn N; tegn N _ merke N, signal N; fiskemed N _ 
riddu N: kyst N _ kyst N; strand N _ 
mielddus N: følgeskriv N; vedlegg N _ følgeskriv N, vedlegg N _ 
miella N: sinn N _ sinn N; humør N; lyst N _ 
mihttomearri N: målsetting N; mål N _ målsetting N _ 
mokta N: optimisme N; motivasjon N _ humør N, optimisme N; motivasjon N _ 
muitalus N: fortelling N; historie N _ fortelling N _ 
máinnas N: fortelling N; eventyr N _ eventyr N _ 
máhcastat N: brett N _ fold N, brett N _ 
máhttu N: ferdighet N; kunnskap N; kompetanse N; kvalifikasjon N _ kunnskap N, ferdighet N; kvalifikasjon N _ 
márkan N: kirkested N; marked N; tettsted N _ marked N; kirkested N, tettsted N _ 
nieidamánná N: jente N _ jentebarn N _ 
niestelávka N: nistesekk N _ nistesekk N, matransel N _ 
náittosgovva N: bryllupsbilde N _ brudebilde N, bryllupsbilde N _ 
oaidnu N: synspunkt N; syn N _ syn N; synspunkt N _ 
ortnet N: orden N; orden N; ordning N _ orden N _ 
skihkka N: orden N _ skikk N; orden N _ 
ovdagovva N: ideal N; forbilde N _ ideal N _ 
ovdaolmmoš N: formann N; leder N _ leder N, formann N, forkvinne N _ 
raddi N: bryst N _ bryst N; barm N _ 
čižži N: bryst N; pupp N _ kvinnebryst N _ 
spihčá N: pisk N _ svepe N _ 
roaškkas N: rabalder N _ smelling N, rabalder N _ 
rumaš N: kropp N _ legeme N, kropp N _ 
gorut N: kropp N _ skrott N _ 
rusttet N: installasjon N; byggverk N; anlegg N _ anordning N, installasjon N, anlegg N; byggverk N; etablissement N _ 
ráhkkanas N: innretning N; greie N _ innretning N, greie N _ 
ráhpi N: slam N _ slam N, søle N _ 
čuoigan N: ski N; langrenn N; skirenn N _ skirenn N _ 
seahtu N: stand N; stilling N _ stand N, stilling N _ 
sirdin N: overføring N; flytting N _ flytting N; overføring N _ 
sisdoallu N: innholdsfortegnelse N; innhold N _ innhold N; innholdsfortegnelse N _ 
skohter N: snøscooter N; scooter N _ scooter N, snøscooter N _ 
muohtaskohter N: snøscooter N; snøskuter N _ snøskuter N _ 
skuovva N: sko N; støvel N _ sko N _ 
sohka N: slekt N _ slekt N, ætt N; slektning N _ 
sogalaš N: slekt N; slektning N _ slektning N _ 
suopman N: dialekt N; stemme N _ stemme N, røst N; dialekt N _ 
sárggis N: linje N; strek N _ strek N _ 
duhpát N: røyk N; tobakk N _ tobakk N _ 
ságastallan N: samtale N; debatt N; dialog N _ samtale N; dialog N _ 
unnitlohku N: mindretall N; minoritet N _ mindretall N _ 
viidna N: vin N _ vin N, brennevin N _ 
viidni N: vin N; brennevin N _ vin N _ 
vuogádat N: system N _ framgangsmåte N; system N _ 
vuoiŋŋalašvuohta N: ånd N _ åndelighet N _ 
vuoitu N: fordel N; gevinst N _ seier N; fordel N; gevinst N; avkastning N _ 
vuoiŋŋahat N: pust N _ åndedrett N _ 
sarvvis N: okse N _ reinsbukk N _ 
bárggeš N: komagbånd N _ flettet snor til komagbånd N _ 
vuođđojurdda N: ideologi N; prinsipp N _ prinsipp N; ideologi N _ 
duottar N: fjell N _ vidde N _ 
áhta N: element N; ting N _ ting N; element N _ 
áigodat N: intervall N; sesong N _ intervall N; tidsperiode N _ 
áigumuš N: intensjon N; vilje N _ vilje N, hensikt N; intensjon N _ 
láigi N: tråd N; garn N _ garn N, ulltråd N _ 
ásahus N: ordning N; institusjon N; organ N _ ordning N, foranstaltning N; institusjon N, organ N _ 
ávnnas N: emne N; materiale N _ emne N, skurlast N _ 
fáddá N: emne N; tema N; motiv N _ tema N, motiv N _ 
áššebábir N: saksdokument N; dokument N; sakspapir N _ sakspapir N, aktstykke N, saksdokument N _ 
čađaheapmi N: gjennomgang N; gjennomføring N _ gjennomgang N, gjennomføring N _ 
geahčadeapmi N: gjennomgang N _ innsyn N _ 
čielgi N: ryggrad N; rygg N _ rygg N, ryggrad N; landrygg N; hovedsnøre N _ 
čielgedákti N: ryggrad N _ ryggvirvel N _ 
čoarvi N: gevir N; horn N _ horn N _ 
čujuhus N: adresse N; henvisning N _ adresse N; anvisning N, henvisning N _ 
čáhci N: vann N _ vann N, vatn N _ 
jávri N: vann N _ innsjø N _ 
čálus N: notat N _ notat N, skriv N _ 
čázet N: komag N _ komag N, sommerkomag N _ 
báidi N: genser N _ skjorte N _ 
gáddu N: myte N; tro N _ knehase N; tro N, formodning N _ 
noras N: lårbein N _ lårbein N, margbein N _ 
astoáiggeviessu N: fritidsbolig N; fritidshus N _ fritidshus N, fritidsbolig N _ 
diehtogáldu N: informasjonskilde N; datakilde N _ informasjonskilde N, datakilde N _ 
diehtovuođđu N: informasjonsgrunnlag N; database N _ database N; informasjonsgrunnlag N _ 
doaibmagoddi N: arbeidsutvalg N; kommisjon N _ kommisjon N, arbeidsutvalg N _ 
doaibmalohpi N: konsesjon N; løyve N _ konsesjon N, løyve N _ 
lohpi N: løyve N; tillatelse N; lov N _ tillatelse N, lov N _ 
jođihandoarjja N: driftstilskudd N; driftsstøtte N _ driftstilskudd N _ 
ovttaolbmofitnodat N: enkeltmannsforetak N _ eneierforetak N, enkeltmannsforetak N _ 
ovttasbargolávdegoddi N: samarbeidsutvalg N _ samarbeidskomité N, samarbeidsutvalg N _ 
guovlopolitihkka N: regionalpolitikk N; distriktspolitikk N _ distriktspolitikk N _ 
riektegeavahus N: rettspraksis N _ rettsanvendelse N _ 
skovvi N: blankett N; skjema N _ skjema N, blankett N _ 
astoáiggefálaldat N: skolefritidsordning N; fritidstilbud N _ fritidstilbud N _ 
ulbmilparagráfa N: formålsbestemmelse N; formålsparagraf N _ formålsparagraf N _ 
media N: presse N _ media N _ 
rehketmašiidna N: kalkulator N _ regnemaskin N, kalkulator N _ 
diehtu N: informasjon N; beskjed N; kunnskap N; opplysning N _ kunnskap N, viten N; informasjon N _ 
diehtojuohkin N: informasjon N; orientering N _ informasjon N, orientering N _ 
sorta N: type N _ sort N _ 
jagiáigi N: sesong N _ årstid N _ 
digaštallan N: debatt N; diskusjon N _ debatt N, ordskifte N _ 
buvttadus N: produksjon N _ produksjon N, avkastning N _ 
mearrádus N: vedtak N; bestemmelse N _ bestemmelse N _ 
vádjit N: mangel N; underskudd N _ underskudd N, mangel N _ 
váili N: mangel N; underskudd N _ mangel N, underskudd N _ 
osku N: religion N; tro N _ tro N; religion N _ 
geahččaleapmi N: prøve N; forsøk N _ prøve N _ 
geahččalus N: prøve N; prøvelse N; fristelse N _ prøvelse N; fristelse N _ 
sadji N: posisjon N; sted N; rolle N; plass N _ sted N, plass N; posisjon N; rolle N _ 
dorvu N: sikkerhet N; tillit N; trygghet N _ tillit N; sikkerhet N _ 
hápmi N: stil N; form N _ form N; skikkelse N; utseende N; fasade N _ 
eaktu N: forutsetning N; vilkår N; kriterium N _ betingelse N, vilkår N; klausul N; kriterium N _ 
duohtavuohta N: alvor N; realitet N; faktum N _ sannhet N _ 
fearán N: episode N; hendelse N; historie N _ hending N, hendelse N _ 
guorahallan N: analyse N; utredning N; utredning N; undersøkelse N _ utredning N; analyse N _ 
bálvalus N: service N; tjeneste N _ tjeneste N _ 
ovdanbuktin N: presentasjon N; fremstilling N; foredrag N; uttrykk N; framstilling N _ presentasjon N _ 
ádji N: opphold N _ tidhefte N _ 
leaika N: humor N; spøk N _ spøk N _ 
dáidu N: sans N; kunnskap N; evne N _ kunnskap N; forstand N _ 
ealáhat N: pensjon N _ beite N; pensjon N _ 
suodjalus N: beskyttelse N; forsvar N; vern N _ beskyttelse N, vern N _ 
suodji N: beskyttelse N; vern N _ ly N, vern N _ 
suoidni N: gress N _ gress N, høy N; sennegress N _ 
rássi N: gress N _ gras N; urt N, blomst N _ 
sáŋgár N: forbilde N; helt N _ helt N _ 
ruovdemáđidja N: jernbane N _ jernbanespor N _ 
váldi N: fullmakt N; mandat N; myndighet N _ fullmakt N, myndighet N, mandat N _ 
fápmudus N: fullmakt N; mandat N _ mandat N _ 
náittosbárra N: ektepar N _ brudepar N _ 
náittospárra N: ektepar N _ brudepar N _ 
dovddastus N: erkjennelse N _ innrømmelse N, tilståelse N; betroelse N _ 
dutkan N: etterforskning N; forskning N; undersøkelse N _ undersøkelse N; forskning N _ 
garrusátni N: banning N _ banneord N _ 
guoddá N: madrass N _ pute N _ 
gilvočuoigan N: langrenn N; skirenn N _ skirenn N _ 
báhpasuohkan N: prestegjeld N _ prestesokn N _ 
čáhcerusttet N: vannverk N _ vannanlegg N _ 
riikkageaidnu N: riksveg N; riksvei N _ riksvei N _ 
bargobivttas N: kjeledress N _ arbeidsplagg N _ 
dárbbaš N: rekvisita N; behov N _ behov N, nødvendighet N _ 
váldooassi N: hovedenhet N; hoveddel N _ hoveddel N _ 
resursaváili N: ressursknapphet N _ ressurssvak A _ 
juolgi N: bein N; fot N _ fot N, bein N _ 
váddu N: feil N; skade N _ skade N, feil N _ 
meaddádus N: feil N _ feil N, tabbe N _ 
vearri N: feil N; urett N _ urett N, feil N _ 
ruoktu N: hjem N _ heim N, hjem N _ 
vuohki N: måte N; metode N _ måte N, metode N _ 
láhki N: måte N _ måte N, vis N _ 
ossodathoavda N: avdelingsleder N; avdelingsdirektør N _ avdelingsleder N _ 
bálvá N: tjener N; tjenestemann N _ tjener N _ 
čázádat N: vassdrag N _ vassdrag N, vassfar N _ 
lássa N: glass N _ glass N; skjær som synes over vannet N _ 
buohccebiila N: ambulanse N _ sykebil N, ambulanse N _ 
beaivelatnja N: stue N _ dagligstue N, stue N _ 
stohpu N: stue N; hus N; bolig N _ stue N; hus N _ 
olggoš N: omslag N; trekk N; overflate N _ omslag N, trekk N; overflate N _ 
sámeálbmot N: samefolk N _ samefolket N _ 
veahtu N: hindring N; hefte N _ hefte N, hindring N _ 
girjjáš N: hefte N _ liten bok N, hefte N _ 
vuođđudus N: stiftelse N _ stiftelse N, grunnleggelse N _ 
árja N: iver N; energi N; innsats N _ energi N, iver N; innsats N _ 
loahppageahččaleapmi N: eksamen N _ eksamen N; generalprøve N _ 
bartasadji N: hyttetomt N; tomt N _ hyttetomt N _ 
deaddileapmi N: trykking N; opplag N _ trykking N _ 
mánnu N: måned N _ måne N; måned N _ 
jorgalanbargu N: oversettelsesarbeid N; oversettelse N _ oversettelsesarbeid N _ 
TV N: fjernsyn N _ TV N, fjernsyn N _ 
allaskuvla N: høgskole N; høyskole N _ høgskole N _ 
hálti N: himmelretning N; retning N _ himmelretning N; kurs N; retning N _ 
gállis N: mann N _ kall N, mann N _ 
salla N: fang N _ fang N, favn N _ 
gealbu N: nytte N; kompetanse N _ gagn N, nytte N; kompetanse N _ 
gávdni N: nytte N _ nytte N, gagn N _ 
attáldat N: gave N; anlegg N; evne N _ gave N _ 
ballu N: frykt N _ frykt N; angst N _ 
bargobihttá N: arbeidsoppgave N; oppgave N _ arbeidsoppgave N _ 
bargojoavku N: arbeidsgruppe N; utvalg N _ utvalg N, arbeidsgruppe N _ 
beaivi N: dag N _ dag N; sol N _ 
bealgi N: tommelfinger N _ tommelfinger N, tommel N; stortå N _ 
beallji N: øre N _ øre N; svømmefinne N _ 
čeahborbeaska N: pesk N _ pesk N, tykk pesk N, pesk av tykt høstskinn N _ 
beavdi N: bord N; pult N _ bord N _ 
bordi N: bord N; rekke N _ bord N; rekke N; skranke N _ 
biebmu N: mat N _ mat N, føde N _ 
diggi N: ting N; rett N _ ting N, rett N; tinglyd N _ 
oažži N: kjøtt N; muskel N _ kjøtt N; kjød N, legeme N; muskel N _ 
moallu N: bit N _ smule N, bit N _ 
binná N: bit N _ bit N, stykke N; liten flokk N _ 
molssodanlatnja N: garderobe N _ stellerom N; garderobe N _ 
lasta N: blad N _ løv N, blad N _ 
ráidu N: rekke N; serie N; rekkefølge N; kolonne N _ raid N, rekke N; serie N; kolonne N _ 
šoavva N: brus N; sus N _ sus N, brus N _ 
juhca N: brus N; sus N _ sus N, brus N _ 
buolaš N: kulde N _ kulde N, frost N _ 
buolva N: generasjon N _ slektsledd N, generasjon N; kne N _ 
sohkabuolva N: generasjon N _ slektsledd N, generasjon N _ 
bustávva N: bokstav N; tegn N _ bokstav N _ 
báidnu N: farge N _ farge N, maling N _ 
báiki N: sted N _ sted N, heim N _ 
bárdni N: sønn N; gutt N _ gutt N; sønn N _ 
vuoissahat N: smerte N _ sting N, smerte N _ 
savu N: kulp N _ kulp N, stilleflytende strekning i elva N _ 
dappal N: kulp N _ kulp N, bakevje N _ 
jorbmi N: kulp N _ djup kulp N; myrhull N _ 
dieđa N: vitenskap N; kunnskap N _ vitenskap N _ 
tiibma N: time N _ time N, klokke N _ 
tiibmu N: time N _ time N; ur N, klokke N _ 
diksu N: hyse N _ hyse N, kolje N _ 
vearru N: avgift N; skatt N _ skatt N, avgift N _ 
divri N: insekt N _ dyr N, insekt N _ 
doaivu N: håp N; tro N _ håp N _ 
doavttir N: lege N _ lege N, doktor N _ 
dolla N: bål N; ild N _ bål N, ild N _ 
duollu N: toll N; toll N _ tele N; toll N _ 
duolva N: skitt N _ smuss N, skitt N _ 
luhča N: skitt N _ skitt N, avføring N, søle N _ 
riekti N: domstol N; rett N; rett N; rettighet N _ rett N, domstol N _ 
fearrán N: hendelse N _ hending N, hendelse N _ 
viessu N: hus N; bolig N _ hus N _ 
dássi N: nivå N _ jamnhøyde N; nivå N _ 
dáčča N: nordmann N _ nordmann N, svenske N _ 
eahpádus N: tvil N _ tvil N; betenkelighet N, skepsis N _ 
eallin N: liv N _ liv N, leven N _ 
eallindilálašvuohta N: livssituasjon N; levekår N _ livssituasjon N _ 
eallindilli N: livssituasjon N; levekår N _ livssituasjon N _ 
eallu N: flokk N; reinflokk N _ flokk N, reinflokk N _ 
áhkká N: kone N _ hustru N, kone N _ 
gálgu N: kone N _ kone N, hustru N _ 
eamit N: kone N _ hustru N, kone N _ 
eanadoallu N: jordbruk N; landbruk N _ jordbruk N _ 
eanandoallu N: jordbruk N; landbruk N _ jordbruk N _ 
eananspábba N: jordklode N; jord N _ jordklode N _ 
čiehka N: krok N _ hjørne N, krok N _ 
faggi N: krok N _ krok N, knagg N _ 
roahkki N: krok N; hake N _ krok N, hake N; hektekrok N, malje N _ 
fanas N: båt N; fartøy N _ båt N _ 
fápmu N: makt N; kraft N; styrke N _ makt N, styrke N _ 
gielda N: kommune N _ kommune N; sogn N _ 
suohkan N: kommune N _ kommune N; sogn N; herred N _ 
gielis N: løgn N _ løgn N; løgner N _ 
gikta N: skyss N _ synkestein N, vekt N; skyss N _ 
gilvu N: konkurranse N; kamp N _ konkurranse N _ 
gilvva N: sæd N _ sæd N, frø N _ 
ginttal N: stearinlys N _ talglys N, stearinlys N _ 
girji N: bok N _ bok N; brev N; flekk i pelsen N _ 
goikeguolli N: tørrfisk N _ klippfisk N; tørrfisk N _ 
gonagasbárdni N: prins N _ kongssønn N, prins N _ 
lahttu N: medlem N _ medlem N, lem N _ 
gullevašvuohta N: identitet N; tilknytning N _ tilhørighet N; identitet N _ 
guoika N: stryk N _ stryk N, fossestryk N _ 
guolbi N: golv N _ jordgolv N, golv N _ 
guolevuodja N: tran N _ fiskeleverolje N, tran N _ 
guvžá N: sjøaure N _ sjøaure N, sjøørret N _ 
gužža N: urin N _ tiss N, urin N _ 
gáhttu N: katt N _ hustak N; katt N _ 
gámmár N: rom N _ kammer N, rom N _ 
gárdi N: gjerde N _ innhegning N; gjerde N; rypesnare med risgjerde N _ 
gávppašeapmi N: handel N; omsetning N _ handel N _ 
bálkkašupmi N: pris N _ pris N, belønning N, premie N _ 
vuoján N: hest N; kjøretøy N _ kjørerein N; hest N _ 
hersko N: delikatesse N _ delikatesse N; god mat N _ 
hivsset N: do N _ do N, WC N, toalett N _ 
hoahkan N: regle N; rim N _ regle N _ 
hoammá N: dreng N _ same vestfra N; dreng N, arbeidskar N _ 
háhcci N: skritt N _ skrev N, skritt N _ 
lávki N: skritt N _ løk N; skritt N, steg N _ 
moarsi N: kjæreste N _ kjæreste N; brud N _ 
irgi N: kjæreste N _ kjæreste N; frier N; brudgom N _ 
jietna N: stemme N _ lyd N; stemme N _ 
julggaštus N: erklæring N _ erklæring N; manifest N _ 
jurdda N: tanke N; ide N; idé N _ tanke N _ 
jáffu N: mel N; melsekk N _ mel N _ 
lahkki N: halvdel N _ halvdel N, halvpart N _ 
leavga N: flagg N _ flagg N; fane N _ 
roassu N: ulykke N _ ulykke N; tap N _ 
logeš N: tier N _ titall N, tier N _ 
lohku N: tall N; antall N _ tall N, antall N _ 
láhka N: lov N _ lov N; lake N _ 
láddelaš N: kven N _ finne N, kven N; svenske N _ 
skiipa N: skip N; fartøy N _ skip N _ 
lávdi N: scene N; plattform N _ scene N; plattform N; podium N _ 
mearra N: hav N; sjø N _ hav N, sjø N _ 
áhpi N: hav N _ vid myrstrekning N, treløs slette N; hav N _ 
skáhpi N: rogn N _ rogn N, rognetre N _ 
skoaddu N: tåke N _ skodde N, tåke N _ 
mierká N: tåke N _ tåke N, skodde N _ 
mátta N: rot N _ rot N; nederste del N _ 
moivi N: rot N _ rot N, grums N _ 
máddu N: rot N _ rot N; opprinnelse N _ 
ruohtas N: rot N; opprinnelse N _ rot N _ 
muitu N: minne N _ minne N, hukommelse N _ 
neavva N: råd N; anbefaling N _ råd N, formaning N _ 
niibeboagán N: knivbelte N _ knivbelte N, belte med kniv N _ 
njárga N: nes N _ nes N; halvøy N _ 
návste N: naust N _ naust N; skjul N, skur N _ 
oabbá N: søster N; søsken N _ søster N _ 
oahpahus N: undervisning N; utdanning N; opplæring N _ undervisning N _ 
oaksi N: grein N; kvist N _ grein N, kvist N _ 
oarra N: snøre N _ snøre N, tau N _ 
olgoriika N: utland N _ utlandet N _ 
ossodat N: avdeling N; andel N _ andel N; avdeling N _ 
riegádanbeaiskeaŋka N: bursdagsgave N _ fødselsdagsgave N, bursdagsgave N _ 
rievssat N: rype N; lirype N _ rype N, lirype N _ 
rovvi N: bru N _ enkel bru N; bru N; stoppskive N _ 
šaldi N: bru N; bro N _ bru N _ 
ruvke N: gruve N; verk N _ gruve N _ 
searvi N: forening N; selskap N _ forening N, selskap N _ 
silki N: silke N _ silke N; silketørkle N _ 
sudja N: årsak N; grunn N _ årsak N, grunn N; skyld N _ 
sivva N: årsak N; grunn N _ grunn N, årsak N _ 
soabbi N: stav N _ stav N, kjepp N _ 
spáiddar N: fakkel N _ fakkel N, bluss N _ 
stoagus N: leke N; lek N _ leke N, leketøy N _ 
submi N: sum N; beløp N _ sum N _ 
suolu N: øy N _ øy N, holme N _ 
sámeláhka N: samelov N _ sameloven N _ 
sávdni N: dampbad N _ dampbad N, sauna N _ 
sávdnji N: søm N _ søm N; badstue N _ 
linnjábiila N: tog N _ rutebuss N; tog N _ 
ulbmil N: formål N; mål N _ mål N, formål N _ 
vahát N: skade N; tap N; uhell N _ skade N, tap N; uhell N, vanvare N _ 
vilba N: fetter N _ fetter N; tremenning N _ 
vilbealle N: fetter N; søskenbarn N _ fetter N _ 
virgi N: embete N; stilling N _ stilling N, embete N _ 
vuodja N: smør N _ smør N, fett N _ 
vuolgga N: avreise N; opprinnelse N _ opprinnelse N; start N; avreise N _ 
vuorbi N: skjebne N _ lodd N, skjebne N _ 
vuođđoealáhus N: primærnæring N _ basisnæring N, primærnæring N _ 
vuođđoláhka N: grunnlov N _ grunnloven N _ 
vásáhus N: opplevelse N; erfaring N _ opplevelse N _ 
áddjá N: bestefar N _ bestefar N; gammel mann N _ 
áhkku N: bestemor N _ bestemor N; eldre kvinne N _ 
álbmot N: folk N; befolkning N _ folk N _ 
álgu N: begynnelse N; opprinnelse N _ begynnelse N _ 
árbmu N: nåde N _ nåde N; amnesti N _ 
čalbmi N: øye N _ øye N; garnmaske N, maske N _ 
šalbmi N: øye N _ nåløye N; øye N _ 
čoavddasátni N: stikkord N _ nøkkelord N, stikkord N _ 
čohkka N: fjelltopp N; topp N _ topp N, fjelltopp N _ 
čuovgagovva N: lysbilde N _ lysbilde N, slide N _ 
čuoččuhus N: påstand N _ påstand N; pretensjon N _ 
čála N: skrift N _ skrift N; tegnsett N _ 
šibit N: husdyr N _ husdyr N, fe N _ 
duiskkagiella N: tysk N _ tysk språk N _ 
miellaguoddu N: holdning N; innstilling N _ holdning N, innstilling N _ 
boazodoalloguovlu N: reindriftsområde N; reinbeiteområde N _ reindriftsområde N, reinbeiteområde N _ 
dávdamearka N: sykdomstegn N; symptom N _ symptom N, sykdomstegn N _ 
ealáhusdoaibma N: næringsvirksomhet N; næringsliv N _ næringsliv N, næringsvirksomhet N _ 
jearahallan N: intervju N _ intervju N, utspørring N _ 
olmmoš N: person N; menneske N _ menneske N _ 
fitnodat N: bedrift N; selskap N _ firma N, foretak N _ 
giehta N: hånd N _ hand N; arm N _ 
jođihangoddi N: ledelse N _ ledelse N, lederskap N _ 
hámádat N: profil N; struktur N _ profil N _ 
spiehkastat N: unntak N _ unntak N, avvik N _ 
doaba N: begrep N _ fagord N _ 
dovdomearka N: symptom N; kjennetegn N _ kjennetegn N _ 
fállu N: meny N _ tilbud N; meny N _ 
ohcan N: søk N; søknad N _ søknad N; leting N _ 
nuohtta N: tone N; melodi N _ melodi N; note N _ 
čotta N: hals N _ svelg N, hals N _ 
eanadat N: landskap N _ terreng N _ 
veardádus N: sammenligning N _ sammenligning N; lignelse N _ 
jápmin N: dødsfall N; død N _ døden N _ 
váikkuhus N: påvirkning N; konsekvens N _ virkning N; påvirkning N _ 
bajásgeassin N: oppdragelse N _ oppfostring N _ 
oanádus N: forkortelse N _ forkorting N _ 
ađa N: marg N _ marg N, margbein N _ 
biilaboagán N: sikkerhetsbelte N _ bilbelte N _ 
lieđđegavja N: pollen N _ pollen N, blomsterstøv N _ 
vearroláhka N: skattelov N _ skatteloven N _ 
čikŋodat N: dyp N _ dybde N _ 
čiekŋalas N: dyp N _ dyp N, dypt sted N _ 
heargi N: rein N _ kjørerein N _ 
geahččoboazu N: rein N _ sytingsrein N _ 
vuođđu N: grunn N; plattform N; grunnlag N _ bunn N, grunn N, underside N, fundament N _ 
vuoigatvuohta N: rett N; rettighet N _ rettighet N _ 
badjenisu N: reindriftssame N; reindriftskvinne N _ reindriftssame N _ 
heargegilvu N: reinkappkjøring N _ reinkappløp N _ 
dárogiella N: norsk N _ norsk språk N _ 
dárru N: norsk N _ norsk språk N _ 
jiella N: trekk N _ trekk N, svakt luftdrag N _ 
skoađas N: trekk N; isolasjon N _ trekk N, for N, paneling N; isolasjon N _ 
čáhcegiera N: overflate N _ vannskorpe N _ 
eanaeaiggáduššanvuoigatvuohta N: eiendomsrett N _ jordeiendomsrett N _ 
bivdu N: fiske N; jakt N; fangst N _ jakt N; fiske N _ 
oahppu N: utdanning N; kunnskap N; opplæring N _ kunnskap N _ 
oahppa N: utdanning N; kunnskap N _ kunnskap N; lære N _ 
alitoahppu N: utdanning N _ høyere utdanning N _ 
skuvlen N: utdanning N _ skolering N _ 
skuvlejupmi N: utdanning N; skolegang N _ utdanning N _ 
ođastus N: reform N _ reform N, fornyelse N _ 
táhpa N: tap N; tap N _ tap N _ 
veaigi N: ettermiddag N _ skumring N _ 
soabalašvuohta N: enighet N _ fordragelighet N _ 
hušša N: stress N _ ståk N, stress N _ 
orrunsadji N: bosted N _ oppholdssone N _ 
náittus N: ekteskap N _ vielse N _ 
giellaovdáneapmi N: språkutvikling N _ språklig utvikling N _ 
šiella N: skatt N _ finnerlønn N, fødselsgave N _ 
dadjamuš N: utsagn N; innflytelse N _ noe å si N _ 
dajahus N: utsagn N; uttrykk N _ uttrykk N; joiketekst N _ 
sáhkavuorru N: innlegg N; tale N _ innlegg N _ 
reaidu N: redskap N; utstyr N; verktøy N; hjelpemiddel N _ verktøy N, hjelpemiddel N _ 
bargobierggas N: redskap N; utstyr N _ redskap N, arbeidsredskap N _ 
bargoneavvu N: redskap N; verktøy N _ verktøy N _ 
bivddus N: redskap N _ fangstredskap N _ 
bivdoneavvu N: redskap N; fiskeredskap N _ fiskeredskap N _ 
ávvir N: omsorg N; oppmerksomhet N _ oppmerksomhet N, omsorg N _ 
biebmodoallu N: kosthold N _ diett N; kosthold N _ 
bihci N: rim N _ rimfrost N, rim N _ 
birasoahppu N: orienteringsfag N _ orienteringsfag N, miljøfag N _ 
bártnáš N: gutt N _ liten gutt N _ 
gánddaš N: gutt N _ liten gutt N _ 
bárti N: uhell N; problem N _ uhell N; knipe N _ 
giera N: topp N _ topp N; utspring N _ 
sisabahkken N: inngrep N _ inntrenging N _ 
dievasčoahkkin N: plenum N; plenumsmøte N _ plenum N _ 
ollesčoahkkin N: plenum N; plenumsmøte N _ plenumsmøte N _ 
doaimmahus N: virksomhet N; redaksjon N _ redaksjon N _ 
doaibmaviidodat N: virkeområde N _ virkeområde N, aksjonsradius N _ 
duodji N: håndarbeid N; håndverk N _ håndarbeid N, håndverk N _ 
dipmaduodji N: håndarbeid N _ myksløyd N, håndarbeid med myke materialer N _ 
duovdda N: område N _ område N, flytte- og beiteområde N, reinbeiteareal N _ 
eahketborramuš N: kveldsmat N _ kveldsmat N, aftensmat N _ 
hávvi N: gang N _ sår N _ 
vázzin N: gang N _ gåing N _ 
fierpmádat N: nettverk N; nettverk N _ nettverk N _ 
fierbmi N: nettverk N; garn N _ fiskegarn N _ 
fuomášupmi N: ide N; oppmerksomhet N; fokus N _ ide N _ 
mális N: middag N _ kokt mat N; suppe N _ 
geahčču N: tilsyn N; kontroll N _ tilsyn N, bevoktning N _ 
bearráigeahčču N: tilsyn N; kontroll N _ oppsyn N _ 
čehppodat N: kompetanse N _ dyktighet N _ 
gierdevašvuohta N: toleranse N _ tålmodighet N _ 
mearri N: mål N _ mål N, mengde N _ 
mihttu N: mål N; mål N _ mål N, målestokk N _ 
govvádus N: framstilling N _ beskrivelse N, framstilling N _ 
guoibmi N: kamerat N; partner N _ kamerat N; livsledsager N, ektemake N; samboer N _ 
verdde N: kamerat N _ kamerat N; vert N, gjestevenn N _ 
čielggadeapmi N: utredning N; utredning N _ utredning N _ 
čielggadus N: utredning N _ forklaring N _ 
doaresbealli N: distrikt N _ veggrøft N; avsides sted N _ 
jáhkku N: tro N; forestilling N _ forestilling N _ 
gáibi N: hake N _ hake N, kjake N _ 
báddi N: bånd N; bånd N _ tau N _ 
čanas N: bånd N; bånd N _ bånd N, bind N _ 
čanastat N: bånd N; bånd N _ band N, bånd N _ 
historjá N: historie N; historie N _ historie N _ 
hálddašanguovlu N: forvaltningsområde N; forvaltningsområde N _ forvaltningsområde N, administrativt område N _ 
lassioahppu N: videreutdanning N; etterutdanning N _ etterutdanning N _ 
johka N: elv N _ bekk N, elv N _ 
fielbmá N: elv N _ lita stille elv N, stille sted i ei lita elv N _ 
eatnu N: elv N _ stor elv N, flod N _ 
deatnu N: elv N _ stor elv N _ 
jorgalus N: oversettelse N _ oversettelse N; omvendelse N _ 
govahallan N: forestilling N _ illusjon N _ 
juoigan N: joik N _ joiking N _ 
sáibma N: garn N _ ørretgarn N, småfiskgarn N _ 
mearkkašeapmi N: merknad N; kommentar N _ kommentar N, bemerkning N _ 
bajilčála N: tittel N _ overskrift N _ 
nákca N: kraft N; evne N _ evne N, kraft N _ 
uvdna N: ovn N _ peis N, grue N _ 
omman N: ovn N _ stekeovn N _ 
stoahka N: lek N _ lek N; leven N _ 
duhkoras N: lek N _ leketøy N _ 
stoahkanhearva N: lek N _ leketøy N _ 
sárdni N: tale N _ preken N, tale N _ 
sáhka N: tale N _ tale N, samtale N _ 
hállan N: tale N _ bøy N, li N, skråning N _ 
máihli N: saft N _ sevje N; juice N _ 
sáhppi N: saft N _ galle N _ 
sálaš N: fangst N _ bytte N, fangst N _ 
urbi N: skudd N _ knopp N, skudd N _ 
vuodjingoarta N: førerkort N _ sertifikat N, førerkort N _ 
vuodjinkoarta N: førerkort N _ sertifikat N _ 
vuorká N: arkiv N _ arkiv N; depot N, oppbevaringsplass N; oppbevaring N _ 
mánnáolmmoš N: forelder N _ person med barn N _ 
várrelahttu N: varamedlem N; vararepresentant N _ varamedlem N _ 
čuolbma N: problem N; problemstilling N _ knute N; problemstilling N _ 
árran N: åre N _ åre N, ildsted N _ 
suotna N: åre N _ sene N _ 
ásodat N: bolig N _ bolig N; leilighet N _ 
nálli N: art N; art N; bestand N _ ætt N; rase N _ 
čoahkkin N: møte N _ møte N, forsamling N _ 
deaivvadeapmi N: møte N _ treff N _ 
čuvgehus N: opplysning N _ opplysning N; belysning N _ 
šaddu N: vekst N; vekst N; plante N _ vekst N; plante N _ 
lassáneapmi N: vekst N; økning N _ økning N _ 
bealljemearka N: reinmerke N _ øremerke N _ 
oasussearvi N: aksjeselskap N _ aksjeselskap N, andelslag N _ 
vuoiŋŋasteapmi N: rekreasjon N _ rekreasjon N, hvile N _ 
nuppástus N: endring N _ forandring N; omstilling N _ 
anárašgiella N: enaresamisk N _ enaresamisk språk N _ 
dákse N: drosje N _ taksi N _ 
rahčamuš N: kamp N; innsats N _ strev N _ 
vuolggasadji N: utgangspunkt N _ innfallsvinkel N _ 
dálkkodeapmi N: behandling N _ medisinsk behandling N _ 
arva N: energi N _ energi N, viljestyrke N _ 
čálamearka N: tegn N _ skrifttegn N _ 
riggodat N: ressurs N _ rikdom N _ 
dienas N: inntekt N _ fortjeneste N _ 
riidu N: konflikt N; strid N _ trette N, krangel N _ 
dahku N: handling N _ gjerning N; inngrep N _ 
veahkaváldin N: vold N; overgrep N _ vold N, makt N, overgrep N _ 
loahppajurdda N: konklusjon N _ resonnement N _ 
bagadallan N: veiledning N _ regi N; veiledning N _ 
ráva N: anbefaling N _ formaning N _ 
siedja N: verk N _ materie N, verk N, sårvæske N _ 
čohkkehus N: samling N _ samling N, sammensetning N _ 
govadat N: figur N _ riss N _ 
nággu N: strid N _ krangel N, disputt N, ordstrid N, tvistemål N _ 
vuostálat N: strid N _ motbakke N _ 
vearredahku N: overgrep N _ forbrytelse N _ 
searvan N: deltakelse N _ medvirkning N _ 
riedja N: støy N; skrål N _ skrål N; bråk N; høyrøystet snakk N _ 
váikkuhanfápmu N: innflytelse N _ påvirkningskraft N _ 
váikkuhanváldi N: innflytelse N _ påvirkingskraft N _ 
váikkuhanvejolašvuohta N: innflytelse N _ påvirkningsmulighet N _ 
čanus N: tilknytning N _ binding N, sammenheng N _ 
mohtorfievru N: kjøretøy N _ motorkjøretøy N _ 
vieljaš N: søsken N _ lillebror N _ 
oappáš N: søsken N _ lillesøster N _ 
bajuš N: pålegg N _ pålegg N; garndupp N _ 
váldobargu N: hovedoppgave N _ hovedarbeid N _ 
oambealle N: søskenbarn N _ kusine N _ 
oarpmealle N: søskenbarn N _ kusine N _ 
šiehtadanlávdegoddi N: forhandlingsutvalg N _ forhandlingskomité N _ 
rieibmu N: skrål N _ skrål N, leven N _ 
duollji N: reinskinn N _ reinskinn N; elgskinn N _ 
gámas N: reinskinn N _ leggskinn N _ 
