SME lemma pos: fad NOB lemma pos _ gt NOB lemma pos _ placeholder for action tag
áššemeannudeaddji N: saksbehandlerstilling N; saksbehandler N _ saksbehandler N _ 
ossodatjođiheaddji N: etatsleder N; avdelingsleder N; avdelingsdirektør N _ avdelingsleder N _ 
buohccidikšu N: sykesøster N; sykepleier N _ sykepleier N _ 
vearredahkki N: gjerningsmann N _ forbryter N _ 
biebmoealli N: beitedyr N _ kjæledyr N _ 
guldaleaddji N: lytter N; tilhører N _ tilhører N _ 
govvejeaddji N: illustratør N; fotograf N _ fotograf N _ 
bálvaleaddji N: servicepersonell N; tjener N _ tjener N _ 
vuoiti N: prisvinner N; vinner N _ vinner N _ 
šiehtadalli N: part N _ forhandler N _ 
mánnageahčči N: barnetilsyn N _ barnevakt N _ 
boazodoalli N: reindriftsutøver N; reineier N _ reindriftsutøver N _ 
dáksevuoddji N: drosjesjåfør N _ drosjesjåfør N, taksisjåfør N _ 
ságajođiheaddji N: ordfører N _ ordfører N, ordstyrer N _ 
čálli N: forfatter N; sekretær N _ forfatter N; sekretær N; skribent N _ 
girdi N: fly N _ fly N; flyver N _ 
váldočálli N: generalsekretær N _ hovedsekretær N _ 
geahčči N: publikum N; seer N _ publikum N _ 
áššedovdi N: ekspert N _ ekspert N; sakkyndig N _ 
meahciealli N: rovdyr N _ vilt dyr n _ 
buohcci N: pasient N _ syk a; pasient N _ 
bagadalli N: instruktør N; konsulent N _ instruktør N; konsulent N; rettleder N _ 
ohcci N: søker N _ søker N, skjerper N _ 
jođiheaddji N: leder N _ leder N, styrer N _ 
ovddasteaddji N: representant N _ foresatt N; representant N _ 
čoahkkinjođiheaddji N: møteleder N _ dirigent N, møteleder N _ 
jábmi N: død N _ død N, lik N _ 
láidesteaddji N: pådriver N _ dirigent N; pådriver N _ 
ruhtadeaddji N: finansieringskilde N _ finansiør N _ 
