SME lemma pos: fad NOB lemma pos _ gt NOB lemma pos _ placeholder for action tag
dovdat V: kjennskap N; føle V; kjenne V; kjenne V _ kjenne V; føle V _ 
čoahkkinastit V: ha møte V _ holde møte V _ 
báidnit V: prege V; påvirke V _ farge av V; påvirke V _ 
láhčit V: tilrettelegge V _ re V _ 
áŋgiruššat V: satse V _ ivre for V _ 
čájehit V: opptre V; vise V _ vise V _ 
láhttet V: opptre V; agere V _ bære seg at V _ 
áđđestallat V: mime V; imitere V _ herme V _ 
doapmat V: skynde V _ skynde seg V _ 
jaskkodit V: stilne V _ tie V _ 
boahtit V: møte frem V; komme V _ komme V _ 
hoigadit V: dytte V; ekskludere V; skyve V _ skyve V _ 
vuostálastit V: gå i mot V; bekjempe V _ protestere V; gjøre motstand V _ 
leaikkastallat V: skøye V _ spøke V _ 
árvidit V: spekulere V; skjønne V; forutse V; anta V _ skjønne V; gjette V _ 
vuortnuhit V: røyne V; plage V; tvinge V; presse V _ plage V; tvinge V, presse V _ 
hutkat V: uteksperimentere V; skape V _ finne på V, dikte opp V _ 
vihahit V: vigsle V; vie V; innvie V _ vie V, innvie V _ 
govvidit V: portrettere V; skissere V; gjenspeile V; beskrive V; illustrere V _ beskrive V, illustrere V _ 
boarásmuvvat V: eldes V _ bli gammel V _ 
reaškit V: gapskratte V _ skratte V _ 
veaddit V: tjore V _ holde i tjor V _ 
ahkiduššat V: mistrives V; vantrives V _ vantrives V _ 
váccašit V: rusle V _ spasere V _ 
čiŋahit V: utsmykke V; pynte V _ pynte V _ 
gevret V: bortvise V; utvise V; pålegge V _ kommandere V _ 
spežžet V: klappe V _ daske V _ 
gaikkihit V: røske V _ rykke V _ 
nimmorit V: murre V; beklage V _ beklage V _ 
árpmihit V: skåne V _ forbarme seg V _ 
márrat V: strømme V _ bruse V, dure V; innsige V _ 
ovttastit V: konsolidere V; forene V; kombinere V _ forene V _ 
gáržudit V: avgrense V; snevre V; innskrenke V; begrense V _ innskrenke V _ 
ráddjet V: avgrense V; begrense V _ begrense V _ 
leavvat V: bre V; spre V _ bre seg V _ 
mearridit V: fastsette V; vedta V; bestemme V _ bestemme V _ 
virgáibidjat V: tilsette V; konstituere V; ansette V _ ansette V _ 
hilgut V: forkaste V; avslå V; avvise V _ vrake V; avslå V, avvise V _ 
bajidit V: oppjustere V; løfte V; øke V; heve V _ løfte V, heve V _ 
átnut V: begjære V; be V _ be V, tigge V _ 
badjelgeahččat V: nedprioritere V; neglisjere V; overkjøre V; overse V _ forakte V, nedvurdere V _ 
háddjet V: splitte V; fragmentere V; spre V _ rote V, spre V _ 
buoridit V: bedre V; forbedre V _ forbedre V, rette på V _ 
čiehkat V: skjule V; gjemme V _ gjømme V _ 
čiegadit V: skjule V; gjemme V _ gjemme V _ 
goarrut V: sømme V; sy V _ sy V _ 
árvvoštallat V: evaluere V; vurdere V; kritisere V _ bedømme V; kritisere V; vurdere V _ 
duhtat V: nøye V _ være fornøyd V _ 
ođasmahttit V: modernisere V; revidere V; oppgradere V; fornye V; oppdatere V _ oppdatere V; fornye V _ 
joatkašuvvat V: vedvare V; videreføre V; fortsette V _ fortsettes V _ 
dáhkidit V: forsikre V; bekrefte V; garantere V; sikre V _ garantere V, bekrefte V; forsikre om V; kausjonere V _ 
fuomášuhttit V: fokusere V; belyse V _ gjøre oppmerksom på V _ 
duolbmat V: trå V; undervurdere V; overkjøre V; tråkke V; tråkke V; trampe V _ trø V, tråkke V _ 
buokčalit V: dukke V; dykke V _ dykke V _ 
suokkardit V: utforske V; granske V; drøfte V _ granske V _ 
muitalit V: informere V; fortelle V; omtale V; opplyse V _ fortelle V _ 
gulahit V: informere V; kunngjøre V; erklære V _ kunngjøre V _ 
buohtastahttit V: jamføre V; sammenligne V; sammenlikne V _ sammenlikne V _ 
veardidit V: jamføre V; sammenligne V; vurdere V _ sammenligne V _ 
beahtahallat V: skuffe V _ bli skuffet V; bli bedratt V _ 
háhkat V: anskaffe V; opparbeide V; skaffe V; rekruttere V _ skaffe V; rekruttere V _ 
ovttastahttit V: samordne V; forene V; inkorporere V; kombinere V; integrere V; innlemme V _ forene V, inkorporere V; kombinere V _ 
ođastit V: revidere V; fornye V; oppdatere V _ fornye V _ 
dárkkistit V: revidere V; kontrollere V; overprøve V; undersøke V _ kontrollere V, overprøve V _ 
guorahallat V: gjennomgå V; undersøke V; drøfte V _ undersøke V _ 
cealkit V: fastslå V; felle V; nedfelle V; si V; uttale V; erklære V; omtale V; uttrykke V _ si V, uttale V _ 
dovddastit V: tilkjenne V; erkjenne V _ innrømme V, bekjenne V _ 
mieđihit V: tilkjenne V; erkjenne V _ bifalle V; erkjenne V _ 
luoikat V: utlåne V; låne V _ låne bort V _ 
čavget V: skjerpe V; stramme V _ stramme V, stramme inn V; sette igang V _ 
dearvvahit V: hilse V _ hilse på V _ 
váikkuhit V: bidra V; påvirke V _ virke V; påvirke V _ 
veahkehit V: bidra V; hjelpe V _ hjelpe V, assistere V _ 
dagahit V: bidra V; føre V _ forårsake V _ 
dieđihit V: rapportere V; oppgi V; orientere V; melde V; melde V; kunngjøre V; innmelde V _ meddele V, orientere V _ 
jorggihit V: vippe V; snu V _ snu V, vende seg V _ 
sihkkut V: nulle V; slette V; sløyfe V; tørke V; stryke V; fjerne V _ tørke V; stryke ut V, fjerne V _ 
rehkenastit V: kalkulere V; regne V; beregne V _ regne V _ 
šláttardit V: tyste V _ sladre V _ 
sihkastit V: slette V; viske V; tørke V; male V _ tørke V; male V _ 
oahpahit V: skolere V; opplære V; undervise V; lære V _ undervise V, lære V _ 
dinet V: opptjene V; tjene V _ tjene V _ 
čollet V: sløye V _ sløye fisk V; gulpe V _ 
navdit V: synse V; tro V; kalle V; anta V; mene V _ kalle V; mene V, tro V _ 
váidit V: politianmelde V; påklage V; klage V; anklage V _ klage V, anklage V; anmelde V _ 
ruostut V: rustne V _ ruste V, bli rusten V _ 
čilget V: spesifisere V; skissere V; avklare V; forklare V; definere V _ forklare V _ 
geatnegahttit V: forplikte V; pålegge V _ plikte V _ 
čuohppat V: sakse V; hugge V; klippe V _ skjære V _ 
sáddet V: oversende V; sende V _ sende V _ 
doaimmahit V: utøve V; utføre V; drive V; drive V _ utrette V, utføre V _ 
cuoigut V: peke V; påpeke V _ påpeke V, gjøre oppmerksom på V _ 
cuiget V: peke V; påpeke V _ påpeke V _ 
čujuhit V: peke V; påvise V; henvise V; påpeke V; vise V; markere V _ markere V; utpeke V _ 
geiget V: avlevere V; overlevere V _ strekke ut V, rekke fram V _ 
geahččalit V: utprøve V; prøve V; forsøke V _ prøve V _ 
doalvut V: havne V; bringe V; eksportere V _ bringe bort V, føre bort V; eksportere V _ 
beahttit V: svikte V _ bedra V, narre V _ 
hállat V: snakke V; orde V; snakke V _ snakke V _ 
hupmat V: snakke V; tale V; snakke V; uttrykke V _ snakke V _ 
vákšut V: overvåke V _ granske nøye V _ 
gozihit V: overvåke V _ vokte V _ 
dohkkehit V: anerkjenne V; akseptere V; vedta V; godkjenne V _ godta V, akseptere V, bifalle V, knesette V; godkjenne V _ 
molsut V: rullere V; bytte V; skifte V _ skifte V, bytte V _ 
deattuhit V: vektlegge V; understreke V; fremheve V; poengtere V; påpeke V _ betone V, fremheve V, poengtere V _ 
rávvet V: tilrå V; anbefale V _ formane V _ 
jienastit V: votere V; nedstemme V; stemme V _ stemme V _ 
vuovdit V: omsette V; selge V _ selge V _ 
válddahit V: omhandle V; beskrive V _ beskrive V _ 
máinnašit V: omhandle V; omtale V _ omtale V, rose V _ 
addit V: yte V; levere V; gi V _ gi V _ 
dáhpáhuvvat V: foregå V; forekomme V; skje V _ hende V, skje V _ 
láittastuvvat V: kjede V; vantrives V _ vantrives V _ 
suorggahit V: ryste V; skremme V _ skremme V _ 
oaidnit V: øyne V; se V _ se V _ 
láitit V: fordømme V; kritisere V _ klandre V, kritisere V _ 
čuollat V: hugge V; hogge V _ hogge V _ 
murret V: hugge V _ sage eller hogge ved V _ 
láigohit V: innleie V; leie V _ leie av noen V _ 
ceahkkut V: tømre V _ skjære hakk V _ 
ravgat V: ramle V _ falle over ende V; sprette V _ 
ráfehuhttit V: uroe V; forstyrre V _ forstyrre V, sjenere V _ 
rihkkut V: overskride V; bryte V _ overtre V, bryte V, misligholde V _ 
rasttildit V: overskride V; passere V; krysse V _ krysse V _ 
sirdit V: omdisponere V; overføre V; flytte V _ flytte V _ 
ásaiduvvat V: bosette V _ begynne å føle seg hjemme V, slå seg ned V _ 
ássat V: bosette V; bo V _ bo V _ 
vuođđudit V: konstituere V; oppnevne V; bygge V; etablere V; opprette V _ grunnlegge V _ 
ájihit V: forsinke V; forhindre V _ hefte bort V _ 
maŋŋonit V: forsinke V _ bli forsinket V _ 
čiekŋudit V: utdype V; fordype V _ fordype V _ 
darvehit V: fange V; klistre V _ feste V, klistre V, klebe V _ 
lonohallat V: utveksle V; bytte V; skifte V _ skifte V; bytte med hverandre V _ 
lonuhit V: utveksle V; bytte V; skifte V _ heve V; bytte V _ 
oadjudit V: trygge V _ gjøre trygg V _ 
duođaštit V: dokumentere V; attestere V; bekrefte V _ bekrefte V, bevitne V, attestere V; godtgjøre V _ 
rahčat V: anstrenge V; slite V; kjempe V _ streve V _ 
beasahit V: sleppe V; miste V _ miste V _ 
bilidit V: skjemme V; skade V; ødelegge V _ ødelegge V _ 
goallostit V: lenke V _ binde sammen etter hverandre V _ 
vuodjat V: påkjøre V; svømme V _ svømme V _ 
bassat V: rundvaske V; vaske V _ vaske V _ 
ávkkuhit V: monne V _ nytte V, gagne V _ 
goddit V: felle V; myrde V; drepe V _ drepe V _ 
báhčit V: felle V; skyte V; stikke V _ skyte V; stikke V _ 
njeaidit V: felle V; sprenge V; redusere V _ velte V _ 
rivvet V: frata V; røve V _ røve V, ta med makt V; tackle V _ 
manahit V: frata V; miste V; fjerne V _ miste V _ 
atnit V: anse V; benytte V; bruke V _ bruke V; anse for V; inneha V _ 
cegget V: stille V; etablere V; opprette V _ reise opp V _ 
luoitit V: overlate V; slippe V; løse V _ slippe V, løse V _ 
fievrridit V: overføre V; videreføre V; føre V; frakte V; eksportere V _ frakte V, ha med seg V _ 
luvvet V: frigi V; frita V; løse V _ løse V _ 
sierranit V: separere V; skilles V; skille V _ skilles V, skille seg ut V _ 
vuoitit V: overkomme V; vinne V _ vinne V _ 
boradit V: lunsje V; spise V _ spise V, ete V, ha et måltid V _ 
guhkidit V: prolongere V; forlenge V _ forlenge V _ 
ságastit V: orde V; tale V; snakke V _ samtale V _ 
álggahit V: iverksette V; starte V; opprette V _ få i gang V _ 
vásihit V: oppleves V; oppleve V _ erfare V, oppleve V _ 
smiehttat V: reflektere V; tenke V _ tenke V, fundere V _ 
joatkit V: videreføre V; fortsette V _ skjøte V; fortsette V _ 
vuolláičállit V: signere V; underskrive V _ underskrive V _ 
doahttalit V: overholde V; respektere V _ akte V, ta hensyn til V _ 
čuovvut V: overholde V; følge V _ følge V _ 
doallat V: overholde V; avholde V; abonnere V; holde V; holde V; holde V _ holde V _ 
máksit V: utbetale V; bety V; belaste V; betale V _ betale V; koste V; bety V _ 
deavdit V: oppfylle V; fylle V _ fylle V _ 
ollašuhttit V: oppfylle V; gjennomføre V; fullføre V _ fullføre V _ 
ollašuvvat V: oppfylle V; oppnå V _ gjennomføres V _ 
sárgut V: skissere V; tegne V _ streke V, tegne V, risse V _ 
seaivut V: ankomme V; lande V _ dale ned V; sveve V _ 
dubmehallat V: domfelle V _ bli dømt V _ 
dubmet V: domfelle V; dømme V _ dømme V _ 
dovddahit V: signalisere V; uttrykke V _ røpe V _ 
ipmirdit V: begripe V; skjønne V; oppfatte V; forstå V _ forstå V, skjønne V _ 
buktit V: overlevere V; bringe V; medføre V _ bringe V _ 
gaskkustit V: overlevere V; formidle V _ formidle V _ 
sirdašuvvat V: forskyve V _ flytte på seg V _ 
sárdnidit V: forkynne V; preke V; tale V _ preke V, tale V _ 
čállit V: protokollføre V; skrive V _ skrive V, notere V; rispe V; råskjære fisk V _ 
diđoštit V: befare V _ innhente opplysninger V, få klarhet i V _ 
barggahit V: aktivisere V _ sysselsette V _ 
nágget V: insistere V; påstå V _ krangle V; påstå V _ 
bissehit V: opphøre V; stoppe V; stanse V; undergrave V _ stoppe V _ 
bagadallat V: veilede V; beskrive V; instruere V _ beskrive V; instruere V _ 
bagadit V: veilede V; oppdra V; refse V; instruere V _ oppdra V, rettlede V; straffe V, refse V _ 
heaittihit V: nedlegge V; avslutte V; avvikle V; oppheve V _ avslutte V; avvikle V _ 
bávkalit V: sprenge V; smelle V _ smelle V, fyre av V _ 
cuvket V: sprenge V _ knuse V; veksle V _ 
vurket V: arkivere V; oppbevare V; lagre V _ oppbevare V; lagre V _ 
nannet V: lovfeste V; styrke V; bekrefte V; sikre V _ styrke V; bekrefte V _ 
jođihit V: ledes V; føre V; dominere V; drive V; lede V _ lede V, styre V _ 
guoddalit V: anke V; påklage V; anklage V _ klage på V, anklage V _ 
čatnat V: knyte V; binde V; knytte V _ binde V, forbinde V, kople V _ 
vuolidit V: avkorte V; redusere V _ senke V _ 
áidut V: gjerde V _ inngjerde V _ 
namuhit V: tilføre V; omtale V; nevne V _ nevne V _ 
bálkáhit V: premiere V; engasjere V; leie V; betale V _ ansette V; leie V; betale V _ 
dásset V: balansere V; utjevne V; stabilisere V _ jamne V, jevne V; stabilisere V _ 
molsašuddat V: variere V _ bli forandret V _ 
čielggadit V: utrede V; avklare V; forklare V _ forklare V _ 
jevdet V: utjevne V _ jevne ut V _ 
ráhkadit V: utarbeide V; lage V; skape V _ lage V _ 
ráhkadahttit V: utarbeide V _ få noen til å lage V _ 
viššat V: tørre V; tore V; orke V _ orke V, gidde V _ 
duostat V: tørre V; våge V; tore V _ våge V, tore V _ 
geasehit V: transportere V; kjøre V; frakte V _ kjøre V, frakte V _ 
illastit V: torturere V _ mishandle V _ 
deattašit V: taste V; trykke V _ trykke V _ 
goaridit V: svekke V; tappe V; undergrave V _ vanskjøtte V _ 
hedjonit V: svekke V _ bli svak V _ 
riidit V: stride V; forhindre V; nekte V _ nekte V; forhindre V _ 
njáhkat V: snike V _ smyge V _ 
njágahit V: snike V _ liste seg til noe V _ 
sivahallat V: skylde V; påtale V; beskylde V; anklage V _ anklage for V, påtale V _ 
šiggut V: skjelle V _ hysse på V _ 
lápmašuvvat V: skamslå V; skade V _ bli vanfør V, bli skadet V _ 
buhtistit V: rengjøre V; rense V _ reingjøre V, rense V _ 
čuohcat V: ramme V; påvirke V; berøre V _ påvirke V, berøre V _ 
jáhkihit V: overbevise V _ få til å tro V _ 
eattehit V: opprøre V _ bli sint V _ 
movttáskit V: oppløfte V _ bli glad V, bli oppmuntret V _ 
boltut V: oppkjøre V; brøyte V _ rote opp V, grave opp V _ 
fáhtet V: oppfange V _ få tak i V _ 
lahkanit V: nærme V _ nærme seg V _ 
lahkonit V: nærme V _ nærme seg V _ 
deaivat V: møte V; treffe V; treffe V _ treffe V _ 
deaivvadit V: møte V; treffe V; møtes V _ møtes V _ 
gávnnadit V: møte V; møtes V _ møtes V _ 
duostut V: møte V _ ta imot V _ 
dustet V: møte V; dempe V _ dempe V; ta imot V _ 
deaividit V: møte V _ inntreffe V _ 
muittuhit V: minne V _ påminne V, minne om V _ 
nagadit V: makte V; klare V _ greie V, klare V _ 
gielistit V: lyve V; lyge V _ lyge V _ 
ealihit V: livnære V _ livberge V _ 
gillát V: lide V; tåle V _ tåle V, holde ut V _ 
biidnašuvvat V: lide V _ pines V _ 
gárrut V: kvie V _ få seg til å gjøre noe V _ 
fuomášit V: konstatere V; oppdage V; merke V _ oppdage V _ 
gávnnahit V: konstatere V; finne V _ finne ut V _ 
jávohuhttit V: kneble V _ få til å tystne V _ 
gárvodit V: kle V _ kle på seg V _ 
nuoladit V: kle V _ kle av seg V _ 
čoalkit V: klapre V; banke V _ knakke V, banke V _ 
bálkásit V: kassere V _ gå til spille V _ 
sahet V: kappe V; sage V _ sage V _ 
áimmahuššat V: ivareta V _ holde i hevd V, ta vare på V _ 
vuhtiiváldit V: ivareta V _ ta hensyn til V _ 
fuolahit V: ivareta V; sørge V _ sørge for V _ 
fátmmastit V: involvere V; omfavne V; omfatte V _ omfavne V _ 
sorrat V: involvere V _ vase sammen V _ 
hoahpuhit V: intensivere V; forsere V _ påskynde V _ 
huikit V: hoie V; rope V _ rope V _ 
hehttet V: hemme V; forhindre V; forebygge V; holde V; hindre V _ hindre V, forhindre V _ 
speadjalastit V: gjenspeile V _ avspeile V _ 
buvttihit V: føre V; nå V; skape V _ rekke V, nå V _ 
vearránit V: forverre V _ bli verre V _ 
hálddašit V: forvalte V; beherske V; betjene V; administrere V _ rå over V; administrere V; beherske V; betjene V _ 
eaktudit V: forutsette V _ ta forbehold V _ 
válbmet V: ferdigstille V; fullføre V _ gjøre ferdig V _ 
ohcalit V: etterspørre V; etterlyse V; søke V; savne V _ savne V, lengte etter V _ 
jearahit V: etterspørre V; intervjue V; spørre V _ intervjue V, spørre V _ 
váillahit V: etterlyse V; savne V _ savne V _ 
smiehtadit V: dvele V; tenke V _ tenke V, gruble V _ 
rámidit V: berømme V _ rose V, prise V _ 
rábmot V: berømme V; skryte V _ skryte V; rose V _ 
mearkkašit V: bemerke V; bety V; innebære V _ merke seg V, notere V; bety V _ 
váivašuvvat V: bekymre V _ plages V _ 
vuorjašuvvat V: bekymre V _ plages V _ 
vuosttaldit V: bekjempe V _ protestere V, motarbeide V, opponere mot V _ 
illosit V: begeistre V _ bli glad V _ 
várret V: avsette V _ advare V; sette av V _ 
čielgat V: avklare V _ klarne V, bli klar V _ 
vuoddját V: kjøre avsted V _ kjøre av sted V _ 
girdilit V: fly V _ fly avgårde V _ 
nanosmahttit V: styrke V; forsterke V _ styrke V, forsterke V _ 
vuorjat V: plage V _ plage V, sjenere V _ 
váivvidit V: plage V _ plage V, bry med V _ 
givssidit V: plage V; mobbe V _ mobbe V, plage V, pine V _ 
iskat V: prøve V; undersøke V _ undersøke V, prøve V _ 
viggat V: prøve V; forsøke V _ prøve V, streve V _ 
geahččaladdat V: prøve V; eksperimentere V _ eksperimentere V _ 
suhkat V: ro V _ ro V; gynge V _ 
suvdit V: ro V _ ferge V, frakte i båt V _ 
šiehtadit V: avtale V; forhandle V _ avtale V _ 
šiehttat V: avtale V _ få plass V; bli enig V _ 
stoahkat V: leke V _ støye V; leke V _ 
fierrat V: rulle V _ rulle V; rase ned V _ 
jorrat V: rulle V _ dreie V, gå rundt V _ 
fieradit V: rulle V _ rulle V, tumle V _ 
fierralit V: rulle V _ rulle V; dette V, falle overende V _ 
čohkohallat V: sitte V _ holde på å sitte V _ 
jurddašit V: tenke V; mene V _ tenke V _ 
jurdilit V: tenke V _ tenke en tanke V _ 
almmuhit V: publisere V; utgi V; kunngjøre V; opplyse V _ publisere V, gi ut V; deklarere V; bekjentgjøre V _ 
bivdit V: anmode V; fiske V; be V _ fiske V, jakte V; be V, anmode V _ 
ávžžuhit V: anmode V; oppfordre V; utfordre V; anbefale V _ oppfordre V _ 
ordnet V: sortere V; ordne V _ ordne V; sortere V _ 
sirret V: sortere V; skille V; isolere V _ skille V, sortere V _ 
čuoldit V: sortere V; skille V _ skille V, sortere V; veve bånd V _ 
boaibmut V: sortere V; plukke V _ plukke V, pille V; sortere V _ 
bovdet V: invitere V _ invitere V, innby V _ 
hástit V: invitere V; oppfordre V; utfordre V _ utfordre V, oppfordre V _ 
buhtadit V: kompensere V; erstatte V _ kompensere V, refundere V _ 
buhttet V: kompensere V; erstatte V _ erstatte V _ 
bágget V: tvinge V; presse V _ tvinge V _ 
bággehallat V: tvinge V _ tvinges V _ 
caggat V: forhindre V; hindre V _ støtte opp V; forhindre V _ 
heađuštit V: forhindre V; avverge V; undergrave V; hindre V _ forhindre V, avverge V _ 
coggat V: putte V _ putte V, stappe V; kle på seg V _ 
coggalit V: putte V _ putte fort V; kle på seg fort V _ 
nahkehit V: putte V; stikke V _ putte V, stikke V _ 
cábadit V: makulere V _ skjære i små biter V; makulere V _ 
dahppat V: stenge V _ stenge V, lukke V _ 
giddet V: stenge V; montere V _ feste V _ 
liibmet V: klistre V; lime V _ lime V _ 
ovdandoallat V: fremheve V _ anføre V, framholde V _ 
doadjit V: knekke V; bryte V _ knekke V, bryte V _ 
doaibmat V: fungere V; utføre V _ fungere V _ 
doaivut V: håpe V; tro V; anta V _ håpe V; tro V _ 
sávvat V: håpe V; ønske V _ ønske V _ 
doarrut V: stange V; slåss V; kjempe V _ stange V; slåss V _ 
nordat V: stange V _ puffe V, støte V _ 
duvdit V: fortrenge V; skyve V; tilsidesette V _ støtte V; puffe V; fortrenge V _ 
muktit V: overprøve V; forandre V; endre V _ endre V, forandre V _ 
eastadit V: forebygge V; unngå V; hindre V _ hindre V; forebygge V _ 
galmmihit V: fryse V _ avkjøle V _ 
finadit V: besøke V _ stikke innom V _ 
botket V: avbryte V; bryte V; skille V _ bryte V, slite av V; slite seg løs V _ 
unnut V: minske V; redusere V _ minske V, bli mindre V _ 
geahpedit V: minske V; lette V; redusere V _ lette V, minske V _ 
geahpidit V: minske V; lette V; redusere V _ lette V, minske V _ 
uhccut V: minske V _ bli mindre V, minske V _ 
hoahkat V: gjenta V _ ymte om at en vil V; gjenta V _ 
geardut V: gjenta V _ gjenta V; multiplisere V _ 
geardduhit V: gjenta V _ repetere V _ 
vuojihit V: kjøre V; frakte V _ frakte V _ 
gohččut V: innkalle V; be V; pålegge V _ be V, befale V; innkalle V; pålegge V _ 
golahallat V: fordrive V _ forbruke V _ 
gudnejahttit V: hedre V _ ære V, hedre V _ 
gulahallat V: kommunisere V _ forstå hverandre V; kommunisere V _ 
guldalit V: høres V; lytte V; høre V _ lytte V; kjenne etter V; teste V _ 
guossohit V: servere V _ traktere V, servere V _ 
gáldet V: gjelde V; kastrere V _ gjelde V, kastrere V _ 
guoskat V: gjelde V; berøre V _ komme bort i V; angå V _ 
gádjut V: redde V _ berge V, redde V _ 
suddjet V: redde V; beskytte V _ beskytte V _ 
gáidat V: forsvinne V _ vike V, forsvinne V _ 
healbat V: forsvinne V _ forbli V _ 
gálašit V: vasse V _ vasse V; bade V _ 
gáržžidit V: innskrenke V; begrense V; redusere V _ innskrenke V _ 
gáržut V: innskrenke V _ bli trang V, innskrenket V _ 
heahpanit V: skjemmes V _ skamme seg V, skjemmes V _ 
luohpat V: slutte V; gå V _ slutte V, gi opp V _ 
loahpahit V: avslutte V; sluttføre V _ avrunde V, sluttføre V _ 
biehttalit V: avslå V; avvise V; nekte V _ gi avslag V; nekte for V _ 
máhttit V: beherske V _ kunne V _ 
bálvalit V: betjene V; tjene V _ tjene V _ 
hárdit V: erte V; terge V; mobbe V _ erte V, terge V _ 
hárjehaddat V: øve V; trene V _ øve V, trene V _ 
hárjehallat V: øve V; trene V _ trene V _ 
ijastallat V: overnatte V; sove V _ overnatte V _ 
ihtit V: fremkomme V; synes V _ vise seg V, komme til syne V, fremkomme V _ 
áddet V: skjønne V; oppfatte V; forstå V _ forstå V _ 
jorgalit V: oversette V _ oversette V; snu noe V; snu V; omvende V; gjøre et notkast V _ 
jorgalahttit V: oversette V; snu V _ få til å snu V; få oversatt V _ 
máhccat V: snu V; komme V _ snu V, vende tilbake V _ 
lohkat V: lese V; telle V; studere V; si V _ lese V; telle V; si V _ 
logadit V: lese V; studere V _ lese lenge V _ 
oalgguhit V: oppmuntre V; stimulere V _ oppmuntre V, friste V _ 
movttiidahttit V: oppmuntre V; inspirere V; motivere V; stimulere V _ oppmuntre V, motivere V _ 
muddet V: moderere V; regulere V; justere V _ korrigere V, moderere V; regulere V _ 
njammat V: absorbere V _ suge V, patte V, sutte V; absorbere V _ 
njoarrat V: tappe V; skjenke V _ skjenke V, tappe V _ 
nohkkat V: sovne V _ sovne V; sove V _ 
čaibmat V: le V _ le V, flire V _ 
boagustit V: le V _ le V, flire V _ 
bohkosit V: le V _ sette i å le V _ 
ovddastit V: representere V _ forestå V; representere V _ 
ovddidit V: fremme V; utvikle V _ fremme V; gå for fort V _ 
ovdanbuktit V: fremme V; presentere V; uttrykke V _ legge fram V, presentere V _ 
rádjat V: oppbevare V; lagre V; ordne V _ ta vare på V, oppbevare V; ordne V _ 
ráđđádallat V: konsultere V; drøfte V _ drøfte V, konferere med V, konsultere V _ 
šohkut V: puste V; blåse V _ puste V, blåse V _ 
sahkat V: puste V _ puste V, pese V _ 
bosihastit V: puste V _ puste ut V _ 
seaguhit V: blande V _ blande V; legere V _ 
seahkanit V: blande V _ bli blandet V, rotet V; bli sinnsforvirret V _ 
áššáskuhttit V: påtale V; saksøke V; anklage V _ skylde på V, anklage V _ 
sorbmet V: myrde V; drepe V _ myrde V, drepe V _ 
stajidit V: herje V _ herje V, plyndre V _ 
speadjat V: herje V _ plyndre V, herje V _ 
rigeret V: herje V _ bråke V _ 
rievidit V: stjele V; røve V _ røve V _ 
vajálduhttit V: overse V; glemme V _ overse V, glemme V _ 
vavdat V: stamme V; stotre V _ stamme V, stotre V; bli sittende fast V _ 
viežžat V: hente V; innhente V _ hente V; laste ned V _ 
viežžalit V: hente V _ hente fort V, hente noe som ikke er langt borte V _ 
vuojehit V: jage V; drive V _ drive V, jage V _ 
ádjit V: jage V; drive V _ jage V, drive V _ 
oaguhit V: jage V; forfølge V _ forfølge V _ 
ásahit V: innrette V; ordne V; etablere V; opprette V; innføre V _ etablere V; ordne V, innrette V _ 
feret V: innrette V; oppleve V _ oppleve V _ 
čoagganit V: samles V; samle V _ samles V _ 
čoahkkanit V: samles V; møtes V; samle V _ samles V _ 
čohkket V: samles V; montere V; innhente V; samle V _ samle V; montere V _ 
čoavdit V: frita V; løse V _ løse V, låse opp V; frita V _ 
čálihit V: skrive V; skrive V; registrere V; innmelde V _ la skrive V, skrive ut V; la seg registrere V; ta ut lysning V _ 
gilvit V: dyrke V; så V; sette V; spre V _ så V, plante V _ 
guovlladit V: kikke V _ kikke V, kaste et blikk på V _ 
guovlalit V: kikke V _ titte i all hast V _ 
buđaldit V: oppholde V _ pusle V _ 
coahkkalit V: klikke V; smelle V _ smelle V, klikke V _ 
deaddilit V: klikke V; trykke V _ trykke V, klemme V _ 
álgit V: starte V; begynne V _ begynne V _ 
ohcat V: søke V _ leite V _ 
geavahit V: benytte V; bruke V _ bruke V _ 
albmadit V: melde V _ melde til øvrigheten V _ 
vikkahit V: forsøke V _ forsøke V, prøve å få til noe V _ 
nagodit V: bestå V; klare V _ klare V _ 
ceavzit V: bestå V; bestå V; holde seg V; overleve V _ holde seg V, klare seg V _ 
seailut V: bestå V; bevare V; overleve V _ bevares V; klare seg V _ 
dohkket V: godkjenne V _ duge V _ 
čuohpadit V: operere V _ skjære seg V, hogge seg V _ 
dihttot V: forekomme V _ vise seg V _ 
čiehkádit V: gjemme V _ gjømme seg V _ 
skirvehit V: svinge V _ svinge brått V _ 
soardit V: såre V; såre V _ undertrykke V; skamfere V _ 
láibut V: bake V _ bake brød V _ 
gáhkket V: bake V _ bake kake V _ 
bohčit V: pumpe V; melke V _ melke V, klemme V _ 
staigat V: avta V _ slå seg til ro V; avta V _ 
diŋgot V: abonnere V; bestille V _ bestille V _ 
divodit V: restaurere V _ reparere V _ 
divvut V: restaurere V; rette V; justere V _ reparere V, rette på V _ 
jeđđet V: berolige V; trøste V _ trøste V _ 
garvit V: fravike V; unngå V _ unngå V _ 
dahkaluddat V: agere V _ late som V; gjøre seg til V _ 
loktet V: løfte V; heve V _ løfte V _ 
váidalit V: klage V; beklage V _ klage V, beklage V _ 
sihtat V: ønske V; be V _ ville ha V, ønske V _ 
dáhttut V: ønske V; be V _ ville V, ønske V _ 
bahčit V: melke V _ melke V; sentrifugere V _ 
jáhkkit V: tro V; anta V _ tro V, anta V _ 
gáddit V: tro V; anta V _ tro V, anta V _ 
bindit V: vare V; holde seg V _ vare V, holde seg V _ 
láidet V: leie V; lede V _ leie V _ 
báhtarit V: rømme V _ flykte V, rømme V _ 
sálket V: tømme V _ tømme V; tappe V _ 
vuojadit V: svømme V _ svømme V, bade V _ 
šearrát V: glitre V; skinne V; lyse V _ lyse V, skinne V, glitre V _ 
rievdadit V: forandre V; endre V _ forandre V _ 
nuppástuhttit V: forandre V; tilpasse V; endre V _ forandre V, omstille V _ 
fillehallat V: bli forledet V _ bli forledet V, bli narret V _ 
duolbmut V: tråkke V _ tråkke V, trø V _ 
šulšet V: tråkke V _ tråkke V, lage spor V _ 
čuovgat V: skinne V; lyse V _ skinne V, lyse V; belyse V _ 
šealgát V: skinne V _ glinse V, skinne V _ 
báittašit V: skinne V; lyse V _ skinne V, lyse V _ 
borrat V: spise V _ spise V, ete V; etse V _ 
ballat V: frykte V _ frykte V, være redd V _ 
buorrestit V: omfavne V _ klemme V, omfavne V _ 
sallut V: omfavne V _ favne V; omfavne V _ 
bajásšaddat V: vokse opp V; vokse V _ vokse opp V _ 
gažadit V: intervjue V; spørre V _ spørre V, intervjue V _ 
gulaskuddat V: spørre V _ forhøre seg V, spørre V _ 
goarránit V: vantrives V _ vantrives V, visne V _ 
hommát V: arbeide V _ sysle V, arbeide V _ 
dahkat V: gjøre V; skape V _ gjøre V; lage V _ 
čákŋat V: krype V _ krype V, smyge inn i V _ 
guokkardit V: krype V _ gå på alle fire - på hender og føtter V _ 
massit V: miste V; tape V _ miste V _ 
bisánit V: stoppe V _ stoppe V; feste seg V _ 
orustit V: stoppe V; stanse V _ stanse V, stoppe V _ 
čuoččastit V: stoppe V _ reise seg V; stoppe V; stille seg V _ 
notkat V: stoppe V _ stoppe V, dytte igjen V _ 
bisuhit V: beholde V; bevare V; opprettholde V _ beholde V _ 
boaldit V: brenne V _ brenne V; svi V _ 
suovastit V: røyke V _ ryke V; røyke V _ 
goaivut V: grave V _ grave V, måke V, spa V _ 
burgit V: grave V _ rote V, grave V; demontere V _ 
skurbat V: grave V _ pirke V, grave V _ 
bálkkašit V: belønne V _ gjengjelde V; belønne V _ 
lotnut V: betale V _ betale V, løse ut V _ 
cahkkehit V: tenne V; fyre V _ tenne V _ 
coahkut V: synke V _ minke V, synke V _ 
dearpat V: banke V; slå V _ slå V, banke V _ 
huškut V: banke V; slå V _ slå V, banke V _ 
cábmit V: banke V; slå V _ slå V, banke V _ 
čoalkalit V: banke V _ banke V, knakke V _ 
goalkalit V: banke V _ banke V, knakke V _ 
darrat V: skjelve V; riste V _ skjelve V, riste V _ 
libaidit V: skjelve V _ bevre V, skjelve V; glimte V _ 
livzzistit V: skjelve V _ vakle V; skjelve V _ 
diehtit V: vite V; kjenne V _ vite V _ 
diggot V: bestille V; diskutere V _ bestille V; diskutere V, trette V; føre rettsak V _ 
diktit V: tillate V _ la V; tillate V _ 
suovvat V: tillate V _ tillate V, gi lov V _ 
doddjot V: brekke V _ brekke V, gå av V _ 
doidilit V: skylle V _ skylle V, skylle fort V _ 
dutkat V: granske V; studere V _ granske V, forske V _ 
dárbbašit V: trenge V _ behøve V, trenge V _ 
dávistit V: svare V _ svare V, gi gjenlyd V, gi respons V, reagere på V _ 
vanahit V: tøye V; dra V; strekke V _ strekke V, tøye V _ 
muosáhit V: oppleve V _ smake V; oppleve V _ 
heivet V: passe V _ høve V, passe V _ 
soahpat V: passe V _ passe V, høve V; bli enig V _ 
fáktet V: passe V _ passe V, vokte V _ 
ruohkkat V: klore V _ klø V, klore V _ 
gaccastit V: klore V _ spise en skjefull V; klore V _ 
rámpostit V: skryte V _ rose V, skryte V _ 
gerret V: skryte V _ rose V, skryte V _ 
rámpot V: skryte V _ rose V; skryte V _ 
gieldit V: forby V; nekte V _ forby V, nekte V _ 
muollat V: brøle V _ belje V, brøle V _ 
gilljut V: brøle V _ hyle V, brøle V _ 
čeargut V: brøle V; rope V _ brøle V; tordne V _ 
čerget V: brøle V _ brøle V; tordne V _ 
giljádit V: brøle V _ hyle V, brøle V _ 
veadjit V: orke V _ orke V, greie V; kanskje adv _ 
gohčodit V: kalle V; definere V _ kalle V, betegne V _ 
goikadit V: tørke V _ tørke V; steke V _ 
golgat V: renne V; drive V; drive V _ renne V; reke V; drive V _ 
čierastit V: renne V _ renne V, ake V _ 
čierastallat V: renne V _ renne V, ake V _ 
govvet V: fotografere V; illustrere V _ fotografere V _ 
gávppašit V: handle V _ handle V, drive handel V _ 
háisut V: lukte V _ lukte V, stinke V _ 
háleštit V: prate V; snakke V _ prate V, snakke sammen V _ 
humadit V: prate V; snakke V _ prate V _ 
hábmet V: utforme V; skape V _ utforme V _ 
hálahit V: overtale V; påvirke V _ overtale V _ 
hávdádit V: begrave V; gravlegge V _ begrave V _ 
čuodjat V: lyde V; ringe V _ klinge V, ringe V, lyde V _ 
jeagadit V: lyde V _ lyde V, lystre V _ 
juohkit V: dele V; spre V; fordele V; tildele V _ dele V _ 
juogadit V: dele V; fordele V; tildele V _ dele V; dele ut V _ 
juolludit V: bevilge V; gi V; tildele V _ avse V; bevilge V _ 
leiket V: skjenke V _ skjenke V, helle V _ 
leaikut V: skjenke V _ skjenke V, helle V _ 
loaktit V: trives V _ forbruke V; trives V _ 
lágidit V: ordne V; arrangere V; lage V _ stelle V, ordne V; arrangere V _ 
stellet V: ordne V; plassere V _ stelle V, ordne V, plassere V _ 
maŋidit V: utsette V _ utsette V; saktne V _ 
mieđuštit V: ledsage V; følge V _ ledsage V, følge V _ 
muitit V: huske V; minnes V _ huske V, minnes V _ 
máhccut V: brette V _ brette V; bukke V _ 
njuovvat V: slakte V _ slakte V, flå V _ 
njuvdit V: smøre V _ kline V, smøre V _ 
čuoččuhit V: påstå V; hevde V _ hevde V, påstå V _ 
návddašit V: nyte V _ nyte V, smake V _ 
vealahit V: diskriminere V _ diskriminere V; berøve V _ 
olgguštit V: diskriminere V; tilsidesette V _ diskriminere V, tilsidesette V _ 
orrut V: bo V; synes V _ være V, bli V; bo V; synes V _ 
šaddat V: fødes V; komme V; vokse V _ vokse V; fødes V; bli V; komme til å V _ 
riegádit V: fødes V; føde V _ fødes V _ 
viehkat V: løpe V; springe V _ løpe V _ 
ruohttat V: løpe V; springe V _ løpe V _ 
ráhkistit V: elske V _ elske V, være glad i V _ 
suodjalit V: beskytte V; bevare V; verne V; sikre V _ verne V, beskytte V _ 
várjalit V: beskytte V; forsvare V _ forsvare V, beskytte V _ 
vajáldahttit V: glømme V; glemme V _ glømme V _ 
ávvudit V: feire V; markere V _ feire V; fryde seg V _ 
gođđit V: binde V; knytte V _ strikke V; veve V; binde, knytte V _ 
čiekčat V: sparke V _ spenne V, sparke V _ 
čievččastit V: sparke V _ sparke V, spenne V _ 
čábbudit V: pynte V _ gjøre penere V, pynte V _ 
čorget V: rydde V _ gjøre reint V, rydde V, stelle V _ 
ákkastallat V: argumentere V; begrunne V _ argumentere V _ 
libardit V: vaie V _ flagre V, vaie V _ 
fállat V: tilby V _ tilby V, by på V _ 
doarjut V: støtte V _ støtte V, gi tilslutning til V _ 
čuožžilit V: oppstå V _ reise seg V _ 
beroštit V: interessere V _ bry seg om V _ 
seastit V: spare V; redusere V _ spare V _ 
bealuštit V: forsvare V _ forsvare V; forfekte V; ta part V _ 
ferdnet V: male V _ male V, kverne V _ 
suddat V: smelte V _ smelte V, tine V _ 
vuohčut V: smelte V _ piple V; smelte V _ 
guođđit V: forlate V _ forlate V, etterlate V _ 
guođđilit V: forlate V _ forlate V, etterlate V _ 
gaivát V: glane V; se V _ glane V, glo V _ 
gávkat V: glane V _ glane V, glo V _ 
olahit V: nå V; nå V; oppnå V _ rekke V, nå V _ 
joksat V: nå V; nå V; innhente V; oppnå V _ innhente V _ 
juksat V: nå V; nå V; oppnå V _ nå igjen V _ 
ollit V: nå V; strekke V _ nå V, rekke V _ 
noddet V: nå V _ nå V, rekke V _ 
oamastit V: eie V _ tilegne seg V; eie V _ 
riegádahttit V: føde V _ føde V, nedkomme V _ 
vadjat V: klippe V _ klippe V, skjære V; lokke V _ 
ofelastit V: følge V _ vise veg V, guide V _ 
dádjadit V: finne V _ finne fram V _ 
merkot V: merke V _ legge merke til V _ 
dárkot V: merke V; undersøke V; observere V _ betrakte V, undersøke V _ 
vávjit V: merke V; mistenke V; kritisere V _ mistenke V; kritisere V _ 
vuohttit V: merke V _ finne spor V, følge spor V _ 
mannat V: reise V; dra V; gå V _ gå V, dra V, reise V _ 
johtit V: reise V; flytte V _ bevege seg V; reise V; flytte V _ 
vuolgit V: reise V; dra V _ dra V, reise av sted V _ 
mátkkoštit V: reise V; ferdes V _ reise V, ferdes V _ 
čuoččahit V: reise V _ reise seg V; stille seg V _ 
oahppat V: lære V _ lære V; se etter fangst V _ 
goargŋut V: stige V; øke V _ klatre V; stige V; stake elvebåt V _ 
lassánit V: stige V; øke V _ øke V _ 
časkit V: slå V; slå V _ slå V _ 
speažžut V: slå V _ daske V, slå V _ 
meaidit V: slå V; hogge V _ slå V, hogge V, meie V _ 
šávget V: slå V _ slå V, helle V _ 
šávgut V: slå V _ slå V, helle V _ 
roaškut V: slå V; smelle V _ slå V, smelle V _ 
sárdnut V: tale V; snakke V _ tale V _ 
ságastallat V: tale V; diskutere V _ snakke sammen V _ 
vahágahttit V: skade V; ødelegge V _ skade V _ 
roasmmuhuvvat V: skade V _ bli skadet V, skade seg V _ 
deaddit V: presse V; veie V; trykke V _ trykke V, presse V; veie V _ 
bahkket V: presse V _ trenge på V, trenge seg fram V; presse V; være nærgående V _ 
geahččat V: se V _ se V, se på V _ 
geahčadit V: se V _ forhåndsgranske V _ 
guovlat V: se V _ kike V, titte V _ 
rahpat V: åpne V _ åpne V, lukke opp V _ 
rabastit V: åpne V _ åpne V, lukke opp V _ 
rabestit V: åpne V _ åpne V, lukke opp V _ 
leahkkut V: åpne V _ åpne V, lukke opp V _ 
leahkastit V: åpne V _ åpne V, lukke opp V _ 
rahpasit V: åpne V _ åpne seg V _ 
guoskkahit V: røre V; berøre V; omtale V _ røre V, berøre V _ 
lihkahit V: røre V; røre V _ røre V, bevege V _ 
lihkastit V: røre V _ bevege V, røre V _ 
njuorasmahttit V: røre V _ ydmyke V _ 
beaškit V: smelle V _ smelle V; slamre V _ 
beaškkihit V: smelle V _ smelle V; kollidere V _ 
spoahkkalit V: smelle V _ smelle V, smekke V _ 
bidjat V: sette V; sette V; sette V; plassere V _ sette V; legge V _ 
bidjalit V: sette V _ legge V, sette V _ 
bordit V: sette V _ stable V _ 
gárvvistit V: forberede V _ forberede V, gjøre klar V _ 
ráhkkanahttit V: forberede V _ utruste V, forberede V _ 
ráhkkanit V: forberede V _ gjøre seg klar V _ 
hásttuhit V: oppfordre V; utfordre V _ oppfordre V, utfordre V _ 
iskkadit V: undersøke V _ undersøke V, holde på å forsøke V _ 
dollet V: holde V; stanse V _ gripe V, ta et tak V; stanse V; konfiskere V; dra V _ 
doalahit V: holde V; opprettholde V _ holde V, fortsette V; la være V _ 
mielddisbuktit V: medføre V; innebære V _ medføre V _ 
gárget V: utvikle V _ vikle opp V, rekke opp V _ 
ovdánit V: utvikle V _ utvikle seg V, gå framover V, avansere V _ 
skeŋket V: gi V _ forære V, gi V _ 
lávet V: bruke V _ pleie V, bruke V _ 
golahit V: bruke V _ bruke V, forbruke V _ 
ávkkástallat V: bruke V; utnytte V _ utnytte V _ 
balahit V: mistenke V _ engste seg for noe V; mistenke V _ 
biehtadit V: nekte V _ nekte V; benekte V _ 
birget V: klare V; overleve V _ greie seg V _ 
billistit V: ødelegge V; undergrave V _ ødelegge V _ 
billašuvvat V: ødelegge V _ bli ødelagt V _ 
bissut V: holde seg V; fortsette V _ forbli V, holde seg V _ 
lávdat V: spre V _ spre seg utover V _ 
soaitit V: komme V _ kanskje adv; tilfeldigvis komme til å V _ 
ollet V: komme V _ nå fram V _ 
joavdat V: komme V _ nå fram V _ 
ilbmat V: komme V _ utkomme V _ 
čoaggit V: plukke V; samle V _ plukke V _ 
gaskit V: plukke V _ ribbe V, plukke V _ 
navvit V: plukke V _ pirke V, plukke V _ 
murjet V: plukke V _ plukke bær V _ 
lubmet V: plukke V _ plukke molter V _ 
gággat V: bryte V _ bryte V, velte V _ 
fággádit V: bryte V _ bryte V, ta tak V _ 
heaibut V: bryte V _ bryte V, ta tak V _ 
boatkanit V: bryte V _ bryte sammen V; slites av V _ 
jorahit V: vri V _ rotere V _ 
viehkalit V: stikke V; springe V _ løpe avgårde V _ 
čuohcit V: påvirke V; berøre V _ påvirke V, berøre V _ 
suhppet V: kaste V; kaste V _ kaste V; sette ut V _ 
suohpput V: kaste V; kaste V _ kaste V; sette ut garn, line, not V _ 
njoarostit V: kaste V _ kaste lasso V _ 
cancut V: springe V _ springe V, sprette V _ 
jietnadit V: si V; uttale V _ gi lyd fra seg V _ 
jienádit V: si V _ ytre V, ymte V _ 
dadjalit V: si V _ si fort V _ 
čárvet V: klype V _ klype V, klemme V _ 
čárvut V: klype V _ klype V, klemme V _ 
cikcut V: klype V _ klype V, knipe V _ 
cibmut V: klype V _ knuge V; klype V _ 
cuiggodit V: påpeke V; kritisere V _ formane V, advare V _ 
šluvgit V: riste V _ riste V, slenge V _ 
náđđut V: trykke V _ krype sammen V; trykke V _ 
prentet V: trykke V _ prente V _ 
oaidnalit V: treffe V _ sees V _ 
digaštallat V: diskutere V; drøfte V _ debattere V _ 
diggedit V: diskutere V _ diskutere V, krangle V _ 
duddjot V: lage V; skape V _ lage V, gjøre håndarbeid V, utføre håndverk V _ 
duššindahkat V: undergrave V _ annullere V, undergrave V _ 
geavvat V: skje V; gå V _ heve seg V; gå V _ 
earránit V: skilles V; skille V _ skilles V _ 
earuhit V: differensiere V; skille V _ differensiere V, skjelne V _ 
evttohit V: foreslå V; anbefale V _ foreslå V, avgi innstilling V; ta til orde for V _ 
árvalit V: foreslå V _ foreslå V; ymte V _ 
fihttet V: oppfatte V _ oppfatte V, komme på V _ 
gaikut V: rive V; slite V _ rive V, slite V _ 
njaskut V: rive V _ gnage V, rive V _ 
ravget V: slite V _ rykke V, slite V _ 
rundit V: slite V _ slite V, slepe V _ 
gaikkehit V: slite V _ rykke til V, slite V _ 
ravgut V: slite V _ rykke V, slite V _ 
váibadit V: slite V _ trøtte ut V _ 
geassit V: dra V; trekke V _ dra V, trekke V _ 
vázzit V: gå V _ gå V, spasere V _ 
vássit V: gå V _ svinne V, gå V _ 
hurgit V: gå V _ ile V, legge i veg V _ 
gollat V: gå V _ gå V, svinne V _ 
vázzilit V: gå V _ begynne å gå V _ 
meannudit V: behandle V _ oppføre seg V; behandle V _ 
gieđahallat V: behandle V _ bearbeide V, behandle V _ 
dálkkodit V: behandle V _ behandle for sykdom V, medisinere V _ 
cielahit V: mobbe V _ gjø på noen V; skjelle ut V _ 
rievdat V: drive V; endre V _ drive V, reke V; forandre seg V _ 
gullat V: høre V _ høre V; tilhøre V _ 
gullostit V: høre V _ plutselig høres V; føles svakt V _ 
lihkahallat V: berøre V _ berøre V; bevege V _ 
einnostit V: anta V; anslå V; forvente V _ forutsi V, spå V, antisipere V _ 
gáhttet V: bevare V; verne V _ vokte V, ta vare på V, bevare V _ 
heŋget V: henge V _ henge opp V _ 
heaŋgut V: henge V _ henge opp V _ 
dárustit V: snakke V _ snakke norsk V _ 
sámástit V: snakke V _ snakke samisk V _ 
hoigat V: skyve V _ skyve V, puffe V _ 
hovdet V: lede V _ lede V, styre V _ 
doahput V: skaffe V _ gripe V _ 
áittardit V: skaffe V _ passe på saker V; skaffe V; sørge for V _ 
geasuhit V: rekruttere V _ tiltrekke V _ 
áddehaddat V: forstå V _ forstå hverandre V _ 
šoavvat V: suse V _ suse V, bruse V _ 
juhcat V: suse V _ suse V, bruse V _ 
juoiggastit V: joike V _ joike litt V _ 
jáddat V: slukke V _ slukne V _ 
njávkat V: stryke V _ stryke med handa V _ 
liktet V: stryke V _ pusse V; stryke V _ 
veallánit V: ligge V _ legge seg V _ 
gárvet V: sluttføre V _ gjøre ferdig V _ 
geargat V: sluttføre V _ bli ferdig V _ 
luoikkahit V: låne V _ låne hos noen V _ 
moaitit V: kritisere V _ klage over V _ 
njáskat V: hogge V _ kviste V; rydde mark V _ 
meroštit V: definere V; anslå V; beregne V _ anslå V; definere V _ 
máinnastit V: fortelle V _ fortelle V, fortelle eventyr V _ 
nuppástuvvat V: endre V _ forandre seg V _ 
namahit V: omtale V; nevne V; oppnevne V _ nevne V _ 
nammadit V: omtale V; oppnevne V _ oppnevne V; omtale V _ 
jođašit V: ferdes V _ bevege V _ 
vánddardit V: ferdes V _ vandre V, streife V _ 
vádjolit V: ferdes V _ vandre V _ 
johtalit V: ferdes V _ rikle, slarke V; ferdes V _ 
oaivvildit V: mene V _ mene V, ta stilling til V _ 
vuhttot V: synes V _ spores V _ 
speallat V: spille V _ spille V; spille kort V _ 
neaktit V: spille V _ se ut som V; spille V _ 
čuojahit V: ringe V _ ringe V; spille V _ 
sivdnidit V: skape V _ skape V, signe V _ 
soahtat V: kjempe V _ kjempe V, krige V _ 
vajálduvvat V: glemme V _ glemmes V _ 
vuordit V: vente V; forvente V _ vente V _ 
vuorddašit V: vente V _ vente lenge V _ 
veavdit V: vente V _ vente V, hale med seg V _ 
stuoridit V: utvide V; øke V _ forstørre V _ 
viidánit V: utvide V _ spre seg V; utvide seg V _ 
čájáhallat V: vise V _ framvise V _ 
čalmmustahttit V: markere V; belyse V _ fokusere på V, gjøre synlig V _ 
čadnot V: knytte V _ knyttes til V _ 
čatnasit V: knytte V _ bli bundet V _ 
čuvget V: belyse V; opplyse V _ opplyse V, belyse V _ 
čuožžut V: stå V; stå V _ stå V _ 
ceaggát V: stå V _ stå oppreist V _ 
čuččodit V: stå V _ bli stående V _ 
stuorrut V: vokse V; øke V _ bli stor V _ 
sisttisdoallat V: inneholde V; omfatte V _ inneholde V _ 
oassálastit V: delta V _ delta i V _ 
searvat V: delta V _ slutte seg sammen V _ 
dolastit V: fyre V _ fyre V, ha bål V _ 
ligget V: fyre V _ varme V _ 
laskat V: øke V _ øke V, formere seg V _ 
lasihit V: øke V _ legge til V, øke V _ 
jiellat V: trekke V _ trekke V, blåse svakt V _ 
geassádit V: trekke V _ trekke seg V _ 
rohttet V: trekke V _ rykke V; komme på V _ 
vuorbádit V: trekke V _ kaste lodd V, trekke lodd V _ 
unnidit V: redusere V _ forminsk V _ 
uhcidit V: redusere V _ forminske V _ 
áicat V: registrere V; observere V _ oppdage V _ 
láhppot V: tape V _ gå seg vill V _ 
oažžut V: motta V; oppnå V _ få V _ 
vuostáiváldit V: motta V _ ta imot V _ 
njulget V: rette V _ rette ut V, glatte ut V _ 
rátkit V: skille V _ skille V, skille rein V _ 
imaštit V: overraske V _ forundre seg V _ 
hirpmástuvvat V: overraske V _ bli forskrekket V _ 
hirpmahuvvat V: overraske V _ bli forskrekket V _ 
divustit V: justere V _ rette på V _ 
divaštallat V: drøfte V _ diskutere V _ 
dovddiidit V: identifisere V _ erfare V, lære å kjenne V _ 
lahttudit V: innlemme V _ innlemme V, inkorporere V _ 
duogŋat V: bøte V _ lappe V _ 
čiktit V: bøte V _ bøte garn V; bøye en skitupp V _ 
fearrat V: meisle V _ telje V _ 
gomihit V: oppheve V _ velte V; avvise V; gjendrive V _ 
