SME lemma pos: fad NOB lemma pos _ gt NOB lemma pos _ placeholder for action tag
iešbirgejupmi N: selvhjelp N; selvstendighet N; selvhushold N _ integritet N _ m
bálvalussuorgi N: tjenesteområde N; tjenestefelle N _ servicebransje N _ m
vuođđoopmodat N: grunneiendom N _ fast eiendom N _ m
gávpedoaibma N: handelsvirksomhet N; forretningsvirksomhet N; virksomhet N _ transaksjon N _ y
lohkkiidjoavku N: lesergruppe N _ leserkrets N _ y
meannováttisvuohta N: problematferd N; atferdsvanske N _ atferdsvanske N _ y
variánta N: eventyrvariant N; variant N _ variant N _ n
olgoriikkabuktu N: importvare N; import N _ import N _ n
šiehtadallandilli N: forhandlingsinnspurt N; forhandlingssituasjon N _ forhandlingsposisjon N _ m
riskadássi N: risikonivå N _ risikoklasse N _ y
geahččalandoaibma N: forsøksaktivitet N; prøvedrift N; forsøksvirksomhet N; forsøk N _ forsøksvirksomhet N _ m
sevdnjeslatnja N: mørkekott N _ mørkerom N _ n
vearrorehketdoallu N: skatteoppgjør N _ skatteregnskapet N _ y
gálvomannu N: varekonsum N _ vareforbruk N _ y
ávkkástallanvuoigatvuohta N: nytterett N _ nyttesrett N _ m
prinsihppamearrádus N: prinsippbestemmelse N _ prinsippavgjørelse N _ n
neavvun N: rettledelse N; veiledning N _ tilråding N _ m
geardedállu N: blokkleilighet N _ boligblokk N _ n
ulli N: farvannsbeskrivelse N; tidevann N _ flo N _ n
vuodjaskáhppu N: smørboks N; smøreske N _ smørdall N _ m
jienastannjuolggadusat N: avstemningsregel N _ voteringsreglement N _ n
láigovuoigatvuohta N: leierett N _ festerett N _ y
fuolahangeatnegasvuohta N: underholdsplikt N _ omsorgsplikt N; vergemålsforpliktelse N _ y
mánáidsuodjaluspedagoga N: barnevernpedagog N _ barnevernspedagog N _ n
bálvalanpolitihkka N: servicepolitikk N _ tjenestepolitikk N _ n
gárggalmastin N: stavhopper N _ stavhopp N _ n
doaibmagelbbolašvuohta N: tiltakskompetanse N; handlingskompetanse N _ handlingskompetanse N _ n
árvvoštallannákca N: vurderingsevne N _ dømmekraft N _ y
luopmoruhta N: feriepenge N _ feriepenger N _ n
oppalašperspektiiva N: helhetsperspektiv N _ fellesperspektiv N _ y
ealáhusláhki N: næringsform N _ levevei N _ y
guolástuslávdegoddi N: fiskeriutvalg N _ fiskerinemd N _ m
doarjjaolmmoš N: støttespiller N; støttekontakt N _ støttekontakt N _ y
dutkanpolitihkka N: forskningspolitikk N _ forskerpolitikk N _ m
gávpeoktavuohta N: kunderelasjon N _ handelsforbindelse N _ y
digaštallančoahkkin N: debattmøte N _ diskusjonsmøte N _ m
dáiddapolitihkka N: kunstnerpolitikk N; kunstpolitikk N _ kunstpolitikk N _ n
báhčinbálká N: skuddpremie N _ jaktpremie N _ m
standárdašiehtadus N: standardavtale N _ standardkontrakt N _ y
váikkuhangaskaoapmeapparáhtta N: virkemiddelapparat N _ påvirkningsapparat N _ m
stivrenstruktuvra N: styringsstruktur N _ styrestruktur N _ m
dievasčoahkkinmearrádus N: plenumsvedtak N _ plenumsbeslutning N _ m
doaibmageatnegasvuohta N: driveplikt N _ løyveplikt N _ m
oahpahusdagus N: opplæringsopplegg N; undervisningsopplegg N _ undervisningsopplegg N _ m
ráhkkanančoahkkin N: forberedelsesmøte N _ forberedende møte N _ m
doaibmamálle N: virksomhetsmodell N; organisering N _ driftsopplegg N _ m
terminála N: passasjerterminal N; terminal N _ terminal N _ n
buvttadanvuoitodoarjja N: produksjonspremieordning N _ produksjonsoverskuddsstønad N _ m
álggahandoarjja N: etableringstilskudd N _ oppstartsmidler N _ y
duođaštusárvvoštallan N: bevisvurdering N _ bevisbedømmelse N _ n
veahkkeásahus N: hjelpeinstans N _ hjelpeinterventient N _ m
álgoálbmotpolitihkka N: urfolkspolitikk N _ urbefolkningspolitikk N _ n
eamiálbmotpolitihkka N: urfolkspolitikk N _ urbefolkningspolitikk N _ n
vuoigatvuođadilálašvuohta N: rettighetsforhold N _ rettighetssituasjon N _ n
dieđihangeatnegasvuohta N: meldeplikt N; opplysningsplikt N _ opplysningsplikt N _ n
láhtten N: væremåte N; atferd N; adferd N _ adferd N _ n
vuovdedoaibma N: skogtiltak N _ skogsdrift N _ n
gulahallanstrategiija N: kommunikasjonsstrategi N _ forvaltningsstrategi N _ m
buhtadanortnet N: erstatningsordning N; kompensasjonsordning N _ kompensasjonsordning N _ y
riekteásahus N: rettsvesen N _ rettsinstitutt N _ m
vuođđodoarjja N: grunntilskudd N; basistilskudd N _ grunnstøtte N _ n
ealáhusdoarjja N: næringsstøtte N _ driftsenhetsstøtte N _ m
iešárvu N: selvrespekt N; egenverd N _ selvaktelse N _ m
mátkerehket N: reiseregningsskjema N; reiseregning N _ reiseregning N _ n
foandadoarjja N: fondsstøtte N _ fondstøtte N _ m
riektesuorgi N: rettsområde N _ rettsfelt N _ y
mátkedoarjja N: reisestøtte N _ reisetilskudd N _ n
autorisašuvdna N: autorisasjonsbevilling N; autorisasjon N _ autorisasjon N _ y
oktiisearvan N: alliansebygging N _ allianseinngåelse N _ n
čállinbálvalus N: sekretærtjeneste N _ skrivetjeneste N _ y
stivrenvuohki N: styringsform N _ styresett N _ y
eamiálbmotprošeakta N: urfolksprosjekt N _ urbefolkningsprosjekt N _ n
váldesirdin N: myndighetsoverføring N; delegasjon N _ myndighetsdelegasjon N _ n
hálddahuslávdegoddi N: administrasjonskomite N _ administrasjonsutvalg N _ n
ráŋggáštanmearrádus N: sanksjonsbestemmelse N; straffebestemmelse N _ straffebestemmelse N _ y
kulturmuitopolitihkka N: kulturminnepolitikk N _ kulturminnespolitikk N _ m
virgekoda N: stillingskode N _ stilingskode N _ m
láigoeana N: leiejord N _ festegrunn N _ y
oahpahusvuohki N: undervisningsmåte N; undervisningsform N; opplæringsform N _ opplæringsform N _ m
buohcanruhta N: sykepenge N _ sykelønn N _ m
hálddašanstrategiija N: forvaltningsstrategi N _ administrasjonsstrategi N _ m
ovddidanperspektiiva N: utviklingsperspektiv N _ framskrittsperspektiv N _ m
boazodoallokultuvra N: reindriftskultur N _ reindriftsenhetkultur N _ m
duolvačáhci N: avløp N _ avløpsvann N _ n
lassigažaldat N: tilleggsspørsmål N _ bispørsmål N _ y
táhter N: tater N; sigøyner N; reisende N _ tater N _ m
sisačáliheapmi N: registrering N _ innsjekking N; innskrivning N _ y
logahallan N: registrering N _ fortegnelse N; tabell N _ m
guođohanguovlu N: beiteområde N _ beitesone N _ y
pearbma N: perm N _ brevordner N _ y
sáltejeagil N: skorpelav N _ klipperagg N _ m
livnnethoavda N: likningssjef N _ ligningssjef N _ m
dássádatdilálašvuohta N: balansegang N _ balanseforhold N _ n
meahcceluodda N: skogsvei N _ skogsveg N _ n
mohtoroassi N: motorblokk N _ motordel N _ n
feastonuohtti N: trålpose N _ trål N _ y
luoddajohtolat N: veitrafikk N _ vegtrafikk N _ n
saŋáš N: kløe N _ skabb N, fnatt N _ y
vuolši N: betennelse N _ infeksjon N _ n
luoddaplána N: veiplan N _ vegplan N _ n
rádjegeassin N: grensegang N _ grenseoppgjør N _ m
ráđđádallan N: konsultasjon N _ overlegning N _ m
mielváikkuheapmi N: medvirkning N; medinnflytelse N _ medinnflytelse N _ n
boatka N: brudd N; pause N _ avsmalning N, innsnevring N; fjellpass N; pause N, avbrudd N; mellomrom N _ n
potensiála N: potensial N; potensiale N _ potensial N _ n
bálkášiehtadallan N: lønnsoppgjør N; lønnsforhandling N _ lønnsforhandling N _ n
oastin N: kjøp N; innkjøp N _ innkjøp N _ n
diplomatiija N: diplomati N; diplomat N _ diplomati N _ n
appellašuvdna N: appell N _ appellasjon N _ n
almmustuhttin N: utgivelse N _ tinglysning N _ m
bávkkanas N: eksplosiv N _ dynamitt N _ m
imaštallan N: forundring N _ undring N _ n
riekteortnet N: rettsorden N _ rettsordning N _ m
buvttadanhivvodat N: produksjonsvolum N; produksjonsomfang N _ produksjonsmengde N _ m
sierraduopmostuollu N: særdomstol N _ spesialdomstol N _ y
stuorideapmi N: utbygging N _ tilbygning N _ m
eanadoallopolitihkka N: jordbrukspolitikk N; landbrukspolitikk N _ landbrukspolitikk N _ y
ráđđenvuoigatvuohta N: råderett N _ overhøyhetsrett N _ y
ráđđenriekti N: råderett N _ rådighetsrett N _ y
buktu N: ytelse N; bidrag N; verk N _ ytelse N _ m
mihtádus N: utmål N; mål N _ utmåling N _ m
riegádahttin N: fødeavdeling N; fødsel N _ forløsning N _ n
sorjjakeahtesvuohta N: uavhengighet N _ suverenitetsutøvelse N _ y
girdihámman N: flystasjon N; lufthavn N _ lufthavn N _ y
rituála N: ritual N _ rituale N _ n
haddebearráigeahčču N: priskontroll N _ pristilsyn N _ y
loatnasátni N: lånord N _ låneord N _ m
narkotihkka N: narkotikum N; narkotika N _ narkotika N _ n
stivrejupmi N: styring N _ styreform N _ y
oasusvuoitu N: utbytte N _ aksjeutbytte N _ n
doaibmavuohki N: driftsmåte N; driftsform N _ virksomhetsmåte N _ m
sierraneapmi N: separasjon N _ separasjon N; spesialisering N _ n
lihttu N: pakt N _ allianse N, forbund N _ y
leavvan N: spredning N _ ekspansjon N _ y
árvobábir N: portefølje N _ verdipapir N _ m
ávžžuheapmi N: påtrykk N _ oppfordring N _ n
borramušgárri N: matfat N _ matskål N _ n
árvofápmu N: prestisje N _ autoritet N _ y
dulkon N: tolkning N; fortolkning N; tolking N _ tolking N _ m
muorrašládja N: treslag N _ tresort N _ n
liidna N: line N _ line N; lin N _ n
vuollásteapmi N: okkupasjon N _ underleggelse N _ y
ámmátčehppodat N: profesjonalitet N _ profesjon N _ y
cavgileapmi N: tips N _ suffli N _ m
táŋka N: tank N _ beholder N _ y
bráhkka N: brakk N _ brakke N _ n
diŋgojupmi N: abonnement N _ ordre N, bestilling N _ y
guolástansadji N: fiskefelt N; fiskeplass N _ fiskeplass N _ y
meannu N: atferd N; handling N; adferd N _ oppførsel N _ n
ráddjen N: avgrensing N; avgrensning N _ avgrensning N _ n
bivdobáiki N: jaktfelt N _ jaktplass N _ y
fievrrádus N: transport N; frakt N _ frakt N _ y
mánnáfuolaheapmi N: barnepass N _ barneomsorg N _ n
virolašvuohta N: sedvane N _ regelmessighet N _ y
riektesuodjalus N: rettsvern N _ rettsbeskyttelse N _ y
buohtastahttin N: sammenlikning N; sammenligning N _ sammenligning N _ n
gárbbis N: nordlandsbåt N _ kjeks N _ y
teáhterbihttá N: teaterstykke N _ skuespill N _ y
viggamuš N: satsing N; forsøk N; innsats N _ forsøk N _ y
biebman N: oppdrett N; ernæring N _ ernæring N _ y
roggan N: utvinning N _ skjerping N _ y
mediapolitihkka N: mediepolitikk N; mediapolitikk N _ mediapolitikk N _ m
kántorlatnja N: kontorlokale N _ kontorrom N _ m
álggaheapmi N: oppstart N; etablering N _ etablering N; avspark N _ y
olmmošvuoigatvuođasoahpamuš N: menneskerettighetskonvensjon N; menneskerettskonvensjon N _ menneskerettskonvensjon N _ n
johtalangeaidnu N: trekklei N _ kommunikasjonsvei N _ y
ávnnasdiehtu N: produktdatablad N; våpentype N; materialkunnskap N _ materialkunnskap N _ n
dáiddárstipeanda N: kunstnerstipend N _ kunststipend N _ m
girjelágádusdoarjja N: forlagsstøtte N _ bokforlagsstønad N _ n
lágádusdoarjja N: forlagsstøtte N _ forlagsstønad N _ m
šiehtadallanbealli N: avtalepart N; forhandlingspart N _ forhandlingspartner N, forhandlingspart N _ n
ovdanbuktinvuohki N: ytringsform N; uttrykksform N _ uttrykksform N _ n
árvolokten N: verdiskapning N; verdiskaping N _ oppskriving N _ m
bagadanávnnas N: veiledningsmateriell N; veiledningsmateriale N _ veiledningsmateriale N _ n
gálvohivvodat N: vareutvalg N _ varebeholdning N _ y
čáhceráidnenrusttet N: vannrensenanlegg N _ vannbehandlingsanlegg N _ m
ruhtaovttadat N: valuta N _ pengeenhet N _ n
luoitinlohpi N: utslippstillatelse N _ utslipptillatelse N _ m
skihkahisvuohta N: uryddighet N _ skjødesløshet N _ y
soahpameahttunvuohta N: tvist N; konflikt N _ uoverenstemmelse N _ y
áigeplána N: tidsplan N; tidsskjema N _ tidsskjema N _ y
sierraláhka N: særlov N _ egenlov N _ m
deavdda N: supplement N _ input N; fyll N _ m
dálveskuovva N: støvlett N _ vinterjogg N, vintersko N _ m
čuorvvassátni N: slagord N _ interjeksjon N _ y
šohkka N: sjokk N _ choke N _ m
suorgeláhka N: sektorlovgivning N; sektorlov N _ sektorlovgivning N _ y
ovttasdoaibman N: samspill N; samhandling N _ samhandling N _ y
riektedilálašvuohta N: rettsforhold N _ rettighetsforhold N _ y
buhtisvuohta N: renhet N; hygiene N _ sanitære forhold N _ y
njuovadeapmi N: reinslakting N; slakting N _ slakting N _ n
veajuiduhttinruhta N: rehabiliteringspenge N _ attføringstrygd N _ m
heahtedoaibma N: redningstiltak N _ kriseforanstaltning N _ y
presumpšuvdna N: presumsjon N _ presumpsjon N _ n
pateantaláhka N: patent N _ patentlov N _ n
rihkus N: overtredelse N; forseelse N _ forseelse N _ y
ráhkkanus N: overbygning N; innretning N _ konstruksjon N _ m
buhtisteapmi N: opprensking N _ rensing N _ y
boaldin N: nedbrenning N _ forbrenning N _ y
luondduruovttudoallu N: naturhushold N _ naturalhusholdning N _ n
fápmosuorgi N: myndighetsområde N; kraftsektor N _ kraftsektor N _ y
muvra N: mur N _ varde N _ m
olahus N: milepæl N; rekord N; prestasjon N _ rekord N; prestasjon N _ y
mearkungárdi N: merkegjerd N _ merkegjerde N _ n
soabaheapmi N: mekling N; megling N _ megling N, mekling N _ n
borranlatnja N: matsal N _ spisestue N; spiserom N _ n
fápmosirdin N: maktforskyving N; maktforskyvelse N _ kraftoverføring N _ m
vealgereantu N: lånerente N _ gjeldsrente N _ y
árvodávvir N: luksusvare N _ verdisak N _ n
ovttadássásašvuođaperspektiiva N: likeverdsperspektiv N _ likestillingsnivåperspektiv N _ m
viđji N: lenke N; kjede N _ kjede N _ y
sodju N: legning N; trend N; tendens N _ bend N; tendens N _ y
rumašguoddu N: legemsbygning N _ kroppstilling N _ m
kulturdovdomearka N: kulturtrekk N _ kulturminnemerke N _ m
kulturguovddášfoanda N: kultursenterfond N _ kultursentrumsfond N _ m
kulturduovdda N: kulturlandskap N _ kulturområde N _ m
liigegeavahus N: kostnadsoverskridelse N _ overskridelse N _ n
kommandihttavuođđudus N: kommandittselskap N _ kommandittforetak N _ y
vuodjinvuohki N: kjøremønster N _ kjøremåte N _ n
dovdan N: kjennskap N _ sansing N _ y
muohtočohkka N: kinnben N _ snøtopp N _ m
luoitu N: kalkulasjon N _ kalkyle N _ y
eanajuohkin N: jordskifte N _ jorddelingsforretning N _ y
eanandoalloulbmil N: jordbruksformål N; landbruksformål N _ landbruksformål N _ y
neavvu N: instrument N; redskap N; verktøy N _ verktøy N _ y
vuosteágga N: innsigelse N _ motargument N _ y
vuosttaldeapmi N: innsigelse N; motstand N; protest N _ protest N _ y
vuoruhansuorgi N: innsatsområde N; prioriteringsområde N; satsingsområde N _ satsingsområde N _ m
govvideapmi N: illustrasjon N; fremstilling N _ symbolisering N _ y
bivdinvuohki N: høstingsmåte N; fiskemetode N; fangstmetode N _ fangstmåte N _ m
váldosáhka N: hovedinnlegg N _ hovedsak N; overskrift N _ m
váldoágga N: hovedgrunn N; hovedargument N _ hovedargument N, kronargument N _ n
váldoevttohus N: hovedforslag N _ prinsipalt forslag N _ y
váldocealkka N: hovedbudskap N; helsetning N _ hovedsetning N _ y
doaibmanvejolašvuohta N: handlingsrom N _ funksjonsmulighet N _ y
dohkálašvuohta N: gyldighet N; kvalifikasjon N _ tjenlighet N _ m
buorrevuohta N: godhet N _ bonitet N _ y
vealggáidupmi N: gjeldsfelle N _ gjeldskrise N _ y
meahcástallan N: friluftsliv N _ utmarksnæring N _ m
ovdanbuktinnákca N: fremstillingsevne N; framstillingsevne N; formidlingsevne N _ formidlingsevne N _ n
ovdalatnja N: forværelse N _ forrom N _ y
hálddašanapparáhtta N: forvaltningsapparat N _ administrasjonsapparat N _ y
nuoskkideapmi N: forurensing N; forurensning N _ forurensning N _ n
láhkaásahusváldi N: forskriftsmyndighet N _ forskriftskompetanse N _ m
gávpejurdda N: forretningsidé N _ kjøpelyst N _ n
juogadanpolitihkka N: fordelingspolitikk N _ delingspolitikk N _ y
juohkin N: fordeling N _ utlevering N _ y
dearvvašvuođaláhka N: folkehelselov N; helselovgivning N _ helseloven N _ n
tv-prográmma N: fjernsynsprogram N; tv-program N _ tv-program N _ n
bivdomudden N: fiskeriregulering N; fiskeregulering N _ uttaksregulering N _ m
miellagovahallan N: fantasi N _ fabulering N _ y
bivdorusttet N: fangstanlegg N _ fangstsystem N _ m
ásahandoarjja N: etableringsstøtte N _ bostønad N _ y
álggahanstipeanda N: etablererstipend N _ stiftelsesstipend N _ m
lassejuolludeapmi N: ekstrabevilgning N; tilleggsbevilgning N _ tilleggsbevilgning N _ y
olgogovva N: eksteriør N; profil N _ profil N _ y
duodjefága N: duodjifag N _ håndverksfag N _ y
vuojeheapmi N: driving N; utdriving N _ utdriving N _ y
sirren N: differensiering N; isolasjon N _ isolering N _ m
ságastallanbealli N: dialogpartner N _ samtalepart N _ n
guoddinnákca N: bærekraft N; bæreevne N _ bæreevne N _ n
huksenláhka N: bygningslov N _ byggelov N _ n
sáttasátni N: budskap N _ sendingsord N _ m
báktešládja N: bergart N _ steinart N _ m
meroštus N: beregning N; anslag N; definisjon N _ anslag N; definisjon N _ y
meroštallan N: beregning N; anslag N _ skjønn N _ y
dárboárvvoštallan N: behovsanalyse N; behovsprøving N _ behovsprøving N _ n
oktiisuddadeapmi N: assimilering N _ assimilasjon N _ y
bargosuorgi N: arbeidsfelt N; arbeidsområde N _ sysselsettingsfaktor N _ m
čuovgaárka N: lysark N _ transparent N _ m
váidinvuoigatvuohta N: klagerettighet N; klagerett N _ klagerett N _ n
álggahansárdni N: innledning N; åpningstale N _ åpningstale N _ n
áššeovddideapmi N: saksforelegg N _ saksframlegg N _ n
bargoreahka N: lasslede N _ jobbslede N _ n
badjosat N: høyfjell N _ øvre del av not N _ m
luohpan N: frafall N _ oppsigelse N _ n
mihtilmasvuohta N: særpreg N _ karakteristikk N _ y
gummi N: kondom N _ gummi N _ y
luŋká N: vindu N _ luke N _ n
vuordda N: forventning N _ person som er ventet N; noe som er ventet N _ m
suovvabohcci N: rør N _ skorstein N _ m
báhkinvuohta N: hedning N _ hedenskap N _ n
stárra N: tare N _ stær N _ y
sierraláganvuohta N: forskjell N _ originalitet N _ n
álgoevttohus N: forslag N; utkast N _ utkast N _ n
ráktu N: stein N; skifer N _ skifer N; stein N _ n
máksámuš N: kostnad N _ anvisning N _ n
gollan N: slitasje N; nedbryting N _ nedbryting N _ y
luohkkádássi N: klassetrinn N _ klassenivå N _ m
láhkanjuolggadus N: forskrift N _ lovregel N _ n
gálga N: ferdighet N; evne N _ falk N _ m
projeakta N: prosjekt N _ projekt N _ m
válljen N: valg N _ seleksjon N _ y
veardideapmi N: vurdering N _ kritikk N _ y
ovdánahttinprošeakta N: utviklingsprosjekt N _ forbedringsprosjekt N _ m
iskan N: prøve N; undersøkelse N _ prøve N _ y
juolludeapmi N: bidrag N; bevilgning N _ bevilgning N _ n
sajádat N: posisjon N; stilling N _ beliggenhet N _ y
luoitin N: utslipp N _ beregning N; utslipp N _ n
dárkka N: sikkerhet N _ pålitelighet N, sikkerhet N _ n
álgga N: initiativ N _ initiativ N; opphav N _ n
bálvaleapmi N: service N; tjeneste N _ tjeneste N _ y
sárggus N: tegning N; trekk N _ tegning N _ y
suddjen N: beskyttelse N; vern N _ beskyttelse N _ y
jorri N: tilhenger N _ turbulens N _ n
dárkkisteapmi N: revisjon N _ ettersyn N, revisjon N _ n
guorraseapmi N: oppslutning N; tilslutning N _ tilslutning N _ n
álgoávnnas N: råvare N; råstoff N _ råmateriale N, råstoff N; råvare N _ n
mieđiheapmi N: erkjennelse N; tilslutning N _ erkjennelse N _ n
heaittiheapmi N: nedleggelse N _ oppgivelse N; nedleggelse N _ n
bolsttar N: madrass N _ sky N; madrass N _ m
áirrasgoddi N: representantskap N; delegasjon N _ representantskap N _ y
ođasteapmi N: restaurering N _ ombygging N, renovasjon N _ m
luoddaáidi N: rekkverk N _ balustrade N, rekkverk N _ n
rátkkašeapmi N: skilling N _ reinskilling N _ y
boalvvir N: handelsmann N _ finsk handelsmann N; handelsmann N; smughandler N _ n
boalvár N: handelsmann N _ finsk handelsmann N; handelsmann N; smughandler N _ n
liigeoassi N: biprodukt N _ reservedel N _ n
stargatvuohta N: stivhet N; fasthet N _ stivhet N _ y
diehtojuohkintávval N: oppslagstavle N _ informasjonstavle N, oppslagstavle N _ n
riepmosálla N: festsal N _ aula N _ y
ođastusdoaibma N: reformarbeid N; reform N _ reformarbeid N _ n
nannodat N: fasthet N; styrke N _ fasthet N _ y
olgoáibmoláhka N: friluftslov N _ friluftsloven N _ n
sierravuoigatvuohta N: særrett N _ særrettighet N _ n
bálvalusapparáhtta N: serviceapparat N; tjenesteapparat N _ tjenesteapparat N _ y
eretvuojeheapmi N: utdriving N _ utdrivning N _ n
divššohasvuoigatvuođaláhka N: pasientrettighetslov N _ pasientrettighetsloven N _ n
luoddajohtolatláhka N: vegtrafikklov N _ vegtrafikkloven N _ n
vuosttaščájálmas N: premiere N _ premiére N _ n
čuovvolanbálvalus N: oppfølgingstjeneste N _ oppfølgingstjenesten N _ m
várrogasvuohta N: varsomhet N _ aktsomhet N _ y
luoddaláhka N: veglov N _ vegloven N _ n
sturrodat N: størrelse N; format N _ format N; volum N _ m
mahtodat N: størrelse N; omfang N _ størrelse N _ y
spiehkastat N: unntak N _ avvik N; unntak N _ n
gulahallan N: kommunikasjon N; dialog N _ kommunikasjon N _ n
vuostálasvuohta N: motsetning N; konflikt N _ motsetning N _ n
buollin N: brann N _ forbrenning N _ y
logaldallan N: foredrag N; forelesning N _ forelesning N, leksjon N _ m
ovdasáhka N: foredrag N; innlegg N _ foredrag N _ y
buorideapmi N: forbedring N _ forbedring N; renovasjon N _ n
dáhkádus N: garanti N _ forsikring N; garanti N, sikkerhetsstillelse N _ n
dohkkeheapmi N: godkjenning N; anerkjennelse N _ aksept N, godkjenning N _ n
vuostebealli N: opposisjon N; motpart N; motvekt N _ motpart N; opposisjon N _ n
opposišuvdna N: opposisjon N _ motsetning N _ y
heivehus N: tilpasning N _ bearbeidelse N; tilpasning N _ n
spivka N: spøk N _ spøk N; moro N; vits N _ n
merken N: merking N _ merking N; oppmerking N _ n
vuostáiváldin N: resepsjon N _ resepsjon N; velkomst N _ n
málbma N: malm N _ erts N; malm N _ n
liggenrusttet N: varmeanlegg N _ fyringsanlegg N, varmeanlegg N _ n
bargoseminára N: arbeidsseminar N _ arbeidsseminar N, workshop N _ n
fuođđobivdu N: storviltjakt N; jakt N _ storviltjakt N _ n
bággočađahanláhka N: tvangsfullbyrdelseslov N _ tvangsfullbyrdelsesloven N _ n
jápminboddu N: død N _ dødsstund N _ n
duvdda N: pådriver N; støtte N _ støtte N _ n
opmodatvuoigatvuohta N: eiendomsrett N _ formuesrettighet N _ m
oamasteapmi N: eierskap N _ disponering N; tilegnelse N _ y
máhtolašvuohta N: kunnskap N _ kvalifikasjon N _ n
doaimmahat N: virksomhet N _ ekspedisjon N _ y
giddodat N: eiendom N _ fast inventar N _ y
idea N: ide N; idé N _ idé N _ n
oaidninguovlu N: perspektiv N _ synsfelt N _ y
gielddastivrraválga N: kommunevalg N _ kommunestyrevalg N _ n
ruggu N: kai N _ brygge N _ n
brugga N: kai N _ brygge N _ n
heivehanmunni N: fleksibilitet N _ fleksibel A _ m
dávggasvuohta N: fleksibilitet N _ fleksibilitet N, seighet N _ n
ovddideapmi N: utvikling N _ fremming N _ m
báhčin N: skudd N _ skyting N _ y
áicilvuohta N: oppmerksomhet N _ konsentrasjonsevne N _ y
bággočađaheapmi N: tvangstiltak N _ tvangsfullbyrdelse N _ n
vuođđostruktuvra N: infrastruktur N _ grunnstruktur N _ n
ráfáiduhttinnjuolggadus N: fredningsbestemmelse N _ fredningsregel N _ m
álgovuorru N: utgangspunkt N _ første omgang N _ n
gieđahallan N: behandling N _ bearbeiding N _ y
dárkkistus N: kontroll N _ ettersyn N, inspeksjon N, kontroll N _ n
dárkkástus N: kontroll N; undersøkelse N _ kontroll N, undersøkelse N _ n
dahkamuš N: oppgave N _ befatning N _ y
riska N: risiko N; risiko N _ risiko N _ n
nannen N: styrke N _ armering N _ n
veahkaválddálašvuohta N: vold N; overgrep N _ overgrep N; vold N _ n
jurddaboađus N: konklusjon N _ konklusjon N, slutning N _ n
ráhkadus N: anlegg N; struktur N _ anlegg N _ y
cuogga N: evne N; kapasitet N _ evne N _ y
oaivadus N: veiledning N _ rettesnor N _ y
rávven N: veiledning N; anbefaling N _ anbefaling N _ y
govastat N: figur N _ symbol N _ n
viidodat N: omfang N; areal N _ areal N _ y
dássedeaddu N: balanse N _ likevekt N _ y
gadja N: støy N; skrål N _ larm N; skrål N; støy N _ n
areála N: areal N; areal N; territorium N _ areal N _ n
gávpejohtu N: omsetning N _ omsettelighet N _ m
veahkkeávnnas N: hjelpemiddel N _ hjelpemateriale N _ y
álgočálus N: utkast N _ konsept N _ m
ráfehisvuohta N: uro N _ ufred N _ y
viessosadji N: tomt N _ hustomt N _ n
suvli N: pålegg N _ tilbehør N _ y
bajoš N: pålegg N _ kopp N _ m
geavahanviidodat N: bruksområde N _ bruksareal N _ y
riekteáddejupmi N: rettsoppfatning N _ rettsforestilling N _ y
riektemannolat N: rettsutvikling N _ rettsutvikling N, rettslig utvikling N _ n
bohcconáhkki N: reinskinn N _ reinhud N _ y
ovttastahttin N: sammenslåing N _ assosiering N _ m
bivdin N: fiske N; fangst N _ veidefang N _ m
