SME lemma pos: fad NOB lemma pos _ gt NOB lemma pos _ placeholder for action tag
sajáiduhttit V: innarbeide V; forankre V; installere V; integrere V _ installere V _ y
virgádit V: tilsette V; ansette V _ ansette V _ n
šláddjet V: kategorisere V; sortere V; klassifisere V _ klassifisere V _ m
máhcahit V: returnere V; tilbakeføre V _ tilbakeføre V _ m
lonistit V: frikjøpe V _ innløse V _ y
duppalastit V: fordoble V; doble V _ overlappe V _ m
buohtalastit V: samordne V; koordinere V; sidestille V _ sideordne V, sidestille V _ y
revideret V: revidere V; revidere V _ revidere V _ m
bievlat V: bli vår V _ bli barmark V _ y
oidit V: tilgodese V; favorisere V _ preferere V _ y
raporteret V: rapportere V _ raportere V _ m
vearuhit V: skattlegge V _ beskatte V _ y
aiddostahttit V: spesifisere V; poengtere V; presisere V _ presisere V _ y
hirpmástuhttit V: ryste V; sjokkere V; overraske V _ sjokkere V _ n
jávkadit V: utslette V; utrydde V; fjerne V _ estingvere V _ y
jorbet V: runde V _ avrunde V _ y
guovdilastit V: tematisere V; konsentrere V _ konsentrere V _ n
vuollástit V: underordne V; erobre V; okkupere V _ annektere V, okkupere V _ y
deattastit V: understreke V; framheve V _ stryke under V _ m
ovttaiduhttit V: standardisere V; integrere V _ integrere V _ y
árvvusatnit V: verdsette V; respektere V _ respektere V _ y
lihccut V: utelukke V; avsette V; ekskludere V _ ekskludere V; oppsi V _ m
projekteret V: prosjektere V _ projektere V _ m
luobahit V: oppgi V; avstå V _ avhende V, avstå V _ y
čoahkkimastit V: møte V _ avholde møte V _ n
goazahit V: hemme V; bremse V _ forhale V, retardere V _ y
bájuhit V: gjengi V; sitere V; referere V _ referere V, sitere V _ y
girjet V: føre V _ bokføre V _ n
sátnádit V: formulere V _ formulere seg V _ m
dárjut V: servere V; tilby V _ tilby V _ y
gállit V: vasse V _ være høy nok til å stå i vannet V _ m
guorrasit V: slutte V _ slutte seg til V _ n
giktalit V: oppmuntre V _ tirre V _ m
seailluhit V: oppbevare V; bevare V; opprettholde V _ forvare V _ y
vavddadit V: stamme V; stotre V _ sette seg fast V; stamme V _ n
engašeret V: ansette V _ engasjere V _ n
áktet V: respektere V _ respektere V, bry seg om V _ n
loavkašuhttit V: såre V _ fornærme V, såre V _ n
geahppánit V: avta V _ avta V, bli færre V, bli lettere V _ n
liigudit V: avstå V _ avse V _ n
stargadit V: støtte V; stabilisere V _ støtte V _ y
almmustahttit V: utgi V; avdekke V _ avdekke V; utgi V _ n
buorádahttit V: forbedre V _ forbedre V; bli godvær V _ n
máŋget V: kopiere V _ kopiere V; mangfoldiggjøre V _ n
čoahkkáigeassit V: oppsummere V _ oppsummere V; sammenfatte V _ n
laktit V: lime V; integrere V; innlemme V _ kople V, lime V _ n
gaifát V: glane V _ glane V; stirre V _ n
lávdadit V: desentralisere V; spre V _ desentralisere V _ y
roasmmohuvvat V: skade V _ skade seg V _ n
vihkkedallat V: veie V _ resonnere V _ m
daguhit V: uttale V _ overdra V _ m
stáđásmuvvat V: stabilisere V _ bli stødig V _ m
álkidahttit V: lette V; forenkle V _ forenkle V _ y
skihkket V: pålegge V _ behefte V _ y
heivehallat V: tilpasse V _ arrondere V _ y
rekruteret V: rekruttere V _ rekrutere V _ m
ságaškuššat V: omtale V; drøfte V _ drøfte V _ n
namuhastit V: nevne V _ nevne i forbifarten V _ n
maŋŋálastit V: plassere V _ rangere V _ y
gessot V: trekke V _ bli dradd V _ n
sajáiduvvat V: etablere V _ tilpasse seg V _ m
justeret V: rette V; justere V; justere V _ justere V _ n
báhkkodit V: uttrykke V _ ta til orde V, uttrykke V _ n
dárkilastit V: justere V; presisere V _ justere V _ m
ákkastit V: begrunne V _ komme med argumenter V _ y
dárkkuhit V: presisere V _ betrakte V _ n
váidudit V: dempe V _ dempe V; modifisere V _ n
čiktásit V: bøte V _ bøte V, bli bøtt V _ n
čuoibmuladdat V: stake V _ stake, holde på med å V _ m
fámohuhttit V: oppheve V _ sette ut av kraft V _ y
