amma	Pcle
beal	Po ja Num - lasit fstii
duoge	Po
eambbosat	Pron Indef
gostege	Adv
guhkit	Adv
hiluid háluid	Adv i mwe-fil
hás	Plce
maŋil	Po strekning
meareheapme A
mii_nu ovdamearkan mii + nu vuolde
nu_ahte ovdamearkan
ovddabeallái Po
ovddimus A
ovttage	Num statisk paradigme
sajis	Po "istedenfor"
seammaláhkái - "seammá láhkái" mwe med seammaláhkái ja seammaláhkai som lsub
seammaládje  - "seammá ládje" mwe med seammaládje som lsub
vaikko_mii  -> statisk fil

áicát - v oppdage
áhcagahttit - v få til å gløde
šluvggašit - v holde på å slenge med noe
bassanmášiidna - n reingjøringsmaskin
birrajándora - adv "døgnet rundt" -> adv i fst
bánna  - binná bánna -> mwe n 
glásaráigi - glásaráigge adv -> fst adv
riebangolleglássaráigge - adv -> fst adv
movtta - adj i fst - jeara Duommás 
sáhpánlágan - adj museaktig -> fst adj
olbmolágan  - adj menneskeaktig -> fst adj

