ollesolbmoášši	ollesolbmoášši	+?
alfabehta	alfabehta	+?
amma	amma	+?
baladit	baladit	+?
balddáhallat	balddáhallat	+?
bassanmášiidna	bassanmášiidna	+?
beal	beal	+?
beallječikŋa	beallječikŋa	+?
betoŋga-seaidni	betoŋga-seaidni	+?
bidjalit	bidjalit	+?
biffa	biffa	+?
biilastuollu	biilastuollu	+?
biile	biile	+?
birrajándor	birrajándor	+?
bivdinguovlu	bivdinguovlu	+?
boahi	boahi	+?
boandabargu	boandabargu	+?
boandahommá	boandahommá	+?
boareslágán	boareslágán	+?
borastit	borastit	+?
buohccebiila	buohccebiila	+?
buohccebiilaolmmoš	buohccebiilaolmmoš	+?
busseceahkki	busseceahkki	+?
busseuksa	busseuksa	+?
buđetmeastu	buđetmeastu	+?
báifáhkka	báifáhkka	+?
báittašit	báittašit	+?
bákteolmmoš	bákteolmmoš	+?
bánna	bánna	+?
bávkalit	bávkalit	+?
cirgguhit	cirgguhit	+?
dan_botta_go	dan_botta_go	+?
diibmo	diibmo	+?
doalahallat	doalahallat	+?
dorggiidit	dorggiidit	+?
dovdot	dovdot	+?
duoge	duoge	+?
duohken	duohken	+?
duolbmut	duolbmut	+?
dákteriggi	dákteriggi	+?
eahkedis	eahkedis	+?
eambbosat	eambbosat	+?
favorihttamusihkka	favorihttamusihkka	+?
feara_mii	feara_mii	+?
filbmasivdnádus	filbmasivdnádus	+?
fillehallat	fillehallat	+?
gahperdiehppi	gahperdiehppi	+?
geaidnobargi	geaidnobargi	+?
geađgegavja	geađgegavja	+?
geniála	geniála	+?
gillár	gillár	+?
gipsa	gipsa	+?
gipsajuolgi	gipsajuolgi	+?
girddihit	girddihit	+?
glásaráigi	glásaráigi	+?
glássa	glássa	+?
glássalávdi	glássalávdi	+?
goaskinčalbmi	goaskinčalbmi	+?
goikesuoidni	goikesuoidni	+?
gostege	gostege	+?
guhkit	guhkit	+?
guovlalit	guovlalit	+?
gussaeallu	gussaeallu	+?
gussačalbmi	gussačalbmi	+?
gárrut	gárrut	+?
hiluid_háluid	hiluid_háluid	+?
hirbmadit	hirbmadit	+?
hoavrrestit	hoavrrestit	+?
hoddet	hoddet	+?
huikkas	huikkas	+?
huksentiŋga	huksentiŋga	+?
huksenšillju	huksenšillju	+?
humanista	humanista	+?
hás	hás	+?
hávális	hávális	+?
ilosmit	ilosmit	+?
iđistit	iđistit	+?
iđitborramuš	iđitborramuš	+?
iđđedis	iđđedis	+?
joavdit	joavdit	+?
jorbbodit	jorbbodit	+?
jorgalahttit	jorgalahttit	+?
jođánisgeaidnu	jođánisgeaidnu	+?
jugus	jugus	+?
jáhkihit	jáhkihit	+?
jámešjietna	jámešjietna	+?
kartoŋga	kartoŋga	+?
kula	kula	+?
káfestallat	káfestallat	+?
liekkihit	liekkihit	+?
lihkastit	lihkastit	+?
lihkká	lihkká	+?
liigeráigi	liigeráigi	+?
liigeskeaŋka	liigeskeaŋka	+?
liigečoavdda	liigečoavdda	+?
livkkihit	livkkihit	+?
livsku	livsku	+?
luonddufágagirji	luonddufágagirji	+?
lákcagáhkkobihttá	lákcagáhkkobihttá	+?
lákcajiekŋa	lákcajiekŋa	+?
mahkáš	mahkáš	+?
maŋil	maŋil	+?
maŋŋebeaŋka	maŋŋebeaŋka	+?
meareheapme	meareheapme	+?
mearrasámeluohti	mearrasámeluohti	+?
mieiggastit	mieiggastit	+?
mielkkas	mielkkas	+?
mii_nu	mii_nu	+?
moddjet	moddjet	+?
movtta	movtta	+?
muhkut	muhkut	+?
muhttit	muhttit	+?
muortu	muortu	+?
málenivdni	málenivdni	+?
málesbeavdi	málesbeavdi	+?
niestelihtti	niestelihtti	+?
nissonbeaivi	nissonbeaivi	+?
njivlut	njivlut	+?
njoammelhiitta	njoammelhiitta	+?
njuorjju	njuorjju	+?
njuovvanbiila	njuovvanbiila	+?
njuovvanreŋko	njuovvanreŋko	+?
njuovvanáigi	njuovvanáigi	+?
njáhkalit	njáhkalit	+?
njávggádit	njávggádit	+?
nu_ahte	nu_ahte	+?
nuoraidromána	nuoraidromána	+?
návehastit	návehastit	+?
návetdoallu	návetdoallu	+?
oahpaheaddjiluopmu	oahpaheaddjiluopmu	+?
oaivesuodji	oaivesuodji	+?
oktovuohta	oktovuohta	+?
olbmolágan	olbmolágan	+?
oljohommá	oljohommá	+?
olmmošláhka	olmmošláhka	+?
orrungoahti	orrungoahti	+?
ovdabeaŋka	ovdabeaŋka	+?
ovdal_go	ovdal_go	+?
ovddabeallái	ovddabeallái	+?
ovddimus	ovddimus	+?
ovttage	ovttage	+?
ovttatmanu	ovttatmanu	+?
rabastit	rabastit	+?
ravkalit	ravkalit	+?
riebangolleglássaráigi	riebangolleglássaráigi	+?
riedja	riedja	+?
rievssatgárdi	rievssatgárdi	+?
ritnut	ritnut	+?
rohkosviessu	rohkosviessu	+?
ruivvas	ruivvas	+?
ráfehuhttit	ráfehuhttit	+?
ráhket	ráhket	+?
sajis	sajis	+?
savkkus	savkkus	+? savkosii
savkkástallat	savkkástallat	+?
seammaláhkái	seammaláhkái	+?
seastinbursa	seastinbursa	+?
servvodatviessu	servvodatviessu	+?
sievlla	sievlla	+?
sihkkeloaivesuodji	sihkkeloaivesuodji	+?
sihkkelsuorbmafáhcca	sihkkelsuorbmafáhcca	+?
sistebuvssat	sistebuvssat	+?
skirvehallat	skirvehallat	+?
skunjihit	skunjihit	+?
skurdnját	skurdnját	+?
skurtnjas	skurtnjas	+?
skuvllaáigi	skuvllaáigi	+?
smiehtadit	smiehtadit	+?
smiehttamuš	smiehttamuš	+?
soabalaš	soabalaš	+?
spihkeluossa	spihkeluossa	+?
spiinnebiergu	spiinnebiergu	+?
stággogeahči	stággogeahči	+?
stáidnár	stáidnár	+?
sáhpánláhka	sáhpánláhka	+?
sámi-ávvudeapmi	sámi-ávvudeapmi	+?
termos	termos	+?
tunealla	tunealla	+?
tuneallanjálbmi	tuneallanjálbmi	+?
tuneallatiŋga	tuneallatiŋga	+?
tunnealla	tunnealla	+?
turistabiila	turistabiila	+?
vaikko_mii	vaikko_mii	+?
vikkahit	vikkahit	+?
vuodjináigi	vuodjináigi	+?
váibmogolláš	váibmogolláš	+?
váikko	váikko	+?
váivvidit	váivvidit	+?
vázzinmátki	vázzinmátki	+?
vázzinsoabbi	vázzinsoabbi	+?
ádjáš	ádjáš	+?
áhcagahttit	áhcagahttit	+?
áicát	áicát	+?
álkit	álkit	+?
álkkeslohkangirjjáš	álkkeslohkangirjjáš	+?
šaddan	šaddan	+?
šaddanbeaidoalut	šaddanbeaidoalut	+?
čakčaguohtun	čakčaguohtun	+?
šealgut	šealgut	+?
šluvggašit	šluvggašit	+?
čohkkádit	čohkkádit	+?
šuohkihit	šuohkihit	+?
čuorgat	čuorgat	+?
čuorvvus	čuorvvus	+?
čusket	čusket	+?
