iešbirgejupmi N: selvberging N; selvhushold N
bálvalussuorgi N: tjenesteområde N; servicebransje N
vuođđoopmodat N: fast eiendom N
šiehtadallandilli N: forhandlingssituasjon N
geahččalandoaibma N: prøvedrift N
ávkkástallanvuoigatvuohta N: nytterett N
neavvun N: rettlning N; veiledning N
vuodjaskáhppu N: smørboks N; smøreske N
guolástuslávdegoddi N: fiskeriutvalg N
dutkanpolitihkka N: forskningspolitikk N
digaštallančoahkkin N: debattmøte N
báhčinbálká N: skuddpremie N 
váikkuhangaskaoapmeapparáhtta N: virkemiddelapparat N
stivrenstruktuvra N: styringsstruktur N
dievasčoahkkinmearrádus N: plenumsvedtak N
doaibmageatnegasvuohta N: driveplikt N
oahpahusdagus N: undervisningsopplegg N
ráhkkanančoahkkin N: forberedelsesmøte N
doaibmamálle N: virksomhetsmodell N; organisering N
buvttadanvuoitodoarjja N: produksjonspremieordning N
veahkkeásahus N: hjelpeinstans N
gulahallanstrategiija N: kommunikasjonsstrategi N
riekteásahus N: rettsvesen N
ealáhusdoarjja N: næringsstøtte N
iešárvu N: selvrespekt N; egenverd N
foandadoarjja N: fondsstøtte N
kulturmuitopolitihkka N: kulturminnepolitikk N
virgekoda N: stillingskode N
oahpahusvuohki N: undervisningsform N; opplæringsform N
buohcanruhta N: sykepenger N
hálddašanstrategiija N: forvaltningsstrategi N
ovddidanperspektiiva N: utviklingsperspektiv N
boazodoallokultuvra N: reindriftskultur N
táhter N: tater N
logahallan N: registrering N
sáltejeagil N: skorpelav N
livnnethoavda N: likningssjef N
rádjegeassin N: grensegang N
ráđđádallan N: konsultasjon N
almmustuhttin N: utgivelse N
bávkkanas N: eksplosiv N
riekteortnet N: rettsorden N
buvttadanhivvodat N: produksjonsvolum N; produksjonsomfang N
stuorideapmi N: utbygging N
buktu N: ytelse N
mihtádus N: utmål N; mål N
loatnasátni N: lånord N
doaibmavuohki N: driftsmåte N; driftsform N
árvobábir N: verdipapir N
dulkon N: fortolkning N; tolking N
cavgileapmi N: tips N
mediapolitihkka N: mediepolitikk N
kántorlatnja N: kontorlokale N
dáiddárstipeanda N: kunstnerstipend N
lágádusdoarjja N: forlagsstøtte N
árvolokten N: verdiskapning N
čáhceráidnenrusttet N: vannrensenanlegg N
luoitinlohpi N: utslippstillatelse N
sierraláhka N: særlov N
deavdda N: fyll N
dálveskuovva N: vintersko N
šohkka N: sjokk N
veajuiduhttinruhta N: rehabiliteringspenger N; attføringstrygd N
ráhkkanus N: overbygning N; innretning N
muvra N: mur N
fápmosirdin N: maktforskyving N
ovttadássásašvuođaperspektiiva N: likeverdsperspektiv N
rumašguoddu N: legemsbygning N
kulturdovdomearka N: kulturtrekk N
kulturguovddášfoanda N: kultursenterfond N
kulturduovdda N: kulturlandskap N
muohtočohkka N: kinnben N
vuoruhansuorgi N: prioriteringsområde N; satsingsområde N
bivdinvuohki N: fangstmetode N
váldosáhka N: hovedinnlegg N
dohkálašvuohta N: gyldighet N; kvalifikasjon N
meahcástallan N: utmarksnæring N
láhkaásahusváldi N: forskriftsmyndighet N
bivdomudden N: fiskeregulering N
bivdorusttet N: fangstanlegg N
álggahanstipeanda N: etablererstipend N
sirren N: differensiering N; isolasjon N
sáttasátni N: budskap N
báktešládja N: bergart N
bargosuorgi N: arbeidsfelt N; arbeidsområde N
čuovgaárka N: lysark N
badjosat N: øvre del av not N
vuordda N: forventning N
suovvabohcci N: skorstein N
luohkkádássi N: klassetrinn N
gálga N: ferdighet N; evne N
projeakta N: prosjekt N
ovdánahttinprošeakta N: utviklingsprosjekt N
bolsttar N: madrass N
ođasteapmi N: restaurering N
čuovvolanbálvalus N: oppfølgingstjeneste N
sturrodat N: størrelse N; format N
logaldallan N: foredrag N; forelesning N
opmodatvuoigatvuohta N: eiendomsrett N
heivehanmunni N: fleksibilitet N
ovddideapmi N: utvikling N
ráfáiduhttinnjuolggadus N: fredningsbestemmelse N
gávpejohtu N: omsetning N
álgočálus N: utkast N; originaltekst N
bajoš N: pålegg N
ovttastahttin N: sammenslåing N
bivdin N: fiske N; fangst N
