SME lemma pos: fad NOB lemma pos _ gt NOB lemma pos _ placeholder for action tag
áššemeannudeaddji N: saksbehandlerstilling N; saksbehandler N _ saksbehandler N _ n
ossodatjođiheaddji N: etatsleder N; avdelingsleder N; avdelingsdirektør N _ avdelingsleder N _ n
buohccidikšu N: sykesøster N; sykepleier N _ sykepleier N _ n
vearredahkki N: gjerningsmann N _ forbryter N _ n
biebmoealli N: beitedyr N _ kjæledyr N _ n
guldaleaddji N: lytter N; tilhører N _ tilhører N _ n
govvejeaddji N: illustratør N; fotograf N _ fotograf N _ y
bálvaleaddji N: servicepersonell N; tjener N _ tjener N _ n
vuoiti N: prisvinner N; vinner N _ vinner N _ n
šiehtadalli N: part N _ forhandler N _ n
mánnageahčči N: barnetilsyn N _ barnevakt N _ n
boazodoalli N: reindriftsutøver N; reineier N _ reindriftsutøver N _ n
dáksevuoddji N: drosjesjåfør N _ drosjesjåfør N, taksisjåfør N _ n
ságajođiheaddji N: ordfører N _ ordfører N, ordstyrer N _ n
čálli N: forfatter N; sekretær N _ forfatter N; sekretær N; skribent N _ n
girdi N: fly N _ fly N; flyver N _ n
váldočálli N: generalsekretær N _ hovedsekretær N _ y
geahčči N: publikum N; seer N _ publikum N _ y
áššedovdi N: ekspert N _ ekspert N; sakkyndig N _ n
meahciealli N: rovdyr N _ vilt dyr n _ n
buohcci N: pasient N _ syk a; pasient N _ n
bagadalli N: instruktør N; konsulent N _ instruktør N; konsulent N; rettleder N _ n
ohcci N: søker N _ søker N, skjerper N _ n
jođiheaddji N: leder N _ leder N, styrer N _ n
ovddasteaddji N: representant N _ foresatt N; representant N _ n
čoahkkinjođiheaddji N: møteleder N _ dirigent N, møteleder N _ n
jábmi N: død N _ død N, lik N _ n
láidesteaddji N: pådriver N _ dirigent N; pådriver N _ n
ruhtadeaddji N: finansieringskilde N _ finansiør N _ n
