vihttanuppelotjahkásaš	vihttanuppelotjahkásaš	+?
hilján	hilján	+?
seksualalaš	seksualalaš	+?
boasttu	boasttu	+?
boastto	boastto	+?
eahpesihkaris	eahpesihkaris	+?
eŋgalas	eŋgalas	+?
eaŋgalas	eaŋgalas	+?
stáđuheapme	stáđuheapme	+?
litnasit	litnasit	+?
snáhppat	snáhppat	+?
maŋŋelas	maŋŋelas	+?
máid	máid	+?
mannjit	mannjit	+?
fiidnat	fiidnat	+?
ipmášit	ipmášit	+?
nubbinjođiheaddji	nubbinjođiheaddji	+?
spábbačikčiekči	spábbačikčiekči	+?
poastamáppa	poastamáppa	+?
boastamáppa	boastamáppa	+?
vánhenságastallan	vánhenságastallan	+?
kopiorginála	kopiorginála	+?
synoniima	synoniima	+?
miessijoavku	miessijoavku	+?
áldujoavku	áldujoavku	+?
penala	penala	+?
mátkešukoláda	mátkešukoláda	+?
mátkešukoláde	mátkešukoláde	+?
mátkešukkuláda	mátkešukkuláda	+?
mátkešukkuláde	mátkešukkuláde	+?
mátkešukuláda	mátkešukuláda	+?
mátkešukuláde	mátkešukuláde	+?
gitarkursa	gitarkursa	+?
desimalalohku	desimalalohku	+?
guovddáškonsonanta	guovddáškonsonanta	+?
oaivádallan	oaivádallan	+?
skándala	skándala	+?
fiasko	fiasko	+?
skutter	skutter	+?
hálidus	hálidus	+?
bandášerenbierggas	bandášerenbierggas	+?
balluvdna	balluvdna	+?
dispusišuvdna	dispusišuvdna	+?
dramatihkár	dramatihkár	+?
báden-báiki	báden-báiki	+?
álkkeslohkangirjjáš	álkkeslohkangirjjáš	+?
savkosit	savkosit	+?
šukoláda	šukoláda	+?
šukoláde	šukoláde	+?
šukkuláda	šukkuláda	+?
šukkuláde	šukkuláde	+?
šukuláda	šukuláda	+?
šukuláde	šukuláde	+?
politihkár	politihkár	+?
direktora	direktora	+?
politihkár	politihkár	+?
leansmánnekántuvra	leansmánnekántuvra	+?
minoritehtta	minoritehtta	+?
justisdepartemeanta	justisdepartemeanta	+?
guovludepartemeanta	guovludepartemeanta	+?
máilmmesoahti	máilmmesoahti	+?
maŋŋelgaska beaivi	maŋŋelgaska beaivi	+?
minstar	minstar	+?
boastakántuvra	boastakántuvra	+?
váldokántuvra	váldokántuvra	+?
bargokántuvra	bargokántuvra	+?
politimeašttir	politimeašttir	+?
sosialkantuvra	sosialkantuvra	+?
sosialkántuvra	sosialkántuvra	+?
boazodoallokántuvra	boazodoallokántuvra	+?
politibálvá	politibálvá	+?
máilmmemeašttir	máilmmemeašttir	+?
politiguovlu	politiguovlu	+?
bearáš	bearáš	+?
biru	biru	+?
cuoŋumánnu	cuoŋumánnu	+?
departementa	departementa	+?
diibmo	diibmo	+?
distat	distat	+?
dárog	dárog	+?
eŋgelasgilla	eŋgelasgilla	+?
friddjaminukta	friddjaminukta	+?
fylkamánni	fylkamánni	+?
girjerájos	girjerájos	+?
guovllokántuvra	guovllokántuvra	+?
guovllokantuvra	guovllokantuvra	+?
guovllukántuvra	guovllukántuvra	+?
hálddáhus	hálddáhus	+?
johtočála	johtočála	+?
johtočálus	johtočálus	+?
gáfejá	gáfejá	+?
kalenddar	kalenddar	+?
kántuvra	kántuvra	+?
kilomehtar	kilomehtar	+?
lensmánni	lensmánni	+?
luo	luo	+?
lašmmohallan	lašmmohallan	+?
maŋŋebarga	maŋŋebarga	+?
mehtar	mehtar	+?
ministar	ministar	+?
minukta	minukta	+?
museá	museá	+?
máttarvánhen	máttarvánhen	+?
njealjes	njealjes	+?
politiijá	politiijá	+?
ressursa	ressursa	+?
sis-eana	sis-eana	+?
skerttehii	skerttehii	+?
sámidiggeválga	sámidiggeválga	+?
vahkoloahppa	vahkoloahppa	+?
vuossarga	vuossarga	+?
vuoss	vuoss	+?
vánhen	vánhen	+?
šukkuládagáhkku	šukkuládagáhkku	+?
šukkuládegáhkku	šukkuládegáhkku	+?
šukuládagáhkku	šukuládagáhkku	+?
šukuládegáhkku	šukuládegáhkku	+?
šukoládagáhkku	šukoládagáhkku	+?
šukoládegáhkku	šukoládegáhkku	+?
adišuvdna	adišuvdna	+?
kulturkantovra	kulturkantovra	+?
kulturkántuvra	kulturkántuvra	+?
generalgeahččaleapmi	generalgeahččaleapmi	+?
muovjamiessi	muovjamiessi	+?
našunálbušeahtta	našunálbušeahtta	+?
risvánhen	risvánhen	+?
siffár	siffár	+?
skuvlakantovra	skuvlakantovra	+?
sosialhoavda	sosialhoavda	+?
stášuvdna	stášuvdna	+?
sámiálbmotfoanda	sámiálbmotfoanda	+?
luondduf	luondduf	+?
finnmárkolaš	finnmárkolaš	+?
sámemišuvdna	sámemišuvdna	+?
sámiskuvla	sámiskuvla	+?
sámisearvi	sámisearvi	+?
kveana	kveana	+?
kapasitehtta	kapasitehtta	+?
klinenta	klinenta	+?
nubbingiella	nubbingiella	+?
dollar	dollar	+?
mánnavovdna	mánnavovdna	+?
miljun	miljun	+?
ballestallat	ballestallat	+?
cipmástit	cipmástit	+?
dihráidit	dihráidit	+?
fanjádit	fanjádit	+?
guođđelit	guođđelit	+?
reaškkehit	reaškkehit	+?
seavvelit	seavvelit	+?
šlieđđát	šlieđđát	+?
šuohkehit	šuohkehit	+?
deaddelit	deaddelit	+?
deaivadit	deaivadit	+?
digáštallat	digáštallat	+?
hálidit	hálidit	+?
jámalgit	jámalgit	+?
mánnat	mánnat	+?
mearredit	mearredit	+?
oahpasmuvvat	oahpasmuvvat	+?
oláhit	oláhit	+?
rehkenasttit	rehkenasttit	+?
rokkáhit	rokkáhit	+?
sihkarastit	sihkarastit	+?
vuohkáhit	vuohkáhit	+?
čágalduhttet	čágalduhttet	+?
oahpasnuvvat	oahpasnuvvat	+?
hirpmáhuvvat	hirpmáhuvvat	+?
sulástahttit	sulástahttit	+?
jávkkehit	jávkkehit	+?
