SME lemma pos: fad NOB lemma pos _ gt NOB lemma pos _ placeholder for action tag
njuoras A: ydmyk A; mild A; svak A _ øm A, mild A, svak A _ n
jábálaš A: velstående A; rik A _ rik A _ y
balddihahtti A: urovekkende A; skremmende A _ skremmende A _ y
boasttu- A: uriktig A _ feil A, uriktig A _ n
oahppameahttun A: uoppdragen A _ ulærd A _ n
dohkketmeahttun A: uholdbar A; uakseptabel A _ ubrukelig A, udugelig A, uakseptabel A _ n
ávdin A: ubebodd A; øde A _ øde A _ n
eahpečielggas A: uavklart A; uklar A _ uklar A _ n
áddjái A: tidkrevende A; sein A _ sein A, tidkrevende A _ n
váibbas A: søvnig A; trøtt A _ trøtt A _ n
seaggi A: sped A; smal A; tynn A _ tynn A, spinkel A _ n
bahánihkkán A: slem A _ uskikkelig A _ y
árvvas A: sjenerøs A; gavmild A _ generøs A, gavmild A _ n
starggas A: robust A; stiv A _ stiv A, stø A _ n
válmmaš A: rede A; ferdig A _ ferdig A _ n
mearkkalaš A: pussig A; merkelig A _ merkelig A _ y
oktageardán A: primitiv A; naiv A; enkel A _ enkel A _ y 
ebmui A: prektig A; flott A _ flott A _ n
nággár A: opposisjonell A; gjenstridig A _ sta A, stridig A _ n
jierbmái A: oppegående A; intelligent A; klok A; smart A _ klok A _ n
návccaheapme A: næringssvak A; svak A _ svak A, veik A _ n
dárogielat A: norsktalende A; norsk A; norskspråklig A _ norskspråklig A _ n
dárogiel A: norsk A; norskspråklig A _ norskspråklig A _ n
šlundi A: nedslått A _ motløs A, bedrøvet A _ n
suohtas A: moro A; morsom A; hyggelig A _ morsom A, hyggelig A _ n
hállái A: meddelsom A _ pratsom A _ n
máŋggabealat A: mangeartet A; allsidig A _ allsidig A, mangesidig A _ n
vigiheapme A: lytefri A; uskyldig A _ uskyldig A _ y
lágalaš A: lovmessig A; rettslig A; lovlig A _ lovlig A; rettsgyldig A _ n
eleš A: livskraftig A _ kvikk og livlig A; livsdyktig A; lengelevende A _ n
beakkálmas A: legendarisk A; kjent A _ kjent A, berømt A _ n
riikkaviidosaš A: landsomfattende A; landsdekkende A; nasjonal A _ riksdekkende A _ n
gelbbolaš A: kompetent A; verdig A _ dugelig A; verdig A _ n
vuoiŋŋalaš A: immateriell A; åndelig A; religiøs A; mental A _ åndelig A _ n
muittoheapme A: glemsk A _ glømsk A, glemsom A, distre A _ n
várrugas A: føre var A; var A _ forsiktig A _ n
máđoheapme A: formidabel A _ forskrekkelig A _ n
dáláš A: eksisterende A _ nåtidens N _ y
dálá A: eksisterende A _ nåtidig A _ y
láiki A: doven A _ lat A _ n
jállu A: djerv A; modig A _ modig A _ n
njuolgat A: direkte A; rett A _ rett A, bein A _ y
njálggat A: deilig A _ velsmakende A, søt A _ n
šealgat A: blinkende A _ blank A _ n
mearrideaddji A: avgjørende A _ bestemmende A _ n
anihahtti A: anvendelig A; anvendbar A _ brukbar A _ n
falli A: sportslig A; rask A _ rask A _ n
roastil A: uredd A _ dristig A _ n
dábálaš A: allmenn A; ordinær A; normal A; standard A; vanlig A _ vanlig A, alminnelig A _ n
erenoamáš A: særlig A; særskilt A; spesiell A _ spesiell A, ekstra A _ n
vásedin A: særlig A; særskilt A _ særskilt A _ n
ahkit A: trist A; kjedelig A _ kjedelig A, utrivelig A _ n
eaŋkil A: enkelt A; enkel A _ enkel A _ n
duhtavaš A: tilfreds A; fornøyd A _ fornøyd A _ n
geasuheaddji A: attraktiv A _ tiltrekkende A _ n
bivnnut A: attraktiv A; populær A _ omsvermet A, godt likt A _ n
jearggalaš A: konsekvent A; fornuftig A; rasjonell A _ fornuftig A _ n
čavgat A: streng A _ stram A _ y
goavvi A: streng A; vanskelig A _ hensynsløs A _ y
áddehahtti A: brukervennlig A; forståelig A _ forståelig A _ n
udju A: beskjeden A _ sjenert A _ n
girjái A: variert A; mangfoldig A _ spraglet A, flekket A _ y
dohkálaš A: forsvarlig A _ høvelig A, tjenlig A _ n
ráfálaš A: harmonisk A; fredelig A _ fredelig A _ n
soabalaš A: harmonisk A; fredelig A _ fredelig A, forsonlig A _ n
olgguldas A: ekstern A; ytre A _ ytre A, utvendig A _ n
roahkkat A: utadvendt A; åpen A _ freidig A _ n
čorgat A: ryddig A _ renslig A _ y
ovddit A: fremre A; foregående A _ tidligere A, foregående A, forrige A; fremre A _ n
ovddimus A: fremre A; første A _ først A, fremst A _ n
bargonávccalaš A: yrkesaktiv A _ arbeidsfør A _ n
heivvolaš A: hensiktsmessig A; egnet A; passelig A _ passelig A _ n
ávkkálaš A: hensiktsmessig A; nyttig A _ nyttig A; formålstjenlig A _ n
ovttalágan A: lik A _ samme slags A _ n
seammalágan A: lik A; tilsvarende A _ likedan A _ n
dárbbašmeahttun A: unødig A; unødvendig A _ unødvendig A _ n
soddjil A: dynamisk A; fleksibel A _ bøyelig A _ y
bistevaš A: permanent A; fast A; langvarig A _ varig A, fast A _ n
bissovaš A: permanent A; kronisk A; fast A _ vedvarende A _ n
njoahci A: sakte A; sein A; treg A; sen A _ sein A, langsom A _ n
ođđaáigásaš A: tidsriktig A; moderne A _ moderne A _ n
moivvas A: forvirrende A; uklar A _ uklar A, grumset A _ n
báhkas A: opphetet A; varm A _ varm A _ n
viiddis A: omfattende A; vid A; bred A _ vid A, utstrakt A _ n
alvvalaš A: offensiv A _ energisk A _ n
bahá A: ond A; alvorlig A _ sint A _ y
gutneheapme A: uverdig A; frekk A _ frekk A _ y
árvvoheapme A: uverdig A; vanskelig A _ vanskelig A, brysom A; verdiløs A _ n
seammasullasaš A: tilsvarende A; lignende A _ lignende A _ y
sullasaš A: tilsvarende A; liknende A; lignende A _ liknende A _ n
oskkáldas A: trofast A; lojal A _ pålitelig A _ y
ruđalaš A: finansiell A; økonomisk A; rik A _ pengemessig A; rik A _ y
gánnáhahtti A: bærekraftig A; lønnsom A _ lønnsom A _ y
bajimuš A: overordnet A _ øverst A _ y
bajit A: overordnet A; øvre A _ øvre A _ y
válddálaš A: uttrykkelig A; mektig A; myndig A _ mektig A, myndig A _ n
váilevaš A: mangelfull A; manglende A _ manglende A _ y
sámegielat A: samisk A _ samiskspråklig A _ n
vuosttaš A: første A; første A _ først A _ n
vuosttas A: første A; første A _ først A _ n
ovddemus A: første A _ først A _ n
vuosttamuš A: første A _ først A _ n
fiinnis A: flott A; fin A _ fin A _ n
almmolaš A: offisiell A; offentlig A _ offentlig A, offisiell A _ n
beaktil A: næringsrik A; effektiv A _ næringsrik A _ y
álbmái A: næringsrik A _ kraftig A _ y
boahtteáigásaš A: fremtidsrettet A; fremtidig A; framtidig A _ fremtidsrettet A, fremtidig A _ n
liekkus A: varm A; hyggelig A _ hyggelig A, koselig A _ n
dearvvaš A: sunn A; frisk A _ frisk A _ n
dárki A: viss A; sikker A _ viss A, sikker A _ n
dihto A: viss A; bestemt A _ viss A _ y
vissis A: viss A; bestemt A; sikker A _ sikker A; bestemt A, viss A _ n
duihmi A: dum A _ dum A, tungnem A _ n
ovddolaš A: underlig A; merkelig A _ underlig A, merkelig A _ n
ártet A: underlig A; merkelig A; rar A _ rar A, merkelig A _ n
eaimmaskas A: underlig A _ snodig A, underlig A _ n
ealas A: livlig A; kvikk A; levende A _ livlig A, kvikk A, energisk A _ n
virkui A: livlig A; kvikk A; vital A _ kvikk A, livlig A _ n
vitmat A: kvikk A; skarp A; dyktig A _ lærenem A, skarp A _ n
áŋgir A: flittig A; ambisiøs A; ivrig A _ ivrig A, flittig A _ n
viššal A: flittig A; aktiv A _ flittig A _ n
ealjár A: flittig A; dyktig A _ flittig A _ n
fasti A: stygg A; fæl A _ stygg A, fæl A _ n
čáppat A: fin A; pen A; vakker A _ pen A _ n
luovus A: fri A; løs A _ løs A, laus A _ n
veaittalas A: fri A _ fri A, på egen hånd A _ n
headju A: dårlig A; svak A; negativ A _ dårlig A, skral A _ n
heittot A: dårlig A; svak A _ dårlig A, svak A _ n
fuotni A: dårlig A; svak A; negativ A _ dårlig A _ n
čoaskkis A: kald A _ kjølig A _ y
geatnegas A: ansvarlig A _ pliktig A; ansvarlig A _ n
návccalaš A: sterk A; dyktig A _ sterk A, dyktig A _ n
searalaš A: sterk A; dyktig A; selvstendig A _ sterk A, dyktig A _ n
gievra A: sterk A; sterk A; sterk A _ sterk A _ n
nanus A: sterk A _ solid A, sterk A _ n
gárži A: smal A; trang A _ trang A, smal A _ n
hiđis A: sein A; sen A _ sein A _ n
siivui A: lydig A; rolig A; snill A _ snill A, rolig A _ n
suvrris A: sur A; sur A _ sur A _ n
jiesas A: sur A _ sur A, blåsur A _ n
lihkolaš A: heldig A; lykkelig A _ lykkelig A, heldig A _ n
lámis A: ufør A _ vanfør A, ufør A, lam A _ n
lášmat A: smidig A; snar A _ smidig A, snar A _ n
movttet A: optimistisk A; glad A _ i godt humør A, optimistisk A _ n
mášoheapme A: urolig A _ rastløs A, urolig A _ n
riekta A: rett A; riktig A; korrekt A _ riktig A _ n
ollislaš A: fullverdig A; total A _ fullverdig A _ n
ovttageardán A: naiv A; ensidig A; enkel A _ enfoldig A, naiv A _ n
rabas A: åpen A; ledig A _ åpen A _ y
rehálaš A: hederlig A; ærlig A; rettferdig A _ ærlig A, hederlig A _ n
sierra A: særskilt A _ særskilt A; adskilt A _ n
villas A: vill A _ vill A, vilter A _ n
vilddas A: vill A _ ustyrlig A, vilter A _ n
bastil A: skarp A; kvass A _ kvass A _ n
unni A: lav A; liten A _ liten A _ n
váivái A: vanskelig A; ubehagelig A _ vanskelig A, ubehagelig A _ n
váigat A: vanskelig A; kjedelig A _ kjedelig A, vanskelig A _ n
čavddis A: urørt A _ tett A, uten hull A; urørt A _ n
čielggas A: tydelig A; klar A _ klar A, tydelig A _ n
olmmošlaš A: høflig A; folkelig A; menneskelig A; grei A _ høflig A; menneskelig A _ n
iešdáhtolaš A: frivillig A _ forsettlig A _ y
oktonas A: ensom A _ alene A _ n
buiga A: ekte A _ ekte A, virkelig A _ n
ilolaš A: glad A; gledelig A _ gledelig A _ y
almmus A: tilgjengelig A; offentlig A _ offentlig A _ y
issoras A: enorm A _ forferdelig A _ n
máŧoheapme A: enorm A; umulig A _ umulig A _ y
áibmadas A: enorm A _ kolossal A _ n
gaskaboddosaš A: foreløpig A; midlertidig A _ midlertidig A _ n
jeagoheapme A: tverr A _ ulydig A _ n
govdat A: stolt A; bred A _ brei A, bred A _ n
čeavlái A: stolt A _ overlegen A, hoven A _ y
vuovdnái A: stolt A _ pågående A, energisk A; staselig A _ n
ilgat A: voldsom A _ nifs A _ n
stáđis A: stabil A; fast A _ stø A, fast A _ n
otná A: dag N _ dagens N _ n
otnáš A: dag N _ dagens N _ n
mávssolaš A: verdifull A; viktig A _ dyrebar A; viktig A _ n
muttát A: moderat A; passelig A; rimelig A _ passelig A _ n
rašši A: sårbar A; svak A _ veik A, skjør A _ n
agálaš A: uendelig A; evig A _ evig A _ n
jáhkehahtti A: troverdig A _ trolig A, sannsynlig A _ n
vuollásaš A: underliggende A _ underlagt A _ y
imaš A: påfallende A; merkelig A; rar A _ merkelig A _ n
risttalaš A: kristelig A; kristen A _ kristen A _ n
kristtalaš A: kristelig A; kristen A _ kristen A _ n
jaskat A: stille A; rolig A; taus A _ rolig A, stille A, taus A _ n
albma A: skikkelig A _ ordentlig A, skikkelig A _ n
allat A: høy A _ høy A, høg A _ n
amas A: fremmed A; ukjent A _ fremmed A, ukjent A _ n
njárbat A: tynn A _ tynn A; glissen A _ n
goiddas A: tynn A; svak A _ tynn A, svak A _ n
rihča A: bitter A _ besk A, bitter A _ n
bealjeheapme A: døv A _ døv A, tunghørt A _ n
bávččas A: vond A _ vond A, smertefull A _ n
diehttalas A: naturlig A _ viss A, naturlig A _ n
dimis A: myk A; mjuk A _ myk A, mjuk A _ n
divrras A: dyr A; kostbar A _ dyr A, kostbar A _ n
doaŋgi A: stiv A _ stiv A, støl A, slapp A _ n
sieiva A: vanlig A; ren A _ vanlig A, alminnelig A _ y
dárkil A: grundig A _ nøyaktig A, grundig A _ n
vuđolaš A: grundig A; grunnleggende A _ grundig A, grunnleggende A _ n
earálágan A: annerledes A; ulik A; forskjellig A _ ulik A, forskjellig A, annerledes A _ n
nuppelágan A: annerledes A; forskjellig A _ annerledes A, forskjellig A _ n
unohas A: ubehagelig A; uheldig A _ uhøvelig A, ubehagelig A _ n
eatnjehas A: ubehagelig A _ ubehagelig A, nifs A _ n
gallji A: vid A _ vid A, rommelig A _ n
suohkat A: tykk A; frodig A _ tjukk A, tett A _ n
assái A: tykk A _ tjukk A _ n
gassat A: tykk A; dyp A; dyp A; grov A _ tykk A; dyp A; dyp A, grov A _ n
váfi A: tykk A; svær A; trygg A; sikker A; frodig A _ svær A, tjukk A; sikker A, trygg A _ n
roakkas A: dyp A; grov A _ dyp A, grov A _ n
roattus A: dyp A; grov A _ grov A, dyp A _ n
roavis A: grov A; rå A _ grov A _ n
healpu A: lett A _ lett A, lettvint A _ n
gillil A: utrettelig A _ utrettelig A, tålmodig A _ n
árjjalaš A: ivrig A; aktiv A _ ivrig A, energisk A _ n
givas A: ivrig A; modig A _ ivrig A, modig A _ n
guorus A: tom A; ledig A _ tom A _ y
válmmas A: ferdig A; klar A _ ferdig A, klar A _ n
gárvvis A: ferdig A; klar A _ ferdig A _ y
hávski A: morsom A; hyggelig A _ morsom A, hyggelig A _ n
hearvái A: morsom A _ herlig A, morsom A _ n
hávskái A: morsom A; hyggelig A _ hyggelig A, morsom A _ n
somá A: morsom A; artig A _ morsom A, artig A _ n
vuogas A: passelig A _ høvelig A, passelig A, behagelig A _ n
hálbi A: billig A; rimelig A _ billig A _ n
smáđáhkis A: hyggelig A; grei A _ hyggelig A _ n
iešlágan A: merkelig A _ merkelig A, noe for seg selv A _ n
jahkásaš A: årlig A _ årsgammel A; årlig A _ n
lodji A: rolig A _ tam A, rolig A _ n
viissis A: klok A _ klok A, vis A _ n
joavdelas A: unødvendig A _ unyttig A, unødvendig A _ n
loažžat A: løs A _ slapp A, løs A _ n
vejolaš A: mulig A; eventuell A _ mulig A _ n
njuoskkas A: våt A; rå A _ våt A, bløt A _ y
obbalaš A: generell A; total A _ generell A, fullstendig A _ n
vuoigat A: riktig A _ åpenhjertig A; riktig A _ n
ráhpat A: flink A _ bra A, flink A _ n
čeahppi A: flink A; dyktig A _ flink A _ n
siskkáldas A: intern A _ det indre A, innbyrdes A, intern A _ n
sitkat A: seig A _ seig A, utholdende A _ n
áššálaš A: skyldig A; saklig A _ skyldig A, tiltalt A _ y
sáhkkái A: nysgjerrig A _ nysgjerrig A; snakkesalig A _ n
sáhkkii A: nysgjerrig A _ nysgjerrig A; snakkesalig A _ n
vielgat A: hvit A _ kvit A, hvit A _ n
čalmmeheapme A: svaksynt A _ blind A, svaksynt A _ n
čihččet A: sjuende A; syvende A _ sjuende A _ n
čáppis A: pen A; vakker A _ pen A, vakker A _ n
eanaš A: mange A _ det meste A, de fleste A _ n
eanas A: mange A _ det meste A _ n
fávru A: vakker A _ skjønn A, vakker A _ n
hámálaš A: vakker A _ staselig A, vakker A _ n
láđis A: mild A _ mild A, blid A _ n
ovddeš A: gammel A; tidlig A _ tidligere A _ n
dološ A: gammel A _ gammeldags A _ y
ollis A: full A; hel A _ hel A, full A _ n
dievaslaš A: full A _ fullstendig A _ n
dievas A: full A _ full A, fullstendig A _ n
oadjebas A: trygg A; trygg A _ trygg A _ n
dorvvolaš A: trygg A; trygg A; sikker A _ trygg A, tillitsfull A _ n
sihkar A: trygg A; trygg A; sikker A; sikker A _ sikker A _ n
vealtameahttun A: nødvendig A _ uunngåelig A _ y
geamus A: uklar A _ uklar A, disig A _ n
iešguđetlágan A: ulik A; forskjellig A _ forskjellige slags A _ n
sierranas A: forskjellig A _ atskilt A _ n
jođán A: rask A; snar A _ hurtig A, rask A _ n
johtil A: rask A; snar A _ hurtig A _ n
valli A: rask A _ hurtig A, rask A _ n
stánddalaš A: dyktig A; stødig A _ stødig A, dyktig A _ n
fávdnát A: dyktig A _ bra A, dyktig A _ n
geahnoheapme A: svak A _ udugelig A, svak A _ n
čuorbi A: svak A _ klønete A, udugelig A _ n
šiervi A: svak A _ spinkel A, svak A _ n
sealvi A: klar A _ klar A, normal A _ n
šearrat A: klar A _ blank A, klar A _ n
girkat A: klar A _ klar A, skinnende A _ n
oppa A: hel A _ hel A, all A _ n
duostil A: modig A _ dristig A _ n
gummá A: rar A _ rart A _ n
háhppil A: snar A _ kjapp A, snar A _ n
iešráđálaš A: selvstendig A; uavhengig A _ egenmektig A, selvstendig A _ n
jalgat A: jevn A _ slett A, jevn A _ n
lagas A: nær A _ nærliggende A, nær A _ n
buhtis A: ren A _ rein A _ n
eallilan A: voksen A _ godt voksen A, som har levd en stund A _ n
stuorebuš A: stor A _ litt større A _ n
luohttevaš A: stødig A _ tillitsfull A _ n
vuoiggalaš A: rettferdig A _ redelig A _ n
vánhurskkis A: rettferdig A _ gudfryktig A; rettferdig A _ n
positiivvalaš A: positiv A; positiv A _ positiv A _ n
positiiva A: positiv A; positiv A _ positiv A _ n
negatiiva A: negativ A; negativ A _ negativ A _ n
dorvvuheapme A: usikker A _ motløs A _ n
nationála A: nasjonal A; nasjonal A _ nasjonal A _ n
maŋit A: sist A _ bakre A _ n
hillján A: sen A _ langsom A, makelig A _ n
áigeguovdil A: aktuell A _ tidsaktuell A _ n
guoskevaš A: aktuell A _ angående A _ n
oskkolaš A: religiøs A _ troende A _ n
duohta A: reell A _ sann A _ n
lihkoheapme A: uheldig A _ ulykkelig A _ y
dávggas A: fleksibel A _ elastisk A, spenstig A _ n
juohkelágan A: allsidig A _ allslags A _ n
dássásaš A: likeverdig A _ jevnbyrdig A; jevnhøy A _ n
bolffas A: frodig A _ lodden A _ y
