SME lemma pos: fad NOB lemma pos _ gt NOB lemma pos _ placeholder for action tag
dovdat V: kjennskap N; føle V; kjenne V; kjenne V _ kjenne V; føle V _ n
čoahkkinastit V: ha møte V _ holde møte V _ n
báidnit V: prege V; påvirke V _ farge av V; påvirke V _ n
láhčit V: tilrettelegge V _ re V _ y
áŋgiruššat V: satse V _ ivre for V _ m
čájehit V: opptre V; vise V _ vise V _ n
láhttet V: opptre V; agere V _ bære seg at V _ n
áđđestallat V: mime V; imitere V _ herme V _ n
doapmat V: skynde V _ skynde seg V _ n
jaskkodit V: stilne V _ tie V _ y
boahtit V: møte frem V; komme V _ komme V _ n
hoigadit V: dytte V; ekskludere V; skyve V _ skyve V _ n
vuostálastit V: gå i mot V; bekjempe V _ protestere V; gjøre motstand V _ n
leaikkastallat V: skøye V _ spøke V _ n
árvidit V: spekulere V; skjønne V; forutse V; anta V _ skjønne V; gjette V _ m
vuortnuhit V: røyne V; plage V; tvinge V; presse V _ plage V; tvinge V, presse V _ n
hutkat V: uteksperimentere V; skape V _ finne på V, dikte opp V _ n
vihahit V: vigsle V; vie V; innvie V _ vie V, innvie V _ n
govvidit V: portrettere V; skissere V; gjenspeile V; beskrive V; illustrere V _ beskrive V, illustrere V _ n
boarásmuvvat V: eldes V _ bli gammel V _ n
reaškit V: gapskratte V _ skratte V _ n
veaddit V: tjore V _ holde i tjor V _ n
ahkiduššat V: mistrives V; vantrives V _ vantrives V _ n
váccašit V: rusle V _ spasere V _ n
čiŋahit V: utsmykke V; pynte V _ pynte V _ y
gevret V: bortvise V; utvise V; pålegge V _ kommandere V _ y
spežžet V: klappe V _ daske V _ y
gaikkihit V: røske V _ rykke V _ n
nimmorit V: murre V; beklage V _ beklage V _ y
árpmihit V: skåne V _ forbarme seg V _ y
márrat V: strømme V _ bruse V, dure V; innsige V _ n
ovttastit V: konsolidere V; forene V; kombinere V _ forene V _ y
gáržudit V: avgrense V; snevre V; innskrenke V; begrense V _ innskrenke V _ y
ráddjet V: avgrense V; begrense V _ begrense V _ n
leavvat V: bre V; spre V _ bre seg V _ n
mearridit V: fastsette V; vedta V; bestemme V _ bestemme V _ n
virgáibidjat V: tilsette V; konstituere V; ansette V _ ansette V _ n
hilgut V: forkaste V; avslå V; avvise V _ vrake V; avslå V, avvise V _ n
bajidit V: oppjustere V; løfte V; øke V; heve V _ løfte V, heve V _ n
átnut V: begjære V; be V _ be V, tigge V _ n
badjelgeahččat V: nedprioritere V; neglisjere V; overkjøre V; overse V _ forakte V, nedvurdere V _ m
háddjet V: splitte V; fragmentere V; spre V _ rote V, spre V _ m
buoridit V: bedre V; forbedre V _ forbedre V, rette på V _ n
čiehkat V: skjule V; gjemme V _ gjømme V _ n
čiegadit V: skjule V; gjemme V _ gjemme V _ n
goarrut V: sømme V; sy V _ sy V _ n
árvvoštallat V: evaluere V; vurdere V; kritisere V _ bedømme V; kritisere V; vurdere V _ n
duhtat V: nøye V _ være fornøyd V _ n
ođasmahttit V: modernisere V; revidere V; oppgradere V; fornye V; oppdatere V _ oppdatere V; fornye V _ n
joatkašuvvat V: vedvare V; videreføre V; fortsette V _ fortsettes V _ m
dáhkidit V: forsikre V; bekrefte V; garantere V; sikre V _ garantere V, bekrefte V; forsikre om V; kausjonere V _ n
fuomášuhttit V: fokusere V; belyse V _ gjøre oppmerksom på V _ n
duolbmat V: trå V; undervurdere V; overkjøre V; tråkke V; tråkke V; trampe V _ trø V, tråkke V _ n
buokčalit V: dukke V; dykke V _ dykke V _ n
suokkardit V: utforske V; granske V; drøfte V _ granske V _ m
muitalit V: informere V; fortelle V; omtale V; opplyse V _ fortelle V _ n
gulahit V: informere V; kunngjøre V; erklære V _ kunngjøre V _ n
buohtastahttit V: jamføre V; sammenligne V; sammenlikne V _ sammenlikne V _ m
veardidit V: jamføre V; sammenligne V; vurdere V _ sammenligne V _ m
beahtahallat V: skuffe V _ bli skuffet V; bli bedratt V _ n
háhkat V: anskaffe V; opparbeide V; skaffe V; rekruttere V _ skaffe V; rekruttere V _ n
ovttastahttit V: samordne V; forene V; inkorporere V; kombinere V; integrere V; innlemme V _ forene V, inkorporere V; kombinere V _ n
ođastit V: revidere V; fornye V; oppdatere V _ fornye V _ n
dárkkistit V: revidere V; kontrollere V; overprøve V; undersøke V _ kontrollere V, overprøve V _ n
guorahallat V: gjennomgå V; undersøke V; drøfte V _ undersøke V _ n
cealkit V: fastslå V; felle V; nedfelle V; si V; uttale V; erklære V; omtale V; uttrykke V _ si V, uttale V _ n
dovddastit V: tilkjenne V; erkjenne V _ innrømme V, bekjenne V _ n
mieđihit V: tilkjenne V; erkjenne V _ bifalle V; erkjenne V _ n
luoikat V: utlåne V; låne V _ låne bort V _ n
čavget V: skjerpe V; stramme V _ stramme V, stramme inn V; sette igang V _ n
dearvvahit V: hilse V _ hilse på V _ n
váikkuhit V: bidra V; påvirke V _ virke V; påvirke V _ n
veahkehit V: bidra V; hjelpe V _ hjelpe V, assistere V _ n
dagahit V: bidra V; føre V _ forårsake V _ n
dieđihit V: rapportere V; oppgi V; orientere V; melde V; melde V; kunngjøre V; innmelde V _ meddele V, orientere V _ n
jorggihit V: vippe V; snu V _ snu V, vende seg V _ n
sihkkut V: nulle V; slette V; sløyfe V; tørke V; stryke V; fjerne V _ tørke V; stryke ut V, fjerne V _ n
rehkenastit V: kalkulere V; regne V; beregne V _ regne V _ n
šláttardit V: tyste V _ sladre V _ n
sihkastit V: slette V; viske V; tørke V; male V _ tørke V; male V _ m
oahpahit V: skolere V; opplære V; undervise V; lære V _ undervise V, lære V _ n
dinet V: opptjene V; tjene V _ tjene V _ n
čollet V: sløye V _ sløye fisk V; gulpe V _ n
navdit V: synse V; tro V; kalle V; anta V; mene V _ kalle V; mene V, tro V _ n
váidit V: politianmelde V; påklage V; klage V; anklage V _ klage V, anklage V; anmelde V _ n
ruostut V: rustne V _ ruste V, bli rusten V _ n
čilget V: spesifisere V; skissere V; avklare V; forklare V; definere V _ forklare V _ n
geatnegahttit V: forplikte V; pålegge V _ plikte V _ m
čuohppat V: sakse V; hugge V; klippe V _ skjære V _ m
sáddet V: oversende V; sende V _ sende V _ n
doaimmahit V: utøve V; utføre V; drive V; drive V _ utrette V, utføre V _n 
cuoigut V: peke V; påpeke V _ påpeke V, gjøre oppmerksom på V _ n
cuiget V: peke V; påpeke V _ påpeke V _ y
čujuhit V: peke V; påvise V; henvise V; påpeke V; vise V; markere V _ markere V; utpeke V _ m
geiget V: avlevere V; overlevere V _ strekke ut V, rekke fram V _ m
geahččalit V: utprøve V; prøve V; forsøke V _ prøve V _ n
doalvut V: havne V; bringe V; eksportere V _ bringe bort V, føre bort V; eksportere V _ n
beahttit V: svikte V _ bedra V, narre V _ y
hállat V: snakke V; orde V; snakke V _ snakke V _ n
hupmat V: snakke V; tale V; snakke V; uttrykke V _ snakke V _ n
vákšut V: overvåke V _ granske nøye V _ y
gozihit V: overvåke V _ vokte V _ y
dohkkehit V: anerkjenne V; akseptere V; vedta V; godkjenne V _ godta V, akseptere V, bifalle V, knesette V; godkjenne V _ n
molsut V: rullere V; bytte V; skifte V _ skifte V, bytte V _ n
deattuhit V: vektlegge V; understreke V; fremheve V; poengtere V; påpeke V _ betone V, fremheve V, poengtere V _ m
rávvet V: tilrå V; anbefale V _ formane V _ y
jienastit V: votere V; nedstemme V; stemme V _ stemme V _ n
vuovdit V: omsette V; selge V _ selge V _ n
válddahit V: omhandle V; beskrive V _ beskrive V _ n
máinnašit V: omhandle V; omtale V _ omtale V, rose V _ n
addit V: yte V; levere V; gi V _ gi V _ n
dáhpáhuvvat V: foregå V; forekomme V; skje V _ hende V, skje V _ n
láittastuvvat V: kjede V; vantrives V _ vantrives V _ y
suorggahit V: ryste V; skremme V _ skremme V _ n
oaidnit V: øyne V; se V _ se V _ n
láitit V: fordømme V; kritisere V _ klandre V, kritisere V _ n
čuollat V: hugge V; hogge V _ hogge V _ n
murret V: hugge V _ sage eller hogge ved V _ n
láigohit V: innleie V; leie V _ leie av noen V _ m
ceahkkut V: tømre V _ skjære hakk V _ y
ravgat V: ramle V _ falle over ende V; sprette V _ n
ráfehuhttit V: uroe V; forstyrre V _ forstyrre V, sjenere V _ n
rihkkut V: overskride V; bryte V _ overtre V, bryte V, misligholde V _ n
rasttildit V: overskride V; passere V; krysse V _ krysse V _ n
sirdit V: omdisponere V; overføre V; flytte V _ flytte V _ m
ásaiduvvat V: bosette V _ begynne å føle seg hjemme V, slå seg ned V _ m
ássat V: bosette V; bo V _ bo V _ y
vuođđudit V: konstituere V; oppnevne V; bygge V; etablere V; opprette V _ grunnlegge V _ m
ájihit V: forsinke V; forhindre V _ hefte bort V _ n
maŋŋonit V: forsinke V _ bli forsinket V _ n
čiekŋudit V: utdype V; fordype V _ fordype V _ n
darvehit V: fange V; klistre V _ feste V, klistre V, klebe V _ m
lonohallat V: utveksle V; bytte V; skifte V _ skifte V; bytte med hverandre V _ m
lonuhit V: utveksle V; bytte V; skifte V _ heve V; bytte V _ n
oadjudit V: trygge V _ gjøre trygg V _ n
duođaštit V: dokumentere V; attestere V; bekrefte V _ bekrefte V, bevitne V, attestere V; godtgjøre V _ m
rahčat V: anstrenge V; slite V; kjempe V _ streve V _ n
beasahit V: sleppe V; miste V _ miste V _ n
bilidit V: skjemme V; skade V; ødelegge V _ ødelegge V _ n
goallostit V: lenke V _ binde sammen etter hverandre V _ n
vuodjat V: påkjøre V; svømme V _ svømme V _ n
bassat V: rundvaske V; vaske V _ vaske V _ n
ávkkuhit V: monne V _ nytte V, gagne V _ n
goddit V: felle V; myrde V; drepe V _ drepe V _ n
báhčit V: felle V; skyte V; stikke V _ skyte V; stikke V _ n
njeaidit V: felle V; sprenge V; redusere V _ velte V _ m
rivvet V: frata V; røve V _ røve V, ta med makt V; tackle V _ n
manahit V: frata V; miste V; fjerne V _ miste V _ n
atnit V: anse V; benytte V; bruke V _ bruke V; anse for V; inneha V _ n
cegget V: stille V; etablere V; opprette V _ reise opp V _ m
luoitit V: overlate V; slippe V; løse V _ slippe V, løse V _ m
fievrridit V: overføre V; videreføre V; føre V; frakte V; eksportere V _ frakte V, ha med seg V _ m
luvvet V: frigi V; frita V; løse V _ løse V _ m
sierranit V: separere V; skilles V; skille V _ skilles V, skille seg ut V _ n
vuoitit V: overkomme V; vinne V _ vinne V _ y
boradit V: lunsje V; spise V _ spise V, ete V, ha et måltid V _ n
guhkidit V: prolongere V; forlenge V _ forlenge V _ n
ságastit V: orde V; tale V; snakke V _ samtale V _ n
álggahit V: iverksette V; starte V; opprette V _ få i gang V _ m
vásihit V: oppleves V; oppleve V _ erfare V, oppleve V _ n
smiehttat V: reflektere V; tenke V _ tenke V, fundere V _ n
joatkit V: videreføre V; fortsette V _ skjøte V; fortsette V _ n
vuolláičállit V: signere V; underskrive V _ underskrive V _ n
doahttalit V: overholde V; respektere V _ akte V, ta hensyn til V _ m
čuovvut V: overholde V; følge V _ følge V _ n
doallat V: overholde V; avholde V; abonnere V; holde V; holde V; holde V _ holde V _ n
máksit V: utbetale V; bety V; belaste V; betale V _ betale V; koste V; bety V _ n
deavdit V: oppfylle V; fylle V _ fylle V _ n
ollašuhttit V: oppfylle V; gjennomføre V; fullføre V _ fullføre V _ m
ollašuvvat V: oppfylle V; oppnå V _ gjennomføres V _ m
sárgut V: skissere V; tegne V _ streke V, tegne V, risse V _ n
seaivut V: ankomme V; lande V _ dale ned V; sveve V _ n
dubmehallat V: domfelle V _ bli dømt V _ n
dubmet V: domfelle V; dømme V _ dømme V _ n
dovddahit V: signalisere V; uttrykke V _ røpe V _ n
ipmirdit V: begripe V; skjønne V; oppfatte V; forstå V _ forstå V, skjønne V _ n
buktit V: overlevere V; bringe V; medføre V _ bringe V _ m
gaskkustit V: overlevere V; formidle V _ formidle V _ n
sirdašuvvat V: forskyve V _ flytte på seg V _ m
sárdnidit V: forkynne V; preke V; tale V _ preke V, tale V _ n
čállit V: protokollføre V; skrive V _ skrive V, notere V; rispe V; råskjære fisk V _ n
diđoštit V: befare V _ innhente opplysninger V, få klarhet i V _ n
barggahit V: aktivisere V _ sysselsette V _ n
nágget V: insistere V; påstå V _ krangle V; påstå V _ n
bissehit V: opphøre V; stoppe V; stanse V; undergrave V _ stoppe V _ n
bagadallat V: veilede V; beskrive V; instruere V _ beskrive V; instruere V _ y
bagadit V: veilede V; oppdra V; refse V; instruere V _ oppdra V, rettlede V; straffe V, refse V _ n
heaittihit V: nedlegge V; avslutte V; avvikle V; oppheve V _ avslutte V; avvikle V _ n
bávkalit V: sprenge V; smelle V _ smelle V, fyre av V _ n
cuvket V: sprenge V _ knuse V; veksle V _ n
vurket V: arkivere V; oppbevare V; lagre V _ oppbevare V; lagre V _ y
nannet V: lovfeste V; styrke V; bekrefte V; sikre V _ styrke V; bekrefte V _ n
jođihit V: ledes V; føre V; dominere V; drive V; lede V _ lede V, styre V _ n
guoddalit V: anke V; påklage V; anklage V _ klage på V, anklage V _ m
čatnat V: knyte V; binde V; knytte V _ binde V, forbinde V, kople V _ n
vuolidit V: avkorte V; redusere V _ senke V _ m
áidut V: gjerde V _ inngjerde V _ n
namuhit V: tilføre V; omtale V; nevne V _ nevne V _ m
bálkáhit V: premiere V; engasjere V; leie V; betale V _ ansette V; leie V; betale V _ m
dásset V: balansere V; utjevne V; stabilisere V _ jamne V, jevne V; stabilisere V _ m
molsašuddat V: variere V _ bli forandret V _ m
čielggadit V: utrede V; avklare V; forklare V _ forklare V _ y
jevdet V: utjevne V _ jevne ut V _ n
ráhkadit V: utarbeide V; lage V; skape V _ lage V _ n
ráhkadahttit V: utarbeide V _ få noen til å lage V _ n
viššat V: tørre V; tore V; orke V _ orke V, gidde V _ m
duostat V: tørre V; våge V; tore V _ våge V, tore V _ m
geasehit V: transportere V; kjøre V; frakte V _ kjøre V, frakte V _ n
illastit V: torturere V _ mishandle V _ n
deattašit V: taste V; trykke V _ trykke V _ m
goaridit V: svekke V; tappe V; undergrave V _ vanskjøtte V _ m
hedjonit V: svekke V _ bli svak V _ n
riidit V: stride V; forhindre V; nekte V _ nekte V; forhindre V _ m
njáhkat V: snike V _ smyge V _ n
njágahit V: snike V _ liste seg til noe V _ n
sivahallat V: skylde V; påtale V; beskylde V; anklage V _ anklage for V, påtale V _ m
šiggut V: skjelle V _ hysse på V _ n
lápmašuvvat V: skamslå V; skade V _ bli vanfør V, bli skadet V _ n
buhtistit V: rengjøre V; rense V _ reingjøre V, rense V _ n
čuohcat V: ramme V; påvirke V; berøre V _ påvirke V, berøre V _ n
jáhkihit V: overbevise V _ få til å tro V _ m
eattehit V: opprøre V _ bli sint V _ n
movttáskit V: oppløfte V _ bli glad V, bli oppmuntret V _ n
boltut V: oppkjøre V; brøyte V _ rote opp V, grave opp V _ m
fáhtet V: oppfange V _ få tak i V _ n
lahkanit V: nærme V _ nærme seg V _ n
lahkonit V: nærme V _ nærme seg V _ n
deaivat V: møte V; treffe V; treffe V _ treffe V _ n
deaivvadit V: møte V; treffe V; møtes V _ møtes V _ n
gávnnadit V: møte V; møtes V _ møtes V _ n
duostut V: møte V _ ta imot V _ n
dustet V: møte V; dempe V _ dempe V; ta imot V _ n
deaividit V: møte V _ inntreffe V _ m
muittuhit V: minne V _ påminne V, minne om V _ n
nagadit V: makte V; klare V _ greie V, klare V _ n
gielistit V: lyve V; lyge V _ lyge V _ n
ealihit V: livnære V _ livberge V _ y
gillát V: lide V; tåle V _ tåle V, holde ut V _ y
biidnašuvvat V: lide V _ pines V _ n
gárrut V: kvie V _ få seg til å gjøre noe V _ n
fuomášit V: konstatere V; oppdage V; merke V _ oppdage V _ n
gávnnahit V: konstatere V; finne V _ finne ut V _ n
jávohuhttit V: kneble V _ få til å tystne V _ n
gárvodit V: kle V _ kle på seg V _ n
nuoladit V: kle V _ kle av seg V _ n
čoalkit V: klapre V; banke V _ knakke V, banke V _ n
bálkásit V: kassere V _ gå til spille V _ n
sahet V: kappe V; sage V _ sage V _ n
áimmahuššat V: ivareta V _ holde i hevd V, ta vare på V _ n
vuhtiiváldit V: ivareta V _ ta hensyn til V _ n
fuolahit V: ivareta V; sørge V _ sørge for V _ n
fátmmastit V: involvere V; omfavne V; omfatte V _ omfavne V _ m
sorrat V: involvere V _ vase sammen V _ n
hoahpuhit V: intensivere V; forsere V _ påskynde V _ m
huikit V: hoie V; rope V _ rope V _ y
hehttet V: hemme V; forhindre V; forebygge V; holde V; hindre V _ hindre V, forhindre V _ n
speadjalastit V: gjenspeile V _ avspeile V _ n
buvttihit V: føre V; nå V; skape V _ rekke V, nå V _ m
vearránit V: forverre V _ bli verre V _ n
hálddašit V: forvalte V; beherske V; betjene V; administrere V _ rå over V; administrere V; beherske V; betjene V _ n
eaktudit V: forutsette V _ ta forbehold V _ y
válbmet V: ferdigstille V; fullføre V _ gjøre ferdig V _ m
ohcalit V: etterspørre V; etterlyse V; søke V; savne V _ savne V, lengte etter V _ m
jearahit V: etterspørre V; intervjue V; spørre V _ intervjue V, spørre V _ n
váillahit V: etterlyse V; savne V _ savne V _ m
smiehtadit V: dvele V; tenke V _ tenke V, gruble V _ n
rámidit V: berømme V _ rose V, prise V _ n
rábmot V: berømme V; skryte V _ skryte V; rose V _ n
mearkkašit V: bemerke V; bety V; innebære V _ merke seg V, notere V; bety V _ n
váivašuvvat V: bekymre V _ plages V _ m
vuorjašuvvat V: bekymre V _ plages V _ m
vuosttaldit V: bekjempe V _ protestere V, motarbeide V, opponere mot V _ n
illosit V: begeistre V _ bli glad V _ n
várret V: avsette V _ advare V; sette av V _ n
čielgat V: avklare V _ klarne V, bli klar V _ n
vuoddját V: kjøre avsted V _ kjøre av sted V _ n
girdilit V: fly V _ fly avgårde V _ n
nanosmahttit V: styrke V; forsterke V _ styrke V, forsterke V _ n
vuorjat V: plage V _ plage V, sjenere V _ n
váivvidit V: plage V _ plage V, bry med V _ n
givssidit V: plage V; mobbe V _ mobbe V, plage V, pine V _ n
iskat V: prøve V; undersøke V _ undersøke V, prøve V _ n
viggat V: prøve V; forsøke V _ prøve V, streve V _ n
geahččaladdat V: prøve V; eksperimentere V _ eksperimentere V _ n
suhkat V: ro V _ ro V; gynge V _ n
suvdit V: ro V _ ferge V, frakte i båt V _ n
šiehtadit V: avtale V; forhandle V _ avtale V _ y
šiehttat V: avtale V _ få plass V; bli enig V _ n
stoahkat V: leke V _ støye V; leke V _ n
fierrat V: rulle V _ rulle V; rase ned V _ n
jorrat V: rulle V _ dreie V, gå rundt V _ n
fieradit V: rulle V _ rulle V, tumle V _ n
fierralit V: rulle V _ rulle V; dette V, falle overende V _ n
čohkohallat V: sitte V _ holde på å sitte V _ n
jurddašit V: tenke V; mene V _ tenke V _ n
jurdilit V: tenke V _ tenke en tanke V _ n
almmuhit V: publisere V; utgi V; kunngjøre V; opplyse V _ publisere V, gi ut V; deklarere V; bekjentgjøre V _ n
bivdit V: anmode V; fiske V; be V _ fiske V, jakte V; be V, anmode V _ n
ávžžuhit V: anmode V; oppfordre V; utfordre V; anbefale V _ oppfordre V _ n
ordnet V: sortere V; ordne V _ ordne V; sortere V _ n
sirret V: sortere V; skille V; isolere V _ skille V, sortere V _ n
čuoldit V: sortere V; skille V _ skille V, sortere V; veve bånd V _ n
boaibmut V: sortere V; plukke V _ plukke V, pille V; sortere V _ n
bovdet V: invitere V _ invitere V, innby V _ n
hástit V: invitere V; oppfordre V; utfordre V _ utfordre V, oppfordre V _ n
buhtadit V: kompensere V; erstatte V _ kompensere V, refundere V _ n
buhttet V: kompensere V; erstatte V _ erstatte V _ n
bágget V: tvinge V; presse V _ tvinge V _ n
bággehallat V: tvinge V _ tvinges V _ n
caggat V: forhindre V; hindre V _ støtte opp V; forhindre V _ n
heađuštit V: forhindre V; avverge V; undergrave V; hindre V _ forhindre V, avverge V _ m
coggat V: putte V _ putte V, stappe V; kle på seg V _ n
coggalit V: putte V _ putte fort V; kle på seg fort V _ n
nahkehit V: putte V; stikke V _ putte V, stikke V _ n
cábadit V: makulere V _ skjære i små biter V; makulere V _ n
dahppat V: stenge V _ stenge V, lukke V _ n
giddet V: stenge V; montere V _ feste V _ n
liibmet V: klistre V; lime V _ lime V _ n
ovdandoallat V: fremheve V _ anføre V, framholde V _ n
doadjit V: knekke V; bryte V _ knekke V, bryte V _ n
doaibmat V: fungere V; utføre V _ fungere V _ n
doaivut V: håpe V; tro V; anta V _ håpe V; tro V _ n
sávvat V: håpe V; ønske V _ ønske V _ y
doarrut V: stange V; slåss V; kjempe V _ stange V; slåss V _ n
nordat V: stange V _ puffe V, støte V _ n
duvdit V: fortrenge V; skyve V; tilsidesette V _ støtte V; puffe V; fortrenge V _ m
muktit V: overprøve V; forandre V; endre V _ endre V, forandre V _ n
eastadit V: forebygge V; unngå V; hindre V _ hindre V; forebygge V _ n
galmmihit V: fryse V _ avkjøle V _ m
finadit V: besøke V _ stikke innom V _ n
botket V: avbryte V; bryte V; skille V _ bryte V, slite av V; slite seg løs V _ n
unnut V: minske V; redusere V _ minske V, bli mindre V _ n
geahpedit V: minske V; lette V; redusere V _ lette V, minske V _ m
geahpidit V: minske V; lette V; redusere V _ lette V, minske V _ m
uhccut V: minske V _ bli mindre V, minske V _ n
hoahkat V: gjenta V _ ymte om at en vil V; gjenta V _ n
geardut V: gjenta V _ gjenta V; multiplisere V _ n
geardduhit V: gjenta V _ repetere V _ n
vuojihit V: kjøre V; frakte V _ frakte V _ m
gohččut V: innkalle V; be V; pålegge V _ be V, befale V; innkalle V; pålegge V _ n
golahallat V: fordrive V _ forbruke V _ m
gudnejahttit V: hedre V _ ære V, hedre V _ n
gulahallat V: kommunisere V _ forstå hverandre V; kommunisere V _ m
guldalit V: høres V; lytte V; høre V _ lytte V; kjenne etter V; teste V _ n
guossohit V: servere V _ traktere V, servere V _ n
gáldet V: gjelde V; kastrere V _ gjelde V, kastrere V _ n
guoskat V: gjelde V; berøre V _ komme bort i V; angå V _ m
gádjut V: redde V _ berge V, redde V _ n
suddjet V: redde V; beskytte V _ beskytte V _ n
gáidat V: forsvinne V _ vike V, forsvinne V _ n
healbat V: forsvinne V _ forbli V _ n
gálašit V: vasse V _ vasse V; bade V _ n
gáržžidit V: innskrenke V; begrense V; redusere V _ innskrenke V _ y
gáržut V: innskrenke V _ bli trang V, innskrenket V _ n
heahpanit V: skjemmes V _ skamme seg V, skjemmes V _ n
luohpat V: slutte V; gå V _ slutte V, gi opp V _ n
loahpahit V: avslutte V; sluttføre V _ avrunde V, sluttføre V _ n
biehttalit V: avslå V; avvise V; nekte V _ gi avslag V; nekte for V _ n
máhttit V: beherske V _ kunne V _ y
bálvalit V: betjene V; tjene V _ tjene V _ y
hárdit V: erte V; terge V; mobbe V _ erte V, terge V _ n
hárjehaddat V: øve V; trene V _ øve V, trene V _ n
hárjehallat V: øve V; trene V _ trene V _ n
ijastallat V: overnatte V; sove V _ overnatte V _ n
ihtit V: fremkomme V; synes V _ vise seg V, komme til syne V, fremkomme V _ n
áddet V: skjønne V; oppfatte V; forstå V _ forstå V _ n
jorgalit V: oversette V _ oversette V; snu noe V; snu V; omvende V; gjøre et notkast V _ n
jorgalahttit V: oversette V; snu V _ få til å snu V; få oversatt V _ n
máhccat V: snu V; komme V _ snu V, vende tilbake V _ n
lohkat V: lese V; telle V; studere V; si V _ lese V; telle V; si V _ y
logadit V: lese V; studere V _ lese lenge V _ n
oalgguhit V: oppmuntre V; stimulere V _ oppmuntre V, friste V _ n
movttiidahttit V: oppmuntre V; inspirere V; motivere V; stimulere V _ oppmuntre V, motivere V _ n
muddet V: moderere V; regulere V; justere V _ korrigere V, moderere V; regulere V _ n
njammat V: absorbere V _ suge V, patte V, sutte V; absorbere V _ n
njoarrat V: tappe V; skjenke V _ skjenke V, tappe V _ n
nohkkat V: sovne V _ sovne V; sove V _ n
čaibmat V: le V _ le V, flire V _ n
boagustit V: le V _ le V, flire V _ n
bohkosit V: le V _ sette i å le V _ n
ovddastit V: representere V _ forestå V; representere V _ n
ovddidit V: fremme V; utvikle V _ fremme V; gå for fort V _ y
ovdanbuktit V: fremme V; presentere V; uttrykke V _ legge fram V, presentere V _ n
rádjat V: oppbevare V; lagre V; ordne V _ ta vare på V, oppbevare V; ordne V _ n
ráđđádallat V: konsultere V; drøfte V _ drøfte V, konferere med V, konsultere V _ n
šohkut V: puste V; blåse V _ puste V, blåse V _ n
sahkat V: puste V _ puste V, pese V _ n
bosihastit V: puste V _ puste ut V _ n
seaguhit V: blande V _ blande V; legere V _ n
seahkanit V: blande V _ bli blandet V, rotet V; bli sinnsforvirret V _ n
áššáskuhttit V: påtale V; saksøke V; anklage V _ skylde på V, anklage V _ n
sorbmet V: myrde V; drepe V _ myrde V, drepe V _ n
stajidit V: herje V _ herje V, plyndre V _ n
speadjat V: herje V _ plyndre V, herje V _ n
rigeret V: herje V _ bråke V _ n
rievidit V: stjele V; røve V _ røve V _ n
vajálduhttit V: overse V; glemme V _ overse V, glemme V _ n
vavdat V: stamme V; stotre V _ stamme V, stotre V; bli sittende fast V _ n
viežžat V: hente V; innhente V _ hente V; laste ned V _ n
viežžalit V: hente V _ hente fort V, hente noe som ikke er langt borte V _ n
vuojehit V: jage V; drive V _ drive V, jage V _ n
ádjit V: jage V; drive V _ jage V, drive V _ n
oaguhit V: jage V; forfølge V _ forfølge V _ n
ásahit V: innrette V; ordne V; etablere V; opprette V; innføre V _ etablere V; ordne V, innrette V _ n
feret V: innrette V; oppleve V _ oppleve V _ n
čoagganit V: samles V; samle V _ samles V _ n
čoahkkanit V: samles V; møtes V; samle V _ samles V _ n
čohkket V: samles V; montere V; innhente V; samle V _ samle V; montere V _ n
čoavdit V: frita V; løse V _ løse V, låse opp V; frita V _ n
čálihit V: skrive V; skrive V; registrere V; innmelde V _ la skrive V, skrive ut V; la seg registrere V; ta ut lysning V _ n
gilvit V: dyrke V; så V; sette V; spre V _ så V, plante V _ n
guovlladit V: kikke V _ kikke V, kaste et blikk på V _ n
guovlalit V: kikke V _ titte i all hast V _ n
buđaldit V: oppholde V _ pusle V _ n
coahkkalit V: klikke V; smelle V _ smelle V, klikke V _ n
deaddilit V: klikke V; trykke V _ trykke V, klemme V _ n
álgit V: starte V; begynne V _ begynne V _ n
ohcat V: søke V _ leite V _ y
geavahit V: benytte V; bruke V _ bruke V _ n
albmadit V: melde V _ melde til øvrigheten V _ n
vikkahit V: forsøke V _ forsøke V, prøve å få til noe V _ n
nagodit V: bestå V; klare V _ klare V _ n
ceavzit V: bestå V; bestå V; holde seg V; overleve V _ holde seg V, klare seg V _ m
seailut V: bestå V; bevare V; overleve V _ bevares V; klare seg V _ n
dohkket V: godkjenne V _ duge V _ n
čuohpadit V: operere V _ skjære seg V, hogge seg V _ y
dihttot V: forekomme V _ vise seg V _ n
čiehkádit V: gjemme V _ gjømme seg V _ n
skirvehit V: svinge V _ svinge brått V _ n
soardit V: såre V; såre V _ undertrykke V; skamfere V _ y
láibut V: bake V _ bake brød V _ n
gáhkket V: bake V _ bake kake V _ n
bohčit V: pumpe V; melke V _ melke V, klemme V _ y
staigat V: avta V _ slå seg til ro V; avta V _ n
diŋgot V: abonnere V; bestille V _ bestille V _ y
divodit V: restaurere V _ reparere V _ n
divvut V: restaurere V; rette V; justere V _ reparere V, rette på V _ n
jeđđet V: berolige V; trøste V _ trøste V _ n
garvit V: fravike V; unngå V _ unngå V _ n
dahkaluddat V: agere V _ late som V; gjøre seg til V _ n
loktet V: løfte V; heve V _ løfte V _ y
váidalit V: klage V; beklage V _ klage V, beklage V _ n
sihtat V: ønske V; be V _ ville ha V, ønske V _ n
dáhttut V: ønske V; be V _ ville V, ønske V _ y
bahčit V: melke V _ melke V; sentrifugere V _ n
jáhkkit V: tro V; anta V _ tro V, anta V _ n
gáddit V: tro V; anta V _ tro V, anta V _ n
bindit V: vare V; holde seg V _ vare V, holde seg V _ n
láidet V: leie V; lede V _ leie V _ m
báhtarit V: rømme V _ flykte V, rømme V _ n
sálket V: tømme V _ tømme V; tappe V _ n
vuojadit V: svømme V _ svømme V, bade V _ n
šearrát V: glitre V; skinne V; lyse V _ lyse V, skinne V, glitre V _ n
rievdadit V: forandre V; endre V _ forandre V _ n
nuppástuhttit V: forandre V; tilpasse V; endre V _ forandre V, omstille V _ n
fillehallat V: bli forledet V _ bli forledet V, bli narret V _ n
duolbmut V: tråkke V _ tråkke V, trø V _ n
šulšet V: tråkke V _ tråkke V, lage spor V _ n
čuovgat V: skinne V; lyse V _ skinne V, lyse V; belyse V _ n
šealgát V: skinne V _ glinse V, skinne V _ n
báittašit V: skinne V; lyse V _ skinne V, lyse V _ n
borrat V: spise V _ spise V, ete V; etse V _ n
ballat V: frykte V _ frykte V, være redd V _ n
buorrestit V: omfavne V _ klemme V, omfavne V _ n
sallut V: omfavne V _ favne V; omfavne V _ n
bajásšaddat V: vokse opp V; vokse V _ vokse opp V _ n
gažadit V: intervjue V; spørre V _ spørre V, intervjue V _ n
gulaskuddat V: spørre V _ forhøre seg V, spørre V _ n
goarránit V: vantrives V _ vantrives V, visne V _ n
hommát V: arbeide V _ sysle V, arbeide V _ n
dahkat V: gjøre V; skape V _ gjøre V; lage V _ y
čákŋat V: krype V _ krype V, smyge inn i V _ n
guokkardit V: krype V _ gå på alle fire - på hender og føtter V _ n
massit V: miste V; tape V _ miste V _ y
bisánit V: stoppe V _ stoppe V; feste seg V _ n
orustit V: stoppe V; stanse V _ stanse V, stoppe V _ n
čuoččastit V: stoppe V _ reise seg V; stoppe V; stille seg V _ n
notkat V: stoppe V _ stoppe V, dytte igjen V _ n
bisuhit V: beholde V; bevare V; opprettholde V _ beholde V _ m
boaldit V: brenne V _ brenne V; svi V _ n
suovastit V: røyke V _ ryke V; røyke V _ n
goaivut V: grave V _ grave V, måke V, spa V _ n
burgit V: grave V _ rote V, grave V; demontere V _ n
skurbat V: grave V _ pirke V, grave V _ n
bálkkašit V: belønne V _ gjengjelde V; belønne V _ n
lotnut V: betale V _ betale V, løse ut V _ n
cahkkehit V: tenne V; fyre V _ tenne V _ n
coahkut V: synke V _ minke V, synke V _ n
dearpat V: banke V; slå V _ slå V, banke V _ n
huškut V: banke V; slå V _ slå V, banke V _ n
cábmit V: banke V; slå V _ slå V, banke V _ n
čoalkalit V: banke V _ banke V, knakke V _ n
goalkalit V: banke V _ banke V, knakke V _ n
darrat V: skjelve V; riste V _ skjelve V, riste V _ n
libaidit V: skjelve V _ bevre V, skjelve V; glimte V _ n
livzzistit V: skjelve V _ vakle V; skjelve V _ n
diehtit V: vite V; kjenne V _ vite V _ n
diggot V: bestille V; diskutere V _ bestille V; diskutere V, trette V; føre rettsak V _ n
diktit V: tillate V _ la V; tillate V _ n
suovvat V: tillate V _ tillate V, gi lov V _ n
doddjot V: brekke V _ brekke V, gå av V _ n
doidilit V: skylle V _ skylle V, skylle fort V _ n
dutkat V: granske V; studere V _ granske V, forske V _ n
dárbbašit V: trenge V _ behøve V, trenge V _ n
dávistit V: svare V _ svare V, gi gjenlyd V, gi respons V, reagere på V _ n
vanahit V: tøye V; dra V; strekke V _ strekke V, tøye V _ n
muosáhit V: oppleve V _ smake V; oppleve V _ n
heivet V: passe V _ høve V, passe V _ n
soahpat V: passe V _ passe V, høve V; bli enig V _ n
fáktet V: passe V _ passe V, vokte V _ n
ruohkkat V: klore V _ klø V, klore V _ n
gaccastit V: klore V _ spise en skjefull V; klore V _ n
rámpostit V: skryte V _ rose V, skryte V _ n
gerret V: skryte V _ rose V, skryte V _ n
rámpot V: skryte V _ rose V; skryte V _ n
gieldit V: forby V; nekte V _ forby V, nekte V _ n
muollat V: brøle V _ belje V, brøle V _ n
gilljut V: brøle V _ hyle V, brøle V _ n
čeargut V: brøle V; rope V _ brøle V; tordne V _ n
čerget V: brøle V _ brøle V; tordne V _ n
giljádit V: brøle V _ hyle V, brøle V _ n
veadjit V: orke V _ orke V, greie V; kanskje adv _ n
gohčodit V: kalle V; definere V _ kalle V, betegne V _ n
goikadit V: tørke V _ tørke V; steke V _ n
golgat V: renne V; drive V; drive V _ renne V; reke V; drive V _ n
čierastit V: renne V _ renne V, ake V _ n
čierastallat V: renne V _ renne V, ake V _ n
govvet V: fotografere V; illustrere V _ fotografere V _ n
gávppašit V: handle V _ handle V, drive handel V _ n
háisut V: lukte V _ lukte V, stinke V _ n
háleštit V: prate V; snakke V _ prate V, snakke sammen V _ n
humadit V: prate V; snakke V _ prate V _ n
hábmet V: utforme V; skape V _ utforme V _ n
hálahit V: overtale V; påvirke V _ overtale V _ n
hávdádit V: begrave V; gravlegge V _ begrave V _ n
čuodjat V: lyde V; ringe V _ klinge V, ringe V, lyde V _ n
jeagadit V: lyde V _ lyde V, lystre V _ n
juohkit V: dele V; spre V; fordele V; tildele V _ dele V _ n
juogadit V: dele V; fordele V; tildele V _ dele V; dele ut V _ n
juolludit V: bevilge V; gi V; tildele V _ avse V; bevilge V _ n
leiket V: skjenke V _ skjenke V, helle V _ n
leaikut V: skjenke V _ skjenke V, helle V _ n
loaktit V: trives V _ forbruke V; trives V _ n
lágidit V: ordne V; arrangere V; lage V _ stelle V, ordne V; arrangere V _ n
stellet V: ordne V; plassere V _ stelle V, ordne V, plassere V _ n
maŋidit V: utsette V _ utsette V; saktne V _ n
mieđuštit V: ledsage V; følge V _ ledsage V, følge V _ n
muitit V: huske V; minnes V _ huske V, minnes V _ n
máhccut V: brette V _ brette V; bukke V _ n
njuovvat V: slakte V _ slakte V, flå V _ n
njuvdit V: smøre V _ kline V, smøre V _ n
čuoččuhit V: påstå V; hevde V _ hevde V, påstå V _ n
návddašit V: nyte V _ nyte V, smake V _ n
vealahit V: diskriminere V _ diskriminere V; berøve V _ n
olgguštit V: diskriminere V; tilsidesette V _ diskriminere V, tilsidesette V _ n
orrut V: bo V; synes V _ være V, bli V; bo V; synes V _ n
šaddat V: fødes V; komme V; vokse V _ vokse V; fødes V; bli V; komme til å V _ n
riegádit V: fødes V; føde V _ fødes V _ n
viehkat V: løpe V; springe V _ løpe V _ n
ruohttat V: løpe V; springe V _ løpe V _ n
ráhkistit V: elske V _ elske V, være glad i V _ n
suodjalit V: beskytte V; bevare V; verne V; sikre V _ verne V, beskytte V _ n
várjalit V: beskytte V; forsvare V _ forsvare V, beskytte V _ n
vajáldahttit V: glømme V; glemme V _ glømme V _ n
ávvudit V: feire V; markere V _ feire V; fryde seg V _ n
gođđit V: binde V; knytte V _ strikke V; veve V; binde, knytte V _ n
čiekčat V: sparke V _ spenne V, sparke V _ n
čievččastit V: sparke V _ sparke V, spenne V _ n
čábbudit V: pynte V _ gjøre penere V, pynte V _ n
čorget V: rydde V _ gjøre reint V, rydde V, stelle V _ n
ákkastallat V: argumentere V; begrunne V _ argumentere V _ n
libardit V: vaie V _ flagre V, vaie V _ n
fállat V: tilby V _ tilby V, by på V _ n
doarjut V: støtte V _ støtte V, gi tilslutning til V _ n
čuožžilit V: oppstå V _ reise seg V _ y
beroštit V: interessere V _ bry seg om V _ y
seastit V: spare V; redusere V _ spare V _ n
bealuštit V: forsvare V _ forsvare V; forfekte V; ta part V _ n
ferdnet V: male V _ male V, kverne V _ n
suddat V: smelte V _ smelte V, tine V _ n
vuohčut V: smelte V _ piple V; smelte V _ n
guođđit V: forlate V _ forlate V, etterlate V _ n
guođđilit V: forlate V _ forlate V, etterlate V _ n
gaivát V: glane V; se V _ glane V, glo V _ n
gávkat V: glane V _ glane V, glo V _ n
olahit V: nå V; nå V; oppnå V _ rekke V, nå V _ m
joksat V: nå V; nå V; innhente V; oppnå V _ innhente V _ m
juksat V: nå V; nå V; oppnå V _ nå igjen V _ m
ollit V: nå V; strekke V _ nå V, rekke V _ n
noddet V: nå V _ nå V, rekke V _ n
oamastit V: eie V _ tilegne seg V; eie V _ n
riegádahttit V: føde V _ føde V, nedkomme V _ n
vadjat V: klippe V _ klippe V, skjære V; lokke V _ n
ofelastit V: følge V _ vise veg V, guide V _ n
dádjadit V: finne V _ finne fram V _ n
merkot V: merke V _ legge merke til V _ n
dárkot V: merke V; undersøke V; observere V _ betrakte V, undersøke V _ n
vávjit V: merke V; mistenke V; kritisere V _ mistenke V; kritisere V _ n
vuohttit V: merke V _ finne spor V, følge spor V _ n
mannat V: reise V; dra V; gå V _ gå V, dra V, reise V _ n
johtit V: reise V; flytte V _ bevege seg V; reise V; flytte V _ n
vuolgit V: reise V; dra V _ dra V, reise av sted V _ n
mátkkoštit V: reise V; ferdes V _ reise V, ferdes V _ n
čuoččahit V: reise V _ reise seg V; stille seg V _ n
oahppat V: lære V _ lære V; se etter fangst V _ n
goargŋut V: stige V; øke V _ klatre V; stige V; stake elvebåt V _ n
lassánit V: stige V; øke V _ øke V _ n
časkit V: slå V; slå V _ slå V _ n
speažžut V: slå V _ daske V, slå V _ n
meaidit V: slå V; hogge V _ slå V, hogge V, meie V _ n
šávget V: slå V _ slå V, helle V _ n
šávgut V: slå V _ slå V, helle V _ n
roaškut V: slå V; smelle V _ slå V, smelle V _ n
sárdnut V: tale V; snakke V _ tale V _ n
ságastallat V: tale V; diskutere V _ snakke sammen V _ n
vahágahttit V: skade V; ødelegge V _ skade V _ n
roasmmuhuvvat V: skade V _ bli skadet V, skade seg V _ n
deaddit V: presse V; veie V; trykke V _ trykke V, presse V; veie V _ n
bahkket V: presse V _ trenge på V, trenge seg fram V; presse V; være nærgående V _ n
geahččat V: se V _ se V, se på V _ n
geahčadit V: se V _ forhåndsgranske V _ y
guovlat V: se V _ kike V, titte V _ n
rahpat V: åpne V _ åpne V, lukke opp V _ n
rabastit V: åpne V _ åpne V, lukke opp V _n 
rabestit V: åpne V _ åpne V, lukke opp V _ n
leahkkut V: åpne V _ åpne V, lukke opp V _ n
leahkastit V: åpne V _ åpne V, lukke opp V _ n
rahpasit V: åpne V _ åpne seg V _ n
guoskkahit V: røre V; berøre V; omtale V _ røre V, berøre V _ n
lihkahit V: røre V; røre V _ røre V, bevege V _ n
lihkastit V: røre V _ bevege V, røre V _ n
njuorasmahttit V: røre V _ ydmyke V _ y
beaškit V: smelle V _ smelle V; slamre V _ n
beaškkihit V: smelle V _ smelle V; kollidere V _ n
spoahkkalit V: smelle V _ smelle V, smekke V _ n
bidjat V: sette V; sette V; sette V; plassere V _ sette V; legge V _ n
bidjalit V: sette V _ legge V, sette V _ n
bordit V: sette V _ stable V _ y
gárvvistit V: forberede V _ forberede V, gjøre klar V _ n
ráhkkanahttit V: forberede V _ utruste V, forberede V _ n
ráhkkanit V: forberede V _ gjøre seg klar V _ n
hásttuhit V: oppfordre V; utfordre V _ oppfordre V, utfordre V _ n
iskkadit V: undersøke V _ undersøke V, holde på å forsøke V _ n
dollet V: holde V; stanse V _ gripe V, ta et tak V; stanse V; konfiskere V; dra V _ m
doalahit V: holde V; opprettholde V _ holde V, fortsette V; la være V _ m
mielddisbuktit V: medføre V; innebære V _ medføre V _ n
gárget V: utvikle V _ vikle opp V, rekke opp V _ n
ovdánit V: utvikle V _ utvikle seg V, gå framover V, avansere V _ n
skeŋket V: gi V _ forære V, gi V _ n
lávet V: bruke V _ pleie V, bruke V _ n
golahit V: bruke V _ bruke V, forbruke V _ n
ávkkástallat V: bruke V; utnytte V _ utnytte V _ n
balahit V: mistenke V _ engste seg for noe V; mistenke V _ n
biehtadit V: nekte V _ nekte V; benekte V _ n
birget V: klare V; overleve V _ greie seg V _ m
billistit V: ødelegge V; undergrave V _ ødelegge V _ n
billašuvvat V: ødelegge V _ bli ødelagt V _ n
bissut V: holde seg V; fortsette V _ forbli V, holde seg V _ n
lávdat V: spre V _ spre seg utover V _ n
soaitit V: komme V _ kanskje adv; tilfeldigvis komme til å V _ n
ollet V: komme V _ nå fram V _ n
joavdat V: komme V _ nå fram V _ n
ilbmat V: komme V _ utkomme V _ n
čoaggit V: plukke V; samle V _ plukke V _ n
gaskit V: plukke V _ ribbe V, plukke V _ n
navvit V: plukke V _ pirke V, plukke V _ n
murjet V: plukke V _ plukke bær V _ n
lubmet V: plukke V _ plukke molter V _ n
gággat V: bryte V _ bryte V, velte V _ n
fággádit V: bryte V _ bryte V, ta tak V _ n
heaibut V: bryte V _ bryte V, ta tak V _ n
boatkanit V: bryte V _ bryte sammen V; slites av V _ n
jorahit V: vri V _ rotere V _ y
viehkalit V: stikke V; springe V _ løpe avgårde V _ n
čuohcit V: påvirke V; berøre V _ påvirke V, berøre V _ n
suhppet V: kaste V; kaste V _ kaste V; sette ut V _ n
suohpput V: kaste V; kaste V _ kaste V; sette ut garn, line, not V _ n
njoarostit V: kaste V _ kaste lasso V _ n
cancut V: springe V _ springe V, sprette V _ n
jietnadit V: si V; uttale V _ gi lyd fra seg V _ m
jienádit V: si V _ ytre V, ymte V _ n
dadjalit V: si V _ si fort V _ n
čárvet V: klype V _ klype V, klemme V _ n
čárvut V: klype V _ klype V, klemme V _ n
cikcut V: klype V _ klype V, knipe V _ n
cibmut V: klype V _ knuge V; klype V _ n
cuiggodit V: påpeke V; kritisere V _ formane V, advare V _ n
šluvgit V: riste V _ riste V, slenge V _ n
náđđut V: trykke V _ krype sammen V; trykke V _ n
prentet V: trykke V _ prente V _ n
oaidnalit V: treffe V _ sees V _ n
digaštallat V: diskutere V; drøfte V _ debattere V _ n
diggedit V: diskutere V _ diskutere V, krangle V _ n
duddjot V: lage V; skape V _ lage V, gjøre håndarbeid V, utføre håndverk V _ n
duššindahkat V: undergrave V _ annullere V, undergrave V _ n
geavvat V: skje V; gå V _ heve seg V; gå V _ m
earránit V: skilles V; skille V _ skilles V _ n
earuhit V: differensiere V; skille V _ differensiere V, skjelne V _ n
evttohit V: foreslå V; anbefale V _ foreslå V, avgi innstilling V; ta til orde for V _ n
árvalit V: foreslå V _ foreslå V; ymte V _ n
fihttet V: oppfatte V _ oppfatte V, komme på V _ n
gaikut V: rive V; slite V _ rive V, slite V _ n
njaskut V: rive V _ gnage V, rive V _ n
ravget V: slite V _ rykke V, slite V _ n
rundit V: slite V _ slite V, slepe V _ n
gaikkehit V: slite V _ rykke til V, slite V _ n
ravgut V: slite V _ rykke V, slite V _ n
váibadit V: slite V _ trøtte ut V _ n
geassit V: dra V; trekke V _ dra V, trekke V _ n
vázzit V: gå V _ gå V, spasere V _ n
vássit V: gå V _ svinne V, gå V _ n
hurgit V: gå V _ ile V, legge i veg V _ n
gollat V: gå V _ gå V, svinne V _ n
vázzilit V: gå V _ begynne å gå V _ n
meannudit V: behandle V _ oppføre seg V; behandle V _ n
gieđahallat V: behandle V _ bearbeide V, behandle V _ n
dálkkodit V: behandle V _ behandle for sykdom V, medisinere V _ n
cielahit V: mobbe V _ gjø på noen V; skjelle ut V _ n
rievdat V: drive V; endre V _ drive V, reke V; forandre seg V _ n
gullat V: høre V _ høre V; tilhøre V _ n
gullostit V: høre V _ plutselig høres V; føles svakt V _ n
lihkahallat V: berøre V _ berøre V; bevege V _ n
einnostit V: anta V; anslå V; forvente V _ forutsi V, spå V, antisipere V _ n
gáhttet V: bevare V; verne V _ vokte V, ta vare på V, bevare V _ n
heŋget V: henge V _ henge opp V _ n
heaŋgut V: henge V _ henge opp V _ n
dárustit V: snakke V _ snakke norsk V _ n
sámástit V: snakke V _ snakke samisk V _ n
hoigat V: skyve V _ skyve V, puffe V _ n
hovdet V: lede V _ lede V, styre V _ n
doahput V: skaffe V _ gripe V _ n
áittardit V: skaffe V _ passe på saker V; skaffe V; sørge for V _ n
geasuhit V: rekruttere V _ tiltrekke V _ n
áddehaddat V: forstå V _ forstå hverandre V _ n
šoavvat V: suse V _ suse V, bruse V _ n
juhcat V: suse V _ suse V, bruse V _ n
juoiggastit V: joike V _ joike litt V _ n
jáddat V: slukke V _ slukne V _ n
njávkat V: stryke V _ stryke med handa V _ n
liktet V: stryke V _ pusse V; stryke V _ n
veallánit V: ligge V _ legge seg V _ n
gárvet V: sluttføre V _ gjøre ferdig V _ n
geargat V: sluttføre V _ bli ferdig V _ n
luoikkahit V: låne V _ låne hos noen V _ n
moaitit V: kritisere V _ klage over V _ n
njáskat V: hogge V _ kviste V; rydde mark V _ n
meroštit V: definere V; anslå V; beregne V _ anslå V; definere V _ n
máinnastit V: fortelle V _ fortelle V, fortelle eventyr V _ n
nuppástuvvat V: endre V _ forandre seg V _ n
namahit V: omtale V; nevne V; oppnevne V _ nevne V _ m
nammadit V: omtale V; oppnevne V _ oppnevne V; omtale V _ n
jođašit V: ferdes V _ bevege V _ y
vánddardit V: ferdes V _ vandre V, streife V _ n
vádjolit V: ferdes V _ vandre V _ y
johtalit V: ferdes V _ rikle, slarke V; ferdes V _ n
oaivvildit V: mene V _ mene V, ta stilling til V _ n
vuhttot V: synes V _ spores V _ y
speallat V: spille V _ spille V; spille kort V _ n
neaktit V: spille V _ se ut som V; spille V _ n
čuojahit V: ringe V _ ringe V; spille V _ n
sivdnidit V: skape V _ skape V, signe V _ n
soahtat V: kjempe V _ kjempe V, krige V _ n
vajálduvvat V: glemme V _ glemmes V _ n
vuordit V: vente V; forvente V _ vente V _ n
vuorddašit V: vente V _ vente lenge V _ n
veavdit V: vente V _ vente V, hale med seg V _ n
stuoridit V: utvide V; øke V _ forstørre V _ n
viidánit V: utvide V _ spre seg V; utvide seg V _ n
čájáhallat V: vise V _ framvise V _ n
čalmmustahttit V: markere V; belyse V _ fokusere på V, gjøre synlig V _ m
čadnot V: knytte V _ knyttes til V _ n
čatnasit V: knytte V _ bli bundet V _ n
čuvget V: belyse V; opplyse V _ opplyse V, belyse V _ n
čuožžut V: stå V; stå V _ stå V _ n
ceaggát V: stå V _ stå oppreist V _ n
čuččodit V: stå V _ bli stående V _ n
stuorrut V: vokse V; øke V _ bli stor V _ m
sisttisdoallat V: inneholde V; omfatte V _ inneholde V _ y
oassálastit V: delta V _ delta i V _ n
searvat V: delta V _ slutte seg sammen V _ y
dolastit V: fyre V _ fyre V, ha bål V _ n
ligget V: fyre V _ varme V _ n
laskat V: øke V _ øke V, formere seg V _ n
lasihit V: øke V _ legge til V, øke V _ n
jiellat V: trekke V _ trekke V, blåse svakt V _ n
geassádit V: trekke V _ trekke seg V _ n
rohttet V: trekke V _ rykke V; komme på V _ n
vuorbádit V: trekke V _ kaste lodd V, trekke lodd V _ n
unnidit V: redusere V _ forminsk V _ n
uhcidit V: redusere V _ forminske V _ n
áicat V: registrere V; observere V _ oppdage V _ n
láhppot V: tape V _ gå seg vill V _ n
oažžut V: motta V; oppnå V _ få V _ n
vuostáiváldit V: motta V _ ta imot V _ n
njulget V: rette V _ rette ut V, glatte ut V _ n
rátkit V: skille V _ skille V, skille rein V _ n
imaštit V: overraske V _ forundre seg V _ n
hirpmástuvvat V: overraske V _ bli forskrekket V _ n
hirpmahuvvat V: overraske V _ bli forskrekket V _ n
divustit V: justere V _ rette på V _ y
divaštallat V: drøfte V _ diskutere V _ n
dovddiidit V: identifisere V _ erfare V, lære å kjenne V _ y
lahttudit V: innlemme V _ innlemme V, inkorporere V _ n
duogŋat V: bøte V _ lappe V _ y
čiktit V: bøte V _ bøte garn V; bøye en skitupp V _ n
fearrat V: meisle V _ telje V _ m
gomihit V: oppheve V _ velte V; avvise V; gjendrive V _ n
