bávččas	ond
bávččas	smertefull
agálaš-	evig
ahkit	kjedelig
ahkit	utrivelig
albma	ordentlig
albma	skikkelig
albmosit	offentlig
almmus	offentlig
bassi	hellig
beaivválaš	daglig
behtolaš	upålitelig
bistevaš	varig
deaŧalaš	viktig
dievaslaš	fullstendig
dieđalaš	vitenskapelig
dohkálaš	høvelig
dohkálaš	tjenlig
duostil	dristig
duođaid	sannelig
duođaid	virkelig
dábálaš	alminnelig
dábálaš	vanlig
dáiddolaš	kyndig
dárbbašlaš	nødvendig
dárkil	grundig
dárkil	nøyaktig
dássásaš	jevnbyrdig
dássásaš	jevnhøy
dávggas	elastisk
dávggas	spenstig
earalágán	forskjellig
earalágán	ulik
erenoamážit	spesielt
erenoamážit	særlig
fuolaheapmi	likegyldig
fuotni	dårlig
fámolaš	mektig
fávdnat	bra
fávdnat	dyktig
fávru	staselig
fávru	vakker
gallji	rommelig
gallji	vid
gappus	nifs
gappus	uhyggelig
geafi	fattig
geamus	disig
geamus	uklar
geatnegas	ansvarlig
geatnegas	pliktig
gelbbolaš	dugelig
gelbbolaš	verdig
gierdameahttun	utålmodig
gierdavaš	tålmodig
gieskat	nylig
giitemeahtun	utakknemlig
giitevaš	takknemlig
gillil	tålmodig
gillil	utrettelig
givas	ivrig
givas	modig
goalus	uhyggelig
gulul	forsiktig
gulul	rolig
guttaheapmi	ubrukelig
guttaheapmi	udugelig
gárvvis	ferdig
gávvil	listig
gávvil	lur
gáđaš	misunnelig
heahttái	ubehjelpelig
heivvolaš	passelig
hilbat	skøyeraktig
hilbat	vilter
hirbmat	svært
hirbmat	veldig
hirpmus	skrekkelig
hálbi	billig
hánis	gjerrig
hávski	hyggelig
hávski	morsomt
ilolaš	gledelig
imaš	merkelig
imaš	underlig
ipmilmeahttun	ugudelig
issoras	forferdelig
jahkásaš	årlig
jahkásaš	årsgammel
jeagoheapmi	ulydig
jearggalaš	fornuftig
jegolaš	lydig
joavdelas	unyttig
joavdelas	unødvendig
jolgat	freidig
juonalaš	listig
juonalaš	lur
jáhkehahtti	sannsynlig
jáhkehahtti	trolig
jáhkkemeahttun	utrolig
jállu	motig
liekkus	hyggelig
liekkus	koselig
lihkolaš	heldig
lihkolaš	lykkelig
loassi	dårlig
loassi	svak
lobiheapmi	ulovlig
lobálaš	lovlig
lodji	rolig
lodji	tam
lunddolaš	naturlig
luohtehahtti	pålitelig
lágalaš	lovlig
lágalaš	rettsgyldig
lávttas	fuktig
meariheapmi	umåtelig
mearkkalaš	merkelig
mielaheapmi	gal
mielaheapmi	vanvittig
muoseheapmi	urolig
muttát	passelig
mánálaš	barnslig
mávssolaš	dyrebar
mávssolaš	viktig
máđoheapmi	forskrekkelig
máŧoheapmi	umulig
namalassii	nemlig
neavri	dårlig
neavri	elendig
njálmmálaš	muntlig
nuoski	urenslig
nuppelágán	annerledes
nuppelágán	forskjellig
nággár	sta
nággár	stridig
návccalaš	dyktig
návccalaš	sterk
oktanaga	samtidig
olggul	utvendig
olgguldas	utvendig
olgguldas	ytre
ollásii	fullstendig
oppalohkái	fullstendig
oskkáldas	pålitelig
ovddolaš	merkelig
ovddolaš	underlig
ovttaskas	enslig
rehálaš	hederlig
rehálaš	ærlig
rievttes	rett
rievttes	riktig
roahkkat	freidig
roastil	dristig
ráfálaš	fredelig
ábolaš	nyttig
ábuheapmi	unyttig
áddehahtti	forståelig
áddemeahttun	uforståelig
áhpeheapmi	fruktsommelig
álfárot	fullstendig
árbmugas	nådig
árgi	engstelig
árgi	redd
árki	elendig
árki	ynkelig
árpmitmeahttun	ubarmhjertig
árrat	tidlig
ártet	merkelig
ártet	rar
ávdugas	salig
ávkkálaš	nyttig
áŋgir	flittig
áŋgir	ivrig
čiegus	hemmelig
čielggas	klar
čielggas	tydelig
čorgat	renslig
čuorbi	klønete
čuorbi	udugelig
ahte	at
ja	og
ja/dahje	ja/eller
dahe	eller
dahje	eller
dahjege	eller
dahege	eller
dehe	eller
dehege	eller
ele	eller
elege	eller
ele%
muhto	men
vai	eller
agálašvuohta	evighet
ahki	alder
albbas	gaupe
albmi	himmel
alva	energi
aláš	høyde
arvi	regn
aski	fang
atnu	nytte
attáldat	gave
aviisa	avis
ađa	margbein
aškkas	issvull
baggi	tjukking
baika	skit
baján	torden
baldu	isflak
ballu	frykt
balva	sky
bargi	arbeider
bargobierggas	arbeidsredskap
bargu	arbeid
basaldat	vaskeklut
basit	helg
bassinmuorra	steikespidd
baste	skje
bađuš	stjert
beahcet	spord
beahci	furu
beahtu	udyr
beaiveloddi	sommerfugl
beaivi	dag
beaivvadat	solskinn
beaivváš	sol
bealdu	åker
bealli	halvpart
beallji	øre
beana	hund
beargalat	djevel
beargalat	fanden
beaska	pesk
beassi	never
beassi	reir
beasuš	fuglekull
beaŋka	krakk
biebmu	føde
biedju	hi
biegga	vind
biehkan	boaimmáš
biehkan	fjellvåk
bielká	bjelke
biellu	bjølle
bierggas	sak
biergu	kjøtt
bieža	hale
bihkka	tjære
bihppor	pepper
bihttá	bit
biibbal	bibel
biika	pigg
biila	bil
biipu	pipe
biras	omgivelse
bircu	terning
biro	djevel
bissu	gevær
boadnjá	ektemann
boaimmáš	biehkan
boaimmáš	fjellvåk
boaittu	avkrok
boaldámuš	brensel
boallu	knapp
boaltu	bolt
boaru	klegg
boazu	rein
bodda	stund
bodni	bunn
bohkká	geitebukk
boraspire	rovdyr
borga	fokk
borga	snøfokk
borgi	skinn
boršu	strømhvirvel
buhtadas	godtgjørelse
bulkor	pulk
bulvarat	pulver
bulži	isskorpe
bunci	propp
buogu	svull
buohcci	pasient
buoidda	røyskatt
buolaš	frost
buolaš	kulde
buolva	generasjon
buolva	kne
buorádus	omvendelse
buoska	fjert
buođđu	demning
burru	okse
bursa	pengepung
busse	buss
busse	pose
bussá	katte
bustu	lugg
bustávva	bokstav
buvda	butikk
buvri	fjøsbur
bábir	papir
bádji	smie
bággi	grime
báhkin	hedning
báhkka	hete
báhkkon	bud
báhppa	prest
báhti	gryte
báidi	skjorte
báidnu	maling
báiki	heim
báimman	gjeter
bákti	klippe
bálddis	kveite
bálggis	sti
bálvvus	dyrking
bálvvus	tilbedelse
bálvá	tjener
bárdni	gutt
bárehuoš	unggutt
bárku	bark
bárru	bølge
bárti	knipe
bátnesoallun	tannpirker
bátni	tann
bávččas	smerte
bázahas	levning
bázzi	støtte
báđar	flyktning
báŋku	bank
ceahkis	hakk
cearki	beger
ceavvi	snøskavl
ciiku	tispe
cissa	tiss
cissa	piss
cissa	urin
cizáš	småfugl
coakci	fotfeste
cummá	kyss
cuoppu	frosk
cuozza	hinne
cuoŋu	skare
cáici	hysteriker
dajaldat	uttrykk
dardi	avsats
darfi	lavdnji
darfi	torv
datni	tinn
daŋas	lyng
deaddu	vekt
deadju	glans
deahkki	muskel
dealli	klopp
deappu	tare
dearbmi	elvemæl
deatta	press
deatta	trykk
diddi	smålaks
diehppi	dusk
diehtu	viten
dielku	flekk
dienas	fortjeneste
dievdu	mann
dievvá	haug
diggi	rett
diggi	rettsak
dihkki	lus
diibmu	klokke
diibmu	ur
diida	tiida
diida	overtro
dikta	dikt
dilli	tilstand
dilljá	tilje
dilálašvuohta	forhold
dilálašvuohta	tilstand
dimbbar	tømmerstokk
divat	avgift
divri	insekt
diŋga	tiŋga
diŋga	ting
doahkki	fugleflokk
doaibma	gjøremål
doaivu	doaivva
doaivu	håp
doaivva	doaivu
doaivva	håp
doalvi	trav
doardna	toardna
doardna	tårn
doarjja	støtte
doassa	toassa
doassa	eske
doavttir	doktor
dobádat	klabbeføre
doggi	kjesemage
dohppa	slire
dolgi	fjær
dolla	ild
dorski	torsk
dorte	rokk
dorve	horn
dorvu	tillit
dovddastus	innrømmelse
dovddastus	tilståelse
dovdu	erfaring
dovtta	storlom
duggu	skrå
duggu	tobakk
duhkku	dott
duhkoras	stoagus
duhkoras	leketøy
duhpát	tobakk
dukta	gjødsel
dulka	tolk
dulvi	flom
duodji	håndverk
duoggi	klump
duohta	sannhet
duokŋas	lapp
duolva	skitt
duopma	hegg
duopmu	dom
duopmár	dommer
duorga	riskvist
duotna	stakkar
duovdda	flytte-
duođaštus	bevitnelse
dutki	forsker
dáhpedorbmi	tilfelle
dáhpi	skikk
dáhpáhus	hendelse
dáhttu	vilje
dáidda	kunst
dáidu	forstand
dáiga	nytte
dáigi	deig
dákti	bein
dálki	vær
dálkkas	medisin
dállu	hus
dálolaš	gårdbruker
dálon	fastboende
dálvi	vinter
dápmot	aure
dápmot	ørret
dárbbaš	dárbu
dárbbaš	nødvendighet
dárbu	dárbbaš
dárbu	behov
dávda	sjukdom
dávda	sykdom
dávvir	skatt
dávvir	verdi
eaddji	gubbe
eadni	mor
eahpádus	tvil
eahpáraš	gjenferd
eaiggát	eier
eaktu	vilkår
eallin	leven
eallámuš	levebrød
ealáhus	næring
ealát	livberging
eamit	husmor
eanan	jorde
eanan	land
eanan	mark
eanu	morbror
eappir	trebøtte
earru	skilsmisse
earán	ærend
eastta	hindring
ehtemas	blokkebær
ehtemas	mikkelsbær
einnostus	spådom
eiseváldi	myndighet
erohus	forskjkell
erttet	side
evangelium	evangelium
evre	øre
evttohus	forslag
eŋgel	engel
faggi	krok
fanas	vanas
fanas	båt
feardna	kvern
fearrán	fearán
fearrán	hending
feaskkir	entre
feaskkir	gang
fidnu	yrke
fiehtar	buksebånd
fiehtar	bånd
fielbmá	elvegrunne
fiellu	bord
fierbmi	fiskegarn
fiervá	fjære
fievru	framkomstmiddel
fuolki	slektning
fuorrá	hore
fuođđu	dyr
fággi	ryggtak
fáhcca	vott
fáhtta	fat
fáldi	fogd
fáldi	fut
fális	hval
fális	kval
fápmu	styrke
fárfu	hempe
fárppal	tønne
fárru	følge
fárru	reisefølge
fátmi	fang
fáttar	fadder
fáŋga	fange
gahpir	lue
gaiba	lueskygge
ganjal	tåre
gapmu	anelse
garca	reim
garra	skorpe
gaska	avstand
gaskaoapmi	middel
gatna	steinlav
gavdnja	skremsel
gavja	støv
gazza	klauv
gazza	klo
geahpis	lunge
geahpádus	minskning
geahči	ende
geahččalus	fristelse
geahčču	bevoktning
geaidnu	veg
geaidnu	vei
geardi	gang
geardi	omgang
geardni	skare
gearpmaš	orm
geassi	sommer
geatki	jerv
geatnegasvuohta	ansvar
geavja	hank
geavri	trinse
geavŋŋis	stryk
geađgi	stein
geaŧŧu	vogge
geres	pulk
giddagas	fengsel
gieddi	voll
giegir	strupe
giehka	gauk
giehka	gjøk
giehta	arm
giehta	arm
giehta	hand
giehta	hand
gielas	kjøl
gielda	sogn
giella	språk
gielis	løgner
gielká	kjelke
giella	snare
gietkka	komse
gievdni	kjel
gievkkan	kjøkken
gihcci	geitekilling
gihli	friergave
gihppu	klase
gihpu	bávččas
gihpu	smerte
giimma	irr
giisá	kiste
giittus	takk
giitu	takk
giksi	plage
gilkkas	klang
gillámuš	lidelse
gilvu	konkurranse
gilvva	frø
ginttal	stearinlys
ginttal	talglys
girdno	smørkjerne
girji	bok
girji	brev
girji	pelsflekk
girku	kirke
giron	fjellrype
gistta	skinnhanske
gistu	likkiste
gižaldat	hengsel
goadjin	hannlaks
goahti	vintertelt
goaikkanas	dråpe
goallus	rekke
goalmmádas	tredel
goalsi	fiskeand
goapmir	handflate
goarta	koarta
goarta	kort
goaskin	ørn
goatnil	elv
goavki	åpning
goaŋku	grytekrok
gobmi	spøkelse
goddi	villrein
gohpi	grop
gohttá	småkake
golgadat	drivgarn
golgolaš	vandringsmann
golka	dombjelle
gollen	gullring
golli	gull
golmmeš	tretall
gonagas	konge
gordni	korn
gorremaš	som
gorsa	djup
gorut	skrott
gorži	foss
gosahat	hoste
gotka	maur
govva	bilde
govččas	dyne
gođus	vev
gudji	passasje
guhkkár	pung
guigu	kvige
gulahus	bekjentgjørelse
gulbmi	øyenbryn
gullu	hørsel
gumpe	ulv
gumppus	blodklubb
guoccat	penis
guoddalus	anmeldelse
guoddá	pute
guohkki	hakke
guohtun	beitemark
guoika	stryk
guoktilaš	hykler
guolbba	mo
guolbi	jordgolv
guoldu	kaldsno
guoldu	snøfokk
guolli	fisk
guopmi	gane
guopmi	gomme
guoppar	sopp
guorba	som
guorbmi	lass
guorssahat	hoste
guoržžu	som
guossa	gran
guossi	gjest
guottu	stubbe
guovddáš	sentrum
guovlu	distrikt
guovlu	retning
guovssahas	nordlys
guovža	bjørn
guođoheaddji	gjeter
gurbmá	larve
gurpi	bør
gurra	kløft
gussa	ku
gutna	aske
guvtteš	totall
guvžá	sjøørret
gáddi	strand
gáddu	formodning
gáddu	tro
gáffal	gaffel
gáhkkor	lom
gáhkkor	smålom
gáhkku	kake
gáhtamuš	anger
gáhttu	tak
gáibmi	med
gáibádus	krav
gáica	geit
gáigá	tufs
gáisá	fjell
gáisá	tinde
gáivo	brønn
gájanas	ekko
gákkis	vadmel
gákti	kofte
gálahat	vadested
gálbi	kalv
gáldu	kilde
gálgu	hustru
gálja	hålkeføre
gálli	klippe
gálli	steinblokk
gállis	kall
gálssot	vinterbelling
gálvu	bagasje
gáma	sko
gárastat	čanastat
gárastat	bånd
gárdin	gård
gárgu	strand
gárri	fat
gárvu	klesplagg
gásta	dåp
gávcceš	åttetall
gávdni	gagn
gávpeolmmai	handelsmann
gávpi	handel
gávpot	by
gávva	bøyning
gáđohus	fortapelse
haddi	pris
heagga	liv
heahpat	skam
heahti	nød
heajat	bryllup
heajat	selskap
heargi	hanrein
heargi	kjørerein
hearrá	storkar
hearva	pynt
heasta	hest
heavdni	edderkopp
heavval	høvel
hehkke	høygrind
herkken	tvare
hersko	delikatesse
hieibma	bris
hiitta	buksebak
hildu	hylle
hilla	glo
hipmu	begjær
hirbma	skrekk
hirsa	tømmerstokk
historjá	historie
hivvodat	masse
hoavda	sjef
hoavri	masekopp
hoaŋka	bergvegg
holbi	koftekant
holga	bjelke
hommá	gjøremål
horbmá	geitrams
horsta	strie
háhcci	skrev
háhcci	skritt
háhká	uer
háhtta	hatt
hálddahus	administrasjon
hálgu	vedkubbe
hápman	havn
hápmi	skikkelse
hápmi	utseende
hárdu	rygg
hárji	høyderygg
háse	háše
háse	hesje
hávdi	grav
hávga	gjedde
hávvi	sår
háŋgu	høygaffel
háŋka	knippe
idja	natt
idjaloddi	ugle
ipmárdus	forståelse
irgi	brudgom
isit	ektemann
ivdni	farge
iđit	morgen
jahki	år
jahkodat	tid
jahkodat	årssyklus
jassa	snøfonn
jeaggi	myr
jeagil	reinlav
jeđđehus	trøst
jiehkki	isbre
jiehkku	skinnskrape
jiehtanas	troll
jiekŋa	is
jiella	luftdrag
jietna	stemme
joavku	gruppe
joavku	husstand
johtolat	flyttevei
johtu	fart
jokŋa	tyttebær
jorbodat	sirkel
jorddamora	jordmor
jorgalus	omvendelse
jođiheaddji	styrer
jugástat	dram
juhca	brus
jumeš	curri
jumeš	tvilling
juohkehaš	hver
juolgi	bein
juotna	intrige
juotna	list
juovva	steinur
jurdda	tanke
jábmi	lik
jáffu	mel
jáhkku	forestilling
jáldu	vinddrag
jámeš	gjenferd
jávri	innsjø
kantuvra	kontor
kapihtal	kapittel
keallir	kjeller
kilo	kilo
krubbá	krybbe
kultuvra	kultur
kárta	kart
kássa	kasse
ladju	bly
lahkki	halvdel
lahkki	halvpart
lahtta	flåte
lahttu	medlem
lasta	blad
latnja	sprekk
latnja	åpning
lađas	ledd
leahki	dal
leaika	spøk
leaksu	lekse
leansmánni	lensmann
leaska	enkemann
leavga	fane
leŋge	seletøy
libar	bleie
libar	bleie
libar	klut
libar	klut
liehppi	klepp
liepma	buljong
lievla	damp
lieđđi	blomst
lihkadus	bevegelse
lihkahus	rørelse
lihkku	lykke
lihkuhisvuohta	ulykke
lihppu	merkelapp
lihtter	liter
liiba	høve
liidni	halsduk
liidni	tøy
liika	lik
limšku	fille
listu	liste
loadda	lodd
loaggi	som
loahppa	ende
loapmi	mellomrom
loapmi	åpning
loatna	lån
loavdda	teltduk
loddi	fugl
logeš	tier
lohkka	lås
lohkki	lokk
lohku	antall
lohku	tall
lohpi	tillatelse
lokta	loft
luhkka	skulderkappe
luhkkár	klokker
luodda	vei
luohkká	bakke
luohti	joik
luokta	bukt
luomi	molte
luonddogáhppálat	skapning
luondu	natur
luoppal	elvefar
luossa	laks
luođđa	kule
luvdá	sopelime
ládda	ammunisjon
ládda	ladning
láddelaš	kvæn
láddelaš	svenske
ládju	slåttonn
lágeš	fjellbjørk
láhka	lov
láhtti	golv
láhttu	løype
láhtu	låve
láibi	brød
láigi	ulltråd
láirá	leire
lákca	fløte
lákca	rømme
lámpá	lampe
láppis	lam
lásis	skjær
lássa	glass
látna	stabel
látnjá	ungbjørk
lávka	bag
lávki	løk
lávki	steg
lávlla	sang
lávvardat	lørdag
lávvi	kjenning
lávvi	venn
lávvu	lavvo
lávvu	sommertelt
lávži	tømme
láđđi	klede
láđđi	stoff
maras	høydedrag
mašiidna	maskin
meaddádus	feil
meahcci	ødemark
meardi	ruse
mearka	merke
mearra	hav
mearri	mengde
mearrádus	bestemmelse
meađđin	rogn
mehter	meter
meinnet	oaivil
meinnet	mening
miehkki	sverd
mielga	bryst
mielggas	mei
mielli	mel
miessi	reinkalv
miestta	busk
mihttu	målestokk
miila	mil
moadde	par
moalki	bøyning
moalki	krumming
moalla	blink
moallu	bit
moarri	raseri
moarsi	brud
modji	smil
mohkki	løkke
mohkki	sving
mohkki	ærend
moivi	grums
mokta	optimisme
monin	manin
monin	nyre
moraš	sorg
mugga	mugge
muhkki	møkk
muitalus	fortelling
muitu	minne
muoddá	gammel
muogir	insekt
muogir	knott
muohta	snø
muorji	bær
muorra	ved
muotki	eid
murku	vinterskodde
máddu	opprinnnelse
mádjit	bever
máhcastat	brett
máhttájeaddji	apostel
máhttájeaddji	disippel
máhtu	larve
máihli	sevje
máilbmi	verden
máinnas	eventyr
máksu	betaling
mála	maling
málle	fasong
málle	mal
málli	suppe
mánnu	måned
mánná	barn
márfi	pølse
márkan	kirkested
márkan	tettsted
mátta	rot
máđii	vei
nagir	søvn
namma	navn
nađđa	skaft
neahkameahttun	spøkelse
nealgi	sult
neavva	formaning
niehku	drøm
nieida	datter
nierra	muohtu
nierra	kinn
niesti	niste
niibi	kniv
niitu	natureng
nisu	nisson
nisu	kvinne
nivssat	knusk
njalagálašvuohta	evighet
njavvi	stryk
njealjádas	fjerdedel
njeašši	våtmark
njelješ	firer
njiellu	svelg
njirran	skredfar
njivli	grønske
njižži	spene
njoaiddu	skråning
njoammil	hare
njoaski	høyfjellskar
njoazan	som
njolgi	luntetrav
njuikehat	hopp
njukča	svane
njunnesuorran	siksak-mønster
njunni	nese
njuolla	pil
njuoratmánná	spebarn
njuovčča	tunge
njurgganas	fløyte
njáhcu	tøvær
njáhká	lake
njálbmi	munn
njálla	fjellrev
njárga	halvøy
njávešeatne	sagnfigur
noaidi	sjaman
noađđi	byrde
nođđu	nøste
nulpu	rein
nuohtta	melodi
nuohtti	not
nuorri	sund
nuortalaš	østsame
nurki	hushjørne
nuvttot	vinterkomag
nábár	bor
nággu	krangel
náhkki	hud
náhpi	navle
náhpol	propp
náhppi	trebolle
nákca	kraft
nálli	rase
nállu	nål
násti	stjerne
návdi	ulv
návet	fjøs
návli	nagle
návrraš	nepe
oabbá	søster
oaffar	offer
oahpaheaddji	lærer
oahppa	lære
oahppu	kunnskap
oaidnaleapmi	gjensyn
oaivegávpot	hovedstad
oaivi	hode
oaivil	mening
oaivvuš	elveutløp
oaivámuš	overhode
oaksi	kvist
oakti	byge
oalgi	skulder
oalul	underkjeve
oamedovdu	samvittighet
oamehas	avdød
oapman	ovn
oarpmealle	kusine
oarra	tau
oarri	ekorn
oassi	del
oavdu	mirakel
ohca	barm
oktii	gang
ollesolmmoš	voksen
olmmoš	menneske
olmmái	mann
opmu	gjørmehull
orbbeš	ringfinger
orda	skoggrense
orda	tregrense
orohat	oppholdssted
osku	tro
ovcceš	nier
ovdáneapmi	utvikling
peanna	penn
persuvdna	person
profehta	profet
proseanta	prosent
raddi	barm
rahttá	spire
ravda	kant
raŧŧi	vintervei
reahka	slede
reahpin	ljor
reasta	rest
reatká	gaskkas
reatká	einer
reaŋga	dreng
reŋko	krakk
ridda	grind
riddu	strand
rieban	rev
riehppi	botndal
riehpu	stakkar
riekkis	ring
riekti	domstol
riekti	rett
rievdna	surbmi
rievdna	gryn
rievvár	røver
rihkku	komma
rihpa	rusk
rihppa	altergang
rihppa	skriftemål
riidu	krangel
riidu	trette
riika	rike
rimški	fille
rissi	kvist
riđđu	kuling
riššasággi	fyrstikk
roadda	balltre
roahkan	huk
roahkki	krok
roahttu	rotte
roaiská	pisk
roakči	bulk
roamši	ujevnhet
roassu	tap
roavgu	skinnfell
roaškkas	rabalder
roggi	grop
rohkki	váidni
rohkki	avdød
rohkos	bønn
rohtu	krattskog
rudni	ishull
ruhkku	krukke
ruhta	penge
ruitu	gryte
rulla	rulle
rumaš	kropp
ruobbi	utslett
ruohtas	rot
ruoksi	jur
ruoktu	hjem
ruossa	rista
ruossa	kors
ruovdi	jern
ruovji	part
ruošša	russer
ruoŧŧilaš	svenske
ruska	rusk
rusttet	byggverk
ruvtto	rute
ruŋgu	skrott
rádju	oppbevaring
rádnu	haretråkk
ráfi	fred
ráhkisvuohta	kjærlighet
ráhkkanas	greie
ráhpi	søle
ráhtis	hjul
ráhtu	åtsel
ráidalas	trapp
ráidu	rekke
ráigi	hull
ráipi	tamp
ráisku	fille
rákkas	forheng
rámški	fille
ránnjá	nabo
rápmi	skryt
rássi	urt
rásttis	trost
rátnu	pledd
ráva	formaning
rávdi	smed
rávdnji	strøm
rávdu	røye
rávjá	hanhund
rávjá	hanulv
rávki	stakkar
ráđđehus	regjering
ráđđi	råd
ráŋggáštus	straff
áddjá	gamling
ágga	unnskyldning
áhkku	kjerring
áhkká	hustrukone
áhpi	hav
áhta	ting
áhčeseatne	eventyrfigur
áhčči	far
áibmi	synål
áibmu	luft
áiddis	gjerdestaur
áidi	gjerde
áigegollu	tidsfordriv
áigga	hensikt
áigumuš	hensikt
áigáboahtu	utkomme
áiru	åre
áisá	skåk
áiti	stabbur
áitta	trusel
ája	kilde
ákšu	øks
álbmot	folk
álddagas	lyn
állat	snøspurv
ámmát	stilling
áppes	abc-bok
árbi	arv
árga	árgabeaivi
árga	hverdag
árja	iver
árpa	rift
árpu	tråd
árran	ildsted
árvalus	forslag
árvu	verd
ásahus	foranstaltning
ássi	innbygger
ávvu	fryd
ávži	dal
ávži	juv
ávžžuhus	oppfordring
ášši	sak
áššálaš	tiltalt
á†estus	trengsel
čahki	snøklump
čakča	høst
čalbmi	øye
čanas	bind
čanastat	band
čanastat	bånd
časttas	hård
čeabet	hals
čearga	fokkskavl
čelččen	čeŋkkeš
čelččen	lillefinger
čeŋkkeš	čelččen
čeŋkkeš	lillefinger
čibbi	kne
čiehka	krok
čielgi	rygg
čikŋa	stas
čilgehus	forklaring
čilla	skyteskjul
čitna	trekull
čivga	unge
čižži	bryst
čoahkkin	møte
čoakkalmas	forsamling
čoalli	tarm
čoaltu	klump
čoamohas	bog
čoarbealli	hofte
čoarvi	horn
čoarvvuš	gevir
čoavdda	nøkkel
čoavji	mage
čoavžžu	snipe
čohkka	fjelltopp
čohkka	topp
čohkun	kam
čolga	spytt
čopma	haug
čorbma	håndfull
čorru	haug
čotta	hals
čuhti	tsjude
čuoibmi	stake
čuoigi	skiløper
čuoika	mygg
čuojanas	musikkinstrument
čuokkis	punkt
čuokkis	punktum
čuolbma	knute
čuolda	stolpe
čuomas	fiskeskjell
čuopma	fiskeskinn
čuorpmas	hagl
čuorpmas	snø
čuovga	lys
čuovža	sik
čuru	flue
čuvdi	pekefinger
čáhci	vann
čáhci	vatn
čáihni	fregne
čáihni	hakkespett
čálli	sekretær
čázet	sommerkomag
divga	bjølle
duovdda	beiteområde
dámmá	hoppe
dámmá	hest
dávgi	fjær
ealát	beite
gatna	flass
giera	utspring
goatnil	sted
gohppi	bukt
gorsa	dal
gorsa	kløft
guksi	øse
guksi	ause
gáibmi	navnebror
gáibmi	navnesøster
gárdin	hus
gárgu	grunne
haŋŋá	isand
haŋŋá	havelle
hersko	mat
johka	elv
johtu	bevegelse
leakša	grasmyr
lihkahus	ekstase
lohpi	lov
mealli	padleåre
mealli	styreåre
muoddá	pesk
muoŧŧá	tante
muoŧŧá	moster
mátta	del
njáhcu	snø
nuortalaš	østsame
rievssat	rype
rievssat	lirype
rivgu	kvinne
riđđu	storm
časttas	snøskavl
čuhti	sagnfigur
infekšuvdnaossodat	infeksjonsavdeling
agenda	agenda
saga	saga
medija	media
melodrámá	melodrama
lemma	lemma
plasma	plasma
teleplasma	teleplasma
protoplasma	protoplasma
cytoplasma	cytoplasma
karborunduma	karborunduma
perigeuma	perigeuma
apogeuma	apogeuma
ateneuma	ateneuma
karbolineuma	karbolineuma
struma	struma
scena	scena
algebra	algebra
homofoba	homofob
radikánda	radikand
diskriminánda	diskriminand
trenda	trend
trenda	trend
rombe	rombe
paráda	parade
allehonda	allehånde
tragediija	tragedie
komediija	komedie
kasserola	kasserolle
orgasma	orgasme
entusiasma	entusiasme
ikonoklasma	ikonoklasme
dadaisma	dadaisme
judaisma	judaisme
lamaisma	lamaisme
bramaisma	bramaisme
mosaisma	mosaisme
árkabisma	arkabisme
earkebisma	erkebisme
bisma	bisme
snobbisma	snobbisme
kubisma	kubisme
fascisma	fascisme
nomadisma	nomadisme
sadisma	sadisme
metodisma	metodisme
nordisma	nordisme
absurdisma	absurdisme
talmudisma	talmudisme
nudisma	nudisme
deisma	deisme
manikeisma	manikeisme
epikureisma	epikureisme
fariseisma	fariseisme
teisma	teisme
ateisma	ateisme
panteisma	panteisme
monoteisma	monoteisme
polyteisma	polyteisme
pasifisma	pasifisme
antropomorfisma	antropomorfisme
dimorfisma	dimorfisme
isomorfisma	isomorfisme
imagisma	imagisme
norvagisma	norvagisme
logisma	logisme
synergisma	synergisme
georgisma	georgisme
sadomasochisma	sadomasochisme
masochisma	masochisme
zenbuddhisma	zenbuddhisme
buddhisma	buddhisme
sjiisma	sjiisme
fetisjisma	fetisjisme
revansjisma	revansjisme
itakisma	itakisme
anarkisma	anarkisme
skisma	skisme
trotskisma	trotskisme
kabbalisma	kabbalisme
kannibalisma	kannibalisme
tribalisma	tribalisme
verbalisma	verbalisme
vandalisma	vandalisme
feodalisma	feodalisme
føydalisma	føydalisme
kolonialisma	kolonialisme
antiimperialisma	antiimperialisme
kulturimperialisma	kulturimperialisme
imperialisma	imperialisme
serialisma	serialisme
materialisma	materialisme
immaterialisma	immaterialisme
industrialisma	industrialisme
eksistensialisma	eksistensialisme
nasjonalsosialisma	nasjonalsosialisme
sosialisma	sosialisme
kommersialisma	kommersialisme
rojalisma	rojalisme
kulturradikalisma	kulturradikalisme
radikalisma	radikalisme
anarkosyndikalisma	anarkosyndikalisme
syndikalisma	syndikalisme
klerikalisma	klerikalisme
vokalisma	vokalisme
animalisma	animalisme
formalisma	formalisme
nominalisma	nominalisme
regionalisma	regionalisme
nationalisma	nationalisme
nasjonalisma	nasjonalisme
rasjonalisma	rasjonalisme
konfesjonalisma	konfesjonalisme
profesjonalisma	profesjonalisme
tradisjonalisma	tradisjonalisme
funksjonalisma	funksjonalisme
konvensjonalisma	konvensjonalisme
paternalisma	paternalisme
konvenšuvdnalisma	konvensjuvnalisme
sosialliberalisma	sosialliberalisme
liberalisma	liberalisme
føderalisma	føderalisme
moralisma	moralisme
sentralisma	sentralisme
nøytralisma	nøytralisme
pluralisma	pluralisme
supranaturalisma	supranaturalisme
naturalisma	naturalisme
strukturalisma	strukturalisme
universalisma	universalisme
fatalisma	fatalisme
monopolkapitalisma	monopolkapitalisme
senkapitalisma	senkapitalisme
seinkapitalisma	seinkapitalisme
statskapitalisma	statskapitalisme
privatkapitalisma	privatkapitalisme
kapitalisma	kapitalisme
vitalisma	vitalisme
fundamentalisma	fundamentalisme
instrumentalisma	instrumentalisme
totalisma	totalisme
dualisma	dualisme
individualisma	individualisme
seksualisma	seksualisme
seksualisma	seksualisme
sensualisma	sensualisme
spiritualisma	spiritualisme
intellektualisma	intellektualisme
bilingvalisma	bilingvalisme
idealisma	idelisme
parallelisma	parallelisme
sosialrealisma	sosialrelisme
neorealisma	neorelisme
realisma	relisme
surrealisma	surrelisme
privatbilisma	privatbilisme
bilisma	bilisme
nihilisma	nihilisme
infantilisma	infantilisme
merkantilisma	merkantilisme
utilisma	utilisme
machiavellisma	machiavellisme
snillisma	snillisme
pointillisma	pointillisme
gaullisma	gaullisme
anabolisma	anabolisme
metabolisma	metabolisme
symbolisma	symbolisme
mongolisma	mongolisme
alkoholisma	alkoholisme
rabulisma	rabulisme
somnambulisma	somnambulisme
populisma	populisme
botulisma	botulisme
dynamisma	dynamisme
akademisma	akademisme
eufemisma	eufemisme
ekstremisma	ekstremisme
muslimisma	muslimisme
animisma	animisme
pessimisma	pessimisme
utviklingsoptimisma	utviklingsoptimisme
optimisma	optimisme
thomisma	thomisme
bromisma	bromisme
atomisma	atomisme
reformisma	reformisme
uniformisma	uniformisme
nonkonformisma	nonkonformisme
konformisma	konformisme
urbanisma	urbanisme
muhamedanisma	muhamedanisme
muhammedanisma	muhammedanisme
paganisma	paganisme
organisma	organisme
leastadianisma	lestadianisme
læstadianisma	læstadianisme
grundtvigianisma	grundtvigianisme
haugianisma	haugianisme
hegelianisma	hegelianisme
vegetarianisma	vegetarianisme
wagnerianisma	wagnerianisme
konfusianisma	konfusianisme
kantianisma	kantianisme
giddenmekanisma	giddenmekanisme
mekanisma	mekanisme
vulkanisma	vulkanisme
sjamanisma	sjamanisme
šamanisma	sjamanisme
bramanisma	bramanisme
humanisma	humanisme
nanisma	nanisme
satanisma	satanisme
puritanisma	puritanisme
spontanisma	spontanisme
galvanisma	galvanisme
hellenisma	hellenisme
rabbinisma	rabbinisme
albinisma	albinisme
morfinisma	morfinisme
vaginisma	vaginisme
stalinisma	stalinisme
feminisma	feminisme
determinisma	determinisme
marxisma-leninisma	marxisme-leninisme
leninisma	leninisme
alpinisma	alpinisme
kalvinisma	kalvinisme
mannssjåvinisma	mannssjåvinisme
sjåvinisma	sjåvinisme
darwinisma	darwinisme
sunnisma	sunnisme
hedonisma	hedonisme
antagonisma	antagonisme
antisionisma	antisionisme
sionisma	sionisme
impressionisma	impressionisme
isolasjonisma	isolasjonisme
profesjonisma	profesjonisme
impresjonisma	impresjonisme
ekspresjonisma	ekspresjonisme
ekshibisjonisma	ekshibisjonisme
perfeksjonisma	perfeksjonisme
proteksjonisma	proteksjonisme
reduksjonisma	reduksjonisme
illusjonisma	illusjonisme
evolusjonisma	evolusjonisme
monisma	monisme
mormonisma	mormonisme
synkronisma	synkronisme
parkinsonisma	parkinsonisme
platonisma	platonisme
plutonisma	plutonisme
modernisma	modernisme
revišunisma	revisjunisme
antikommunisma	antikommunisme
kryptokommunisma	kryptokommunisme
kommunisma	kommunisme
eurokommunisma	eurokommunisme
opportunisma	opportunisme
kynisma	kynisme
maoisma	maoisme
taoisma	taoisme
egoisma	egoisme
jingoisma	jingoisme
heroisma	heroisme
titoisma	titoisme
shintoisma	shintoisme
eskapisma	eskapisme
papisma	papisme
heliotropisma	heliotropisme
tropisma	tropisme
geotropisma	geotropisme
fototropisma	fototropisme
singularisma	singularisme
partikularisma	partikularisme
seminarisma	seminarisme
cæsarisma	cæsarisme
vegetarisma	vegetarisme
monetarisma	monetarisme
totalitarisma	totalitarisme
antimilitarisma	antimilitarisme
militarisma	militarisme
utilitarisma	utilitarisme
unitarisma	unitarisme
parlamentarisma	parlamentarisme
dokumentarisma	dokumentarisme
pauperisma	pauperisme
sekterisma	sekterisme
verisma	verisme
empirisma	empirisme
aforisma	aforisme
rigorisma	rigorisme
behaviorisma	behaviorisme
terrorisma	terrorisme
historisma	historisme
čiehkaprisma	čiehkaprisme
prisma	prisme
sentrisma	sentrisme
ekoturisma	ekoturisme
turisma	turisme
naturisma	naturisme
futurisma	futurisme
amatørisma	amatørisme
nasisma	nasisme
rasisma	rasisme
katolisisma	katolisisme
stoisisma	stoisisme
neoklassisisma	neoklassisisme
wienerklassisisma	wienerklassisisme
klassisisma	klassisisme
kritisisma	kritisisme
eklektisisma	eklektisisme
skeptisisma	skeptisisme
gnostisisma	gnostisisme
agnostisisma	agnostisisme
mystisisma	mystisisme
solipsisma	solipsisme
narsisma	narsisme
parsisma	parsisme
eksorsisma	eksorsisme
narsissisma	narsissisme
skjematisma	skjematisme
pragmatisma	pragmatisme
astigmatisma	astigmatisme
dogmatisma	dogmatisme
animatisma	animatisme
reumatisma	reumatisme
revmatisma	revmatisme
fanatisma	fanatisme
separatisma	separatisme
konservatisma	konservatisme
analfabetisma	analfabetisme
pietisma	pietisme
magnetisma	magnetisme
elektromagnetisma	elektromagnetisme
synkretisma	synkretisme
konkretisma	konkretisme
defaitisma	defaitisme
kosmopolitisma	kosmopolitisme
spiritisma	spiritisme
okkultisma	okkultisme
gigantisma	gigantisme
konsonantisma	konsonantisme
obskurantisma	obskurantisme
protestantisma	protestantisme
dilettantisma	dilettantisme
irredentisma	irredentisme
indifferentisma	indifferentisme
lokalpatriotisma	lokalpatriotisme
patriotisma	patriotisme
hypnotisma	hypnotisme
nepotisma	nepotisme
despotisma	despotisme
eksotisma	eksotisme
baptisma	baptisme
hermafrodittisma	hermafrodittisme
antisemittisma	antisemittisme
semittisma	semittisme
parasittisma	parasittisme
transvestittisma	transvestittisme
autisma	autisme
absolutisma	absolutisme
hinduisma	hinduisme
truisma	truisme
altruisma	altruisme
skandinavisma	skandinavisme
atavisma	atavisme
bilingvisma	bilingvisme
naivisma	naivisme
negativisma	negativisme
relativisma	relativisme
nativisma	nativisme
korporativisma	korporativisme
primitivisma	primitivisme
positivisma	positivisme
aktivisma	aktivisme
objektivisma	objektivisme
subjektivisma	subjektivisme
kollektivisma	kollektivisme
konstruktivisma	konstruktivisme
fauvisma	fauvisme
austromarxisma	austromarxisme
marxisma	marxisme
lobyisma	lobyisme
mccarthyisma	mccarthyisme
nazisma	nazisme
kommuvdna	kommune
sjánsa	sjanse
balansa	balanse
differánsa	differanse
elihta	elite
asymtohta	asymptote
asymptohtta	asymptote
liidnakláva	linklave
gráfa	graf
paragráfa	paragraf
paragráfa	paragraf
páragráfa	paragraf
telegráfa	telegraf
videográfa	videograf
geográfa	geograf
historiográfa	historiograf
leksikográfa	leksikograf
stenográfa	stenograf
typográfa	typograf
fotográfa	fotograf
autográfa	autograf
morfa	morf
pinjoŋga	pinjong
fobiija	fobi
logopediija	logopedi
ensyklopediija	ensyklopedi
melodiija	melodi
parodiija	parodi
prosodiija	prosodi
rapsodiija	rapsodi
nevrografiija	nevrografi
telegrafiija	telegrafi
kalligrafiija	kalligrafi
kemigrafiija	kjemigrafi
serigrafiija	serigrafi
geografiija	geografi
paleografiija	paleografi
koreografiija	koreografi
autobiografiija	autobiografi
iešbiografiija	selvbiografi
biografiija	biografi
bibliografiija	bibliografi
bibliográfiija	bibliografi
leksikográfiija	leksikografi
diskografiija	diskografi
xylografiija	xylografi
demografiija	demografi
mammografiija	mammografi
pomografiija	pomografi
scenografiija	scenografi
oseanografiija	osenografi
stenografiija	stenografi
monografiija	monografi
pornografiija	pornografi
etnografiija	etnografi
topografiija	topografi
topográfiija	topografi
typografiija	typografi
xerografiija	xerografi
petrografiija	petrografi
litografiija	litografi
fotografiija	fotografi
ortografiija	ortografi
amfiija	amfi
deahkkeatrofiija	dehkkeatrofi
deahkkedystrofiija	dehkkedystrofi
teosofiija	teosofi
filosofiija	filosofi
antroposofiija	antroposofi
elegiija	elegi
regiija	regi
strategiija	strategi
strátegiija	strategi
kardialgiija	kardialgi
neuralgiija	neuralgi
nevralgiija	nevralgi
myalgiija	myalgi
nevrologiija	nevrologi
analogiija	analogi
mineralogiija	mineralogi
genealogiija	genelogi
metodologiija	metodologi
ideologiija	ideologi
geologiija	geologi
arkeologiija	arkeologi
teleologiija	teleologi
fraseologiija	fraseologi
teologiija	teologi
grafologiija	grafologi
morfologiija	morfologi
sáivacáhcebiologiija	ferskvannsbiologi
resursabiologiija	ressursbiologi
biologiija	biologi
radiologiija	radiologi
bakteriologiija	bakteriologi
triologiija	triologi
glasiologiija	glasiologi
semasiologiija	semasiologi
sosiologiija	sosiologi
nevrofysiologiija	nevrofysiologi
fysiologiija	fysiologi
farmakologiija	farmakologi
etnoekologiija	etnoekologi
ekologiija	ekologi
gynekologiija	gynekologi
leksikologiija	leksikologi
psikologiija	psikologi
onkologiija	onkologi
mykologiija	mykologi
psykologiija	psykologi
gestaltpsykologiija	gestaltpsykologi
filologiija	filologi
etymologiija	etymologi
røntgenologiija	røntgenologi
frenologiija	frenologi
kriminologiija	kriminologi
davvisámegielterminologiija	nordsameterminologi
terminologiija	terminologi
terminologiija	terminologi
guolástusteknologiija	fiskeriteknologi
giellateknologiija	språkteknologi
kártateknologiija	kartteknologi
ođđaáiggeteknologiija	nyteknologi
teknologiija	teknologi
bioteknologiija	bioteknologi
hymnologiija	hymnologi
fonologiija	fonologi
morfofonologiija	morfofonologi
kronologiija	kronologi
etnologiija	etnologi
immunologiija	immunologi
zoologiija	zoologi
sosialantropologiija	sosialantropologi
antropologiija	antropologi
typologiija	typologi
arologiija	arologi
meterologiija	meterologi
astrologiija	astrologi
eskatologiija	eskatologi
patologiija	patologi
ornitologiija	ornitologi
sitologiija	sitologi
dialektologiija	dialektologi
antologiija	antologi
ontologiija	ontologi
odontologiija	odontologi
paleontologiija	paleontologi
tautologiija	tautologi
mytologiija	mytologi
allergiija	allergi
lihkkanenergiija	lihkkanenergi
liekkasenergiija	liekkasenergi
čanusenergiija	čanusenergi
orruenergiija	orruenergi
energiija	energi
synergiija	synergi
metallurgiija	metallurgi
kirurgiija	kirurgi
kirurgiija	kirurgi
dramaturgiija	dramaturgi
liturgiija	liturgi
litchi	litchi
sushi	sushi
losjiija	losji
krokiija	kroki
kemiija	kjemi
biokemiija	biokemi
leukemiija	leukemi
anemiija	anemi
fysiognomiija	fysiognomi
ergonomiija	ergonomi
oppanasekonomiija	oppanasøkonomi
márkanekonomiija	markedsøkonomi
iešbirgenekonomiija	selvbergingsøkonomi
ekonomiija	økonomi
økonomiija	økonomi
astronomiija	astronomi
taksonomiija	taksonomi
autonomiija	autonomi
anatomiija	anatomi
dikotomiija	dikotomi
pelletsbuvttadeapmi	pelletsbuvttadepmi
homonymiija	homonymi
synonymiija	synonymi
metonymiija	metonymi
kapellaniija	kapellani
kompaniija	kompani
litaniija	litani
schizofreniija	schizofreni
koloniija	koloni
seremoniija	seremoni
harmoniija	harmoni
ironia	ironi
ergoterapiija	ergoterapi
fysioterapiija	fysioterapi
terapiija	terapi
maskepiija	maskepi
kopiija	kopi
colonoskopiija	colonoskopi
daguerreotypiija	daguerreotypi
psykiariija	psykiari
teoriija	teori
allegoriija	allegori
kategoriija	kategori
konditoriija	konditori
pediatriija	pediatri
psykiatriija	psykiatri
geriatriija	geriatri
dosametriija	dosametri
telemetriija	telemetri
symmetriija	symmetri
asymmetriija	asymmetri
geometriija	geometri
trigonometriija	trigonometri
industriija	industri
servodatfarmasiija	samfunnsfarmasi
farmasiija	farmasi
servvodatfarmasiija	samfunnsfarmasi
fantasiija	fantasi
poesiija	poesi
anestesiija	anestesi
dysleksiija	dysleksi
biopsiija	biopsi
suprematiija	supremati
telepatiija	telepati
empatiija	empati
sympatiija	sympati
homeopatiija	homeopati
systematihkka	systematikk
resepšuvdnaestetihkka	resepsjonsestetikk
symbála	symbal
linjála	linjal
radikála	radikal
pokála	pokal
guovdonormála	guovdonormal
bakkanála	bakkanal
semi-finála	semi-final
semifinála	semifinal
terminála	terminal
rituála	ritual
hyperbel	hyperbel
formel	formel
trippela	trippel
trippel	trippel
racerbiila	racerbil
vegetabiila	vegetabil
stabiila	stabil
pedofiila	pedofil
homofiila	homofil
heterofiila	heterofil
profiila	profil
domisiila	domisil
bordealla	bordell
lamealla	lamell
karamealla	karamell
propealla	propell
tomáhtamakrealla	tomatmakrell
makrealla	makrell
eananprohtokolla	jordprotokoll
gažadanprohtokolla	forhørsprotokoll
gažadanprotokolla	forhørsprotokoll
prohtokolla	protokoll
protokolla	protokoll
kontrolla	kontroll
parabola	parabol
!modula	!modul
vinyla	vinyl
kapitéla	kapitél
amalgáma	amalgam
madapoláma	madapolam
nikkeleksema	nikkeleksem
eksema	eksem
emfysema	emfysem
kondoma	kondom
molybden	molybden
skarlagen	skarlagen
mutagena	mutagen
skabilken	skabilken
campen	campen
mandariidna	mandarin
heahtetelefovdna	hehtetelefon
bealjoštelefovdna	beljosjtelefon
mobiltelefovdna	mobiltelefon
mobiltelefuvdna	mobiltelefon
almmustelefovdna	almmustelefon
telefovdna	telefon
telefuvdna	telefon
trifovdna	trifon
gramofovdna	gramofon
grammofovdna	grammofon
mikrofovdna	mikrofon
mikrofuvdna	mikrofon
polygona	polygon
regiovdna	region
regiuvdna	region
religiovdna	religion
religiuvdna	religion
opiniovdna	opinion
opponiovdna	opponion
uniovdna	union
spiovdna	spion
spiuvdna	spion
bataljovdna	bataljon
akkommodašuvdna	akkommodasjon
delegašuvdna	delegasjon
negašuvdna	negasjon
obligašuvdna	obligasjon
variašuvdna	variasjon
ekspropriašuvdna	ekspropriasjon
assosiašuvdna	assosiasjon
kvalifikašuvdna	kvalifikasjon
spesifikašuvdna	spesifikasjon
klassifikašuvdna	klassifikasjon
ratifikašuvdna	ratifikasjon
identifikašuvdna	identifikasjon
reaidaoblikašuvdna	reidaoblikasjon
oblikašuvdna	oblikasjon
publikašuvdna	publikasjon
implikašuvdna	implikasjon
kommunikašuvdna	kommunikasjon
provokašuvdna	provokasjon
relašuvdna	relasjon
relášuvdna	relasjon
deflašuvdna	deflasjon
inflašuvdna	inflasjon
allimilašuvdna	allimilasjon
assimilašuvdna	assimilasjon
ventilašuvdna	ventilasjon
videoinstallašuvdna	videoinstallasjon
installašuvdna	installasjon
appellašuvdna	appellasjon
interpellašuvdna	interpellasjon
konstellašuvdna	konstellasjon
isolašuvdna	isolasjon
spekulašuvdna	spekulasjon
artikulašuvdna	artikulasjon
populašuvdna	populasjon
deklamašuvdna	deklamasjon
reklamašuvdna	reklamasjon
akklamašuvdna	akklamasjon
proklamašuvdna	proklamasjon
animašuvdna	animasjon
automašuvdna	automasjon
konfirmašuvdna	konfirmasjon
konfirmašuvdna	konfirmasjon
reformašuvdna	reformasjon
informašuvdna	informasjon
transformašuvdna	transformasjon
transformašuvdna	transformasjon
našovdna	nasjon
našuvdna	nasjon
nášuvdna	nasjon
náššuvdna	nasjon
vokalkombinašuvdna	vokalkombinasjon
kombinašuvdna	kombinasjon
objeaktasubordinašuvdna	objektasubordinasjon
koordinašuvdna	koordinasjon
geminašuvdna	geminasjon
nominašuvdna	nominasjon
supinašuvdna	supinasjon
pronašuvdna	pronasjon
intonašuvdna	intonasjon
pašuvdna	pasjon
okkupašuvdna	okkupasjon
deklarašuvdna	deklarasjon
deklarášuvdna	deklarasjon
separašuvdna	separasjon
federašuvdna	federasjon
operašuvdna	operasjon
alliterašuvdna	alliterasjon
allitterašuvdna	allitterasjon
dovddaintegrašuvdna	dovddaintegrasjon
integrašuvdna	integrasjon
aspirašuvdna	aspirasjon
inspirašuvdna	inspirasjon
konsentrašuvdna	konsentrasjon
administrašuvdna	administrasjon
demonstrašuvdna	demonstrasjon
frustrašuvdna	frustrasjon
akkulturašuvdna	akkulturasjon
sosialisašuvdna	sosialisasjon
grammatikalisašuvdna	grammatikalisasjon
nasalisašuvdna	nasalisasjon
sivilisašuvdna	sivilisasjon
veahkkeorganisašuvdna	hjelpeorganisasjon
ámmátorganisašuvdna	fagorganisasjon
almmosorganisašuvdna	almmosorganisasjon
organisašuvdna	organisasjon
orgánisašuvdna	organisasjon
kolonisašuvdna	kolonisasjon
linearisašuvdna	linerisasjon
dulkaautorisašuvdna	tolkeautorisasjon
autorisašuvdna	autorisasjon
improvisašuvdna	improvisasjon
kompensašuvdna	kompensasjon
dispensašuvdna	dispensasjon
sensašuvdna	sensasjon
kassašuvdna	kassasjon
vegetašuvdna	vegetasjon
kavitašuvdna	kavitasjon
gravitašuvdna	gravitasjon
konsultašuvdna	konsultasjon
konsultášuvdna	konsultasjon
dokumeantašuvdna	dokumentasjon
dokumentašuvdna	dokumentasjon
presentašuvdna	presentasjon
representašuvdna	representasjon
representašuvdna	representasjon
notašuvdna	notasjon
denotašuvdna	denotasjon
konnotašuvdna	konnotasjon
adaptašuvdna	adaptasjon
dissertašuvdna	dissertasjon
bumpestašuvdna	pumpestasjon
totálastašuvdna	totalstasjon
totálstašuvdna	totalstasjon
čáskadanstašuvdna	časkadanstasjon
bensinstašuvdna	bensinstasjon
diskeahttastašuvdna	diskettstasjon
stašuvdna	stasjon
stášuvdna	stasjon
manifestašuvdna	manifestasjon
mutašuvdna	mutasjon
permutašuvdna	permutasjon
deputašuvdna	deputasjon
derivašuvdna	derivasjon
motivašuvdna	motivasjon
innovašuvdna	innovasjon
profešuvdna	profesjon
supplešuvdna	supplesjon
regrešuvdna	regresjon
progrešuvdna	progresjon
komprešuvdna	kompresjon
sešuvdna	sesjon
industrikonsešuvdna	industrikonsesjon
konsešuvdna	konsesjon
tradišuvdna	tradisjon
addišuvdna	addisjon
ekspedišuvdna	ekspedisjon
mišovdna	misjon
miššovdna	misjon
mišuvdna	misjon
miššuvdna	misjon
lappekommišuvdna	lappekommisjon
kommišovdna	kommisjon
kommišuvdna	kommisjon
komišuvdna	komisjon
pearmišovdna	permisjon
pearbmišuvdna	permisjon
pearmišuvdna	permisjon
permišuvdna	permisjon
trasmišuvdna	transmisjon
kognišuvdna	kognisjon
definišuvdna	definisjon
rekvisišuvdna	rekvisisjon
transišuvdna	transisjon
Wackernagel-posišuvdna	Wackernagel-posisjon
posišuvdna	posisjon
adposišuvdna	adposisjon
preposišuvdna	preposisjon
komposišuvdna	komposisjon
proposišuvdna	proposisjon
anaforalašapposišuvdna	anaforapposisjon
kvantifiserenapposišuvdna	kvantifiseringsapposisjon
identifiserenapposišuvdna	identifiseringsapposisjon
ekvaliserenapposišuvdna	ekvaliseringsapposisjon
presiserenapposišuvdna	presiseringsapposisjon
opposišuvdna	opposisjon
disposišuvdna	disposisjon
postposišuvdna	postposisjon
repetišuvdna	repetisjon
intuišuvdna	intuisjon
višuvdna	visjon
televišuvdna	televisjon
riikkarevišuvdna	riksrevisjon
revišuvdna	revisjon
divišuvdna	divisjon
bearranprovišuvdna	berranprovisjon
álggahanprovišuvdna	startprovisjon
kássakredihttaprovišuvdna	kassekredittprovisjon
provišuvdna	provisjon
!akšuvdna	!aksjon
!ákšuvdna	!aksjon
politiakšuvdna	politiaksjon
vásedinakšuvdna	vasedinaksjon
álbmotakšuvdna	albmotaksjon
akšuvdna	aksjon
ákšuvdna	aksjon
redakšuvdna	redaksjon
trakšuvdna	traksjon
kontrakšuvdna	kontraksjon
erohussubstrakšuvdna	forskjellssubstraksjon
substrakšuvdna	substraksjon
infekšuvdna	infeksjon
desinfekšuvdna	desinfeksjon
bijekšuvdna	bijeksjon
projekšuvdna	projeksjon
interjekšuvdna	interjeksjon
lekšuvdna	leksjon
reflekšuvdna	refleksjon
kollekšuvdna	kolleksjon
introspekšu	introspeksjon
mororeakšuvdna	mororeksjon
váimmusreakšuvdna	vaimmusreksjon
reakšuvdna	reksjon
rekšuvdna	reksjon
rekreakšuvdna	rekreksjon
sekšuvdna	seksjon
kontradikšuvdna	kontradiksjon
jurisdikšuvdna	jurisdiksjon
fikšuvdna	fiksjon
restrikšuvdna	restriksjon
nuppipoteansafunkšuvdna	andrepotensfunksjon
funkšuvdna	funksjon
konjunkšuvdna	konjunksjon
disjunkšuvdna	disjunksjon
obdukšuvdna	obduksjon
redukšuvdna	reduksjon
indukšuvdna	induksjon
produkšuvdna	produksjon
instrukšuvdna	instruksjon
konstrukšuvdna	konstruksjon
dekonstrukšuvdna	dekonstruksjon
asfáltaemulšuvdna	asfaltemulsjon
subsumšuvdna	subsumsjon
presumšuvdna	presumsjon
ekspanšuvdna	ekspansjon
dimenšuvdna	dimensjon
maŋisbáhcciidpenšuvdna	maŋisbahcciidpensjon
boarrásiidpenšuvdna	boarrasiidpensjon
penšuvdna	pensjon
suspenšuvdna	suspensjon
ekstenšuvdna	ekstensjon
prevenšuvdna	prevensjon
sámekonvenšuvdna	samekonvensjon
boazoguohtonkonvenšuvdna	boazoguohtonkonvensjon
biokonvenšuvdna	biokonvensjon
biogirjáivuođakonvenšuvdna	biomangfoldskonvensjon
konvenšuvdna	konvensjon
erošuvdna	erosjon
korrošuvdna	korrosjon
resepšuvdna	resepsjon
persepšuvdna	persepsjon
preskripšuvdna	preskripsjon
preskripšuvdna	preskripsjon
transkripšuvdna	transkripsjon
presumpšuvdna	presumpsjon
adopšuvdna	adopsjon
peršuvdna	persjon
veršuvdna	versjon
kaušuvdna	kausjon
distribušuvdna	distribusjon
refušuvdna	refusjon
transfušuvdna	transfusjon
konklušuvdna	konklusjon
resolušuvdna	resolusjon
evolušuvdna	evolusjon
revolušuvdna	revolusjon
jietnadatsubstitušuvdna	uttalesubstitusjon
substitušuvdna	substitusjon
institušuvdna	institusjon
konstitušuvdna	konstitusjon
prostitušuvdna	prostitusjon
melovdna	melon
sitrovdna	sitron
sitruvdna	sitron
garnisovdna	garnison
bárduvdna	bardun
tranfušuvdnadálkun	tranfusjonsdalkun
risiko	risiko
risiko	risiko
dynámo	dynamo
bistro	bistro
vikára	vikar
designer	designer
topscorer	topscorer
scooter	scooter
suvenira	suvenir
projektor	projektor
kandidatuvra	kandidatur
litteratuvra	litteratur
skulptuvra	skulptur
tekstuvra	tekstur
blues	blues
praksis	praksis
faxa	faks
koksa	koks
tangeansa	tangens
cotangeansa	cotangens
kompetensa	kompetens
poteansa	potens
eksistensa	eksistens
responsa	respons
radius	radius
hypotenus	hypotenus
cosinus	cosinus
poehta	poet
formalitehta	formalitet
formálitehta	formalitet
reliabiliteahtta	reliabilitet
stabilitehta	stabilitet
legitimitehta	legitimitet
artefákta	artefakt
symbolaeffeakta	symboleffekt
effeakta	effekt
perfeakta	perfekt
imperfeakta	imperfekt
dialeakta	dialekt
kolleakta	kollekt
idioleakta	idiolekt
kneakta	knekt
respeakta	respekt
direakta	direkt
indireakta	indirekt
arkiteakta	arkitekt
sibilánta	sibilant
kvotieanta	kvotient
kvotienta	kvotient
produseanta	produsent
stárta	start
identifikašuvdnagoarta	identifikasjonskort
avsnihta	avsnitt
trombocyhtta	trombocytt
oliiva	oliv
diehtointensiiva	kunnskapsintensiv
passiiva	passiv
essiiva	essiv
vearbaabessiiva	verbabessiv
abessiiva	abessiv
adessiiva	adessiv
ekspressiiva	ekspressiv
possessiiva	possessiv
datiiva	dativ
interrogatiiva	interrogativ
initiatiiva	initiativ
infinihttapredikatiiva	infinittpredikativ
predikatiiva	predikativ
indikatiiva	indikativ
multiplikatiiva	multiplikativ
implikatiiva	implikativ
lokatiiva	lokativ
vokatiiva	vokativ
ablatiiva	ablativ
allatiiva	allativ
appellatiiva	appellativ
illatiiva	illativ
superlatiiva	superlativ
translatiiva	translativ
regulatiiva	regulativ
kopulatiiva	kopulativ
eksklamatiiva	eksklamativ
informatiiva	informativ
nominatiiva	nominativ
terminatiiva	terminativ
konatiiva	konativ
alternatiiva	alternativ
inkoatiiva	inkoativ
komparatiiva	komparativ
deliberatiiva	deliberativ
desideratiiva	desiderativ
imperatiiva	imperativ
demonstratiiva	demonstrativ
duratiiva	durativ
kausatiiva	kausativ
akkusatiiva	akkusativ
dubitatiiva	dubitativ
kvalitatiiva	kvalitativ
komitatiiva	komitativ
sitatiiva	sitativ
privatiiva	privativ
priváhtiiva	privativ
innovatiiva	innovativ
konservatiiva	konservativ
vearbagenetiiva	verbgenetiv
genetiiva	genetiv
habitiiva	habitiv
additiiva	additiv
totalitiiva	totalitiv
genitiiva	genitiv
kognitiiva	kognitiv
initiiva	initiv
infinitiiva	infinitiv
partitiiva	partitiv
fortuitiiva	fortuitiv
aktiiva	aktiv
subtraktiiva	subtraktiv
adjektiiva	adjektiv
kollektiiva	kollektiv
konnektiiva	konnektiv
peršpektiiva	persjpektiv
perspektiiva	perspektiv
rektiiva	rektiv
direktiiva	direktiv
kommeantaadjunktiiva	kommentaradjunktiv
refereansaadjunktiiva	referensadjunktiv
adjunktiiva	adjunktiv
deduktiiva	deduktiv
prosubstantiiva	prosubstantiv
substantiiva	substantiv
attentiiva	attentiv
álgomotiiva	begynnermotiv
motiiva	motiv
deskriptiiva	deskriptiv
distributiiva	distributiv
konsekutiiva	konsekutiv
subjeaktaoblikutiiva	subjektoblikutiv
oblikutiiva	oblikutiv
deminutiiva	diminutiv
diminutiiva	diminutiv
possessorstatutiiva	possessorstatutiv
statutiiva	statutiv
janteláhka	jantelov
spráija	spray
spraya	spray
esseija	essay
playboy	playboy
progrešuvdnavearba	progresjonsverb
arkipela	arkipelag
alibiija	alibi
abbediija	abbedi
oligarkiija	oligarki
anarkiija	anarki
monarkiija	monarki
hierarkiija	hierarki
autarkiija	autarki
alkaliija	alkali
staffeliija	staffeli
filateliija	filateli
homofiliija	homofili
similiija	simili
rekvisišuvdnačálli	rekvisisjonsčalli
kanselliija	kanselli
tivoliija	tivoli
tivoli	tivoli
kansliija	kansli
bigamiija	bigami
monogamiija	monogami
eksogamiija	eksogami
polygamiija	polygami
akademiija	akademi
premiija	premi
geniija	geni
universalgeniija	universalgeni
tyranniija	tyranni
hegemoniija	hegemoni
deponiija	deponi
baroniija	baroni
polygyniija	polygyni
barbariija	barbari
havariija	havari
polyandriija	polyandri
raffinaderiija	raffinaderi
knaderiija	knaderi
kameraderiija	kameraderi
skredderiija	skredderi
krydderiija	krydderi
rederiija	rederi
fogderiija	fogderi
broderiija	broderi
periferiija	periferi
drogeriija	drogeri
meieriija	meieri
meieriijá	meieri
menasjeriija	menasjeri
oransjeriija	oransjeri
plafondmaleriija	plafondmaleri
freskomaleriija	freskomaleri
fidusmaleriija	fidusmaleri
maleriija	maleri
gouachemaleriija	gouachemaleri
kavaleriija	kavaleri
kobleriija	kobleri
nasjonalgalleriija	nasjonalgalleri
persongalleriija	persongalleri
kunstgalleriija	kunstgalleri
galleriija	galleri
artilleriija	artilleri
gendarmeriija	gendarmeri
parfymeriija	parfymeri
flaneriija	flaneri
sceneriija	sceneri
raffineriija	raffineri
maskineriija	maskineri
gartneriija	gartneri
raseriija	raseri
fiksfakseriija	fiksfakseri
trakasseriija	trakasseri
presseriija	presseri
tapisseriija	tapisseri
rotisseriija	rotisseri
karosseriija	karosseri
kriteriija	kriteri
bakteriija	bakteri
pedanteriija	pedanteri
infanteriija	infanteri
pikanteriija	pikanteri
galanteriija	galanteri
dilettanteriija	dilettanteri
fantasteriija	fantasteri
sofisteriija	sofisteri
stáhtaruhtaministeriija	stáhtaruhtaministeri
sisáššiidministeriija	sisásjsjiidministeri
eanadoalloministeriija	enadoalloministeri
oahpahusministeriija	oahpahusministeri
ministeriija	ministeri
papisteriija	papisteri
artisteriija	artisteri
hysteriija	hysteri
anodebatteriija	anodebatteri
akkumulatorbatteriija	akkumulatorbatteri
batteriija	batteri
koketteriija	koketteri
lotteriija	lotteri
bijouteriija	bijouteri
porteeeepotpurriija	porteeeepotpurri
diplomatiija	diplomati
teokratiija	teokrati
demokratiija	demokrati
demokratiija	demokrati
timokratiija	timokrati
teknokratiija	teknokrati
byrokratiija	byrokrati
meritokratiija	meritokrati
aristokratiija	aristokrati
autokratiija	autokrati
plutokratiija	plutokrati
byråkratiija	byråkrati
profetija	profeti
rihkuspolitiija	krimitalpoliti
politiija	politi
politiijá	politi
dementiija	dementi
despotiija	despoti
agrarpartiija	agrarparti
kaderpartiija	kaderparti
koalisjonspartiija	koalisjonsparti
opposisjonspartiija	opposisjonsparti
sosialistpartiija	sosialistparti
fløypartiija	fløyparti
partiija	parti
dynastiija	dynasti
amnestiija	amnesti
sakristiija	sakristi
prostiija	prosti
etuiija	etui
salviija	salvi
mediateahka	mediatek
cinemateahka	cinematek
kinemateahka	kinematek
medieteahka	medietek
videoteahka	videotek
pinakoteahka	pinakotek
kinoteahka	kinotek
apoteahka	apotek
hypoteahka	hypotek
fototeahka	fototek
glyptoteahka	glyptotek
artoteahka	artotek
kartoteahka	kartotek
verbála	verbal
modála	modal
bákteregála	bakteregal
vuođđoregála	vuođđoregal
hilggohasregála	hilggohasregal
regála	regal
differensiála	differensial
potensiála	potensial
tertiála	tertial
kjemikála	kjemikal
arsenála	arsenal
nødsignála	nødsignal
signála	signal
ordinála	ordinal
nominála	nominal
urinála	urinal
pennála	pennal
numerála	numeral
ertsminerála	ertsmineral
granatminerála	granatmineral
minerála	mineral
brillefutterála	brillefutteral
futterála	futteral
integrála	integral
plurála	plural
hospitála	hospital
kvartála	kvartal
audiovisuála	audiovisual
audio-visuála	audio-visual
visuála	visual
seksuála	seksual
karnevála	karneval
preambela	prembel
ideála	idel
taffel	taffel
koagela	koagel
tingeltangel	tingeltangel
hammondorgel	hammondorgel
elorgel	elorgel
stalinorgel	stalinorgel
flygel	flygel
tabernakel	tabernakel
orakel	orakel
rekel	rekel
sekel	sekel
spetakkel	spetakkel
vehikkel	vehikkel
instrumentpanela	instrumentpanel
panela	panel
sampel	sampel
eksempel	eksempel
buddhatempel	buddhatempel
datostempel	datostempel
justerstempela	justerstempel
justerstempela	justerstempel
stempel	stempel
koppela	koppel
brensel	brensel
gissel	gissel
epitela	epitel
eksiila	eksil
konsiila	konsil
fissiila	fissil
missiila	missil
fossiila	fossil
prosjektiila	prosjektil
reptiila	reptil
citadealla	citadell
seremoniealla	seremoniell
bakkepersonealla	bakkepersonell
personealla	personell
ritornealla	ritornell
kapealla	kapell
natyrealla	naturell
klientealla	klientell
flotealla	flotell
motealla	motell
kartealla	kartell
sportealla	sportell
kastealla	kastell
sigilla	sigill
codisilla	codisill
skatolla	skatoll
fallossymbola	fallossymbol
statussymbola	statussymbol
kristussymbola	kristussymbol
!filmidola	!filmidol
idola	idol
vinmonopola	vinmonopol
statsmonopola	statsmonopol
monopola	monopol
kolesterola	kolesterol
gásterola	gásterol
dipolmolekyla	dipolmolekyl
DNA-molekyla	DNA-molekyl
molekyla	molekyl
makromolekyla	makromolekyl
alkyla	alkyl
asyla	asyl
diagrámma	diagram
anagrámma	anagram
floragrámma	floragram
pentagrámma	pentagram
kondolansetelegrámma	kondolansetelegram
chiffertelegrámma	chiffertelegram
siffertelegrámma	siffertelegram
telegrámma	telegram
epigrámma	epigram
ideográmma	ideogram
videográmma	videogram
radiográmma	radiogram
kardiográmma	kardiogram
elektrokardiográmma	elektrokardiogram
paralleallográmma	parallellogram
parallellográmma	parallellogram
oscillográmma	oscillogram
holográmma	hologram
termográmma	termogram
seismográmma	seismogram
stenográmma	stenogram
aerográmma	aerogram
dataprográmma	dataprogram
TV-prográmma	TV-program
tv-prográmma	tv-program
prográmma	program
spektrográmma	spektrogram
piktográmma	piktogram
kryptográmma	kryptogram
kartográmma	kartogram
diadema	diadem
modema	modem
ødema	ødem
grafema	grafem
morfema	morfem
rekviema	rekviem
emblema	emblem
fonema	fonem
tonema	tonem
poema	poem
harem	harem
teorema	teorem
ekstrema	ekstrem
anatema	anatem
totema	totem
totem	totem
deccasystema	deccasystem
jurasystema	jurasystem
lymfesystema	lymfesystem
trucksystema	trucksystem
inertialsystema	inertialsystem
vokalsystema	vokalsystem
desimalsystema	desimalsystem
seksagesimalsystema	seksagesimalsystem
signalsystema	signalsystem
alarmsystema	alarmsystem
permsystema	permsystem
ordoviciumsystema	ordoviciumsystem
kambriumsystema	kambriumsystem
karbonsystema	karbonsystem
personsystema	personsystem
devonsystema	devonsystem
flipsystema	flipsystem
chiffersystema	chiffersystem
metersystema	metersystem
silursystema	silursystem
tertiærsystema	tertiærsystem
kvartærsystema	kvartærsystem
triassystema	triassystem
koordinatsystema	koordinatsystem
krittsystema	krittsystem
arkivsystema	arkivsystem
prohibitivsystema	prohibitivsystem
SI-systema	SI-system
touch-systema	touch-system
systema	system
ekosystema	ekosystem
økosystema	økosystem
misseriibma	misserim
fax+N+Sg+Nom	fax+N+Sg+Nom
idioma	idiom
aksioma	aksiom
trakoma	trakom
sarkoma	sarkom
diploma	diplom
binoma	binom
trinoma	trinom
monoma	monom
polynoma	polynom
røntgenlatnja	røntgenrom
obdukšuvdnalatnja	obduksjonsrom
palindroma	palindrom
syndroma	syndrom
nikroma	nikrom
x-kromosoma	x-kromosom
y-kromosoma	y-kromosom
kromosoma	kromosom
atoma	atom
mesonatoma	mesonatom
fantoma	fantom
xantoma	xantom
abstinenssymptoma	abstinenssymptom
symptoma	symptom
albumpa	album
mediija	medium
kollegiija	kollegium
kolegiija	kollegium
govvalaboratoriija	govvalaboratorium
oahpahanlaboratoriija	oahpahanlaboratorium
nagirlaboratoriija	nagirlaboratorium
vahátlaboratoriija	vahátlaboratorium
laboratoriija	laboratorium
loboratoriija	loboratorium
auditoriija	auditorium
territoriija	territorium
faktoriija	faktorium
volubma	volum
voluma	volum
pseudonyma	pseudonym
radiána	radian
njuolggolohkan	njuolggolohkan
repetišuvdnahárjehallan	repetisjonsharjehallan
interpellašuvdnadigaštallan	interpellasjonsdigasjtallan
glykogen	glykogen
halogena	halogen
halogen	halogen
hallusinogena	hallusinogen
hallusinogen	hallusinogen
androgen	androgen
hydrogen	hydrogen
nitrogena	nitrogen
østrogen	østrogen
oksygen	oksygen
alken	alken
naftalena	naftalen
selena	selen
porselena	porselen
pollen	pollen
etylena	etylen
acetylena	acetylen
metylena	metylen
polyetylena	polyetylen
omen	omen
fenomen	fenomen
bitumen	bitumen
aduseren	aduseren
arsen	arsen
karoten	karoten
gluten	gluten
trinitrotoluen	trinitrotoluen
benzen	benzen
lidokaiidna	lidokain
kokaiidna	kokain
trombiidna	trombin
hemoglobiidna	hemoglobin
oksyhemoglobiidna	oksyhemoglobin
turbiidna	turbin
streptomyciidna	streptomycin
gardiidna	gardin
kaffeiidna	kaffein
koffeiidna	koffein
kaseiidna	kasein
teiidna	tein
nukleoproteiidna	nukleoprotein
proteiidna	protein
parafiidna	parafin
olefiidna	olefin
morfiidna	morfin
auberšiidna	aubersjin
pigskiidna	pigskin
liidna	lin
meskaliidna	meskalin
formaliidna	formalin
turmaliidna	turmalin
adrenaliidna	adrenalin
gobeliidna	gobelin
musseliidna	musselin
veliidna	velin
aniliidna	anilin
plastiliidna	plastilin
kliidna	klin
krystalliidna	krystallin
penicilliidna	penicillin
vanilliidna	vanillin
kaoliidna	kaolin
tramboliidna	trambolin
disipliidna	disiplin
popliidna	poplin
globuliidna	globulin
gammaglobuliidna	gammaglobulin
tuberkuliidna	tuberkulin
insuliidna	insulin
amiidna	amin
indamiidna	indamin
melamiidna	melamin
amfetamiidna	amfetamin
A-vitamiidna	A-vitamin
B-vitamiidna	B-vitamin
C-vitamiidna	C-vitamin
D-vitamiidna	D-vitamin
vitamiidna	vitamin
histamiidna	histamin
palmiidna	palmin
karmiidna	karmin
albumiidna	albumin
duralumiidna	duralumin
cyaniidna	cyanin
Ligniidna	lignin
kiniidna	kinin
tanniidna	tannin
heroiidna	heroin
ligroiidna	ligroin
atropiidna	atropin
fariidna	farin
sakkariidna	sakkarin
ultramariidna	ultramarin
rosmariidna	rosmarin
nektariidna	nektarin
antifebriidna	antifebrin
misseriidna	misserin
dekstriidna	dekstrin
tamburiidna	tamburin
antipyriidna	antipyrin
bombasiidna	bombasin
magasiidna	magasin
resiidna	resin
offisiidna	offisin
dioksiidna	dioksin
tyroksiidna	tyroksin
antitoksiidna	antitoksin
toksiidna	toksin
pepsiidna	pepsin
kelatiidna	kelatin
keratiidna	keratin
gratiidna	gratin
kitiidna	kitin
palmitiidna	palmitin
pektiidna	pektin
klementiidna	klementin
terpentiidna	terpentin
nikotiidna	nikotin
hormovdna	hormon
kanovdna	kanon
natrovdna	natron
elektrovdna	elektron
elektruvdna	elektron
elektruvdna	elektron
oscilloskohppa	oscilloskop
singulára	singular
heksaedar	heksaeder
charter	charter
klaviatuvra	klaviatur
nomenklatuvra	nomenklatur
simulatuvra	simulatur
armatuvra	armatur
militærdiktatuvra	militærdiktatur
diktatuvra	diktatur
tastatuvra	tastatur
kreatuvra	kretur
klaverpartituvra	klaverpartitur
partituvra	partitur
prefektuvra	prefektur
agentuvra	agentur
dosentuvra	dosentur
kvestuvra	kvestur
trapesa	trapes
korpsa	korps
premissa	premiss
kompromissa	kompromiss
refušuvdnagáibádus	refusjonsgaibadus
opšuvdnašiehtadus	opsjonssjiehtadus
tertiearaealáhus	tertiærelahus
infiltrašuvdnagoivvohat	infiltrasjonsgoivvohat
kvadráhtta	kvadrat
attentáhtta	attentat
infiltrašuvdnarusttet	infiltrasjonsrusttet
objeakta	objekt
pronomensubjeakta	pronomensubjekt
subjeakta	subjekt
projeakta	projekt
ovdaprošeakta	ovdaprosjekt
pilohtaprošeakta	pilohtaprosjekt
giellarevitaliserenprošeakta	giellarevitaliserenprosjekt
miššunprošeakta	misjsjunprosjekt
prošeakta	prosjekt
aspeakta	aspekt
reakta	rekt
alitkreakta	alitkrekt
kreakta	krekt
inseakta	insekt
veakta	vekt
relikta	relikt
punkta	punkt
abonnemeanta	abonnement
gierdosegmeanta	gierdosegment
tabu	tabu
gáiddusarkiiva	gaiddusarkiv
arkiiva	arkiv
árkiiva	arkiv
govdunliiva	govdunliv
liiva	liv
infekšuvdnabáiki	infeksjonssted
altádna	altan
altána	altan
solista	solist
solista	solist
satanista	satanist
terrorista	terrorist
favorihtta	favoritt
ekstensiiva	ekstensiv
ii	ikke
leat	være
addit	gi
ahcit	flø
ahkiduššat	vantrives
almmuhit	bekjentgjøre
arvat	våge
atnit	bruke
badjelgeahččat	forakte
badjelgeahččat	nedvurdere
badjánit	stige
bagadit	oppdra
bagadit	rettlede
bagadit	straffe
baikit	skite
bajidit	heve
bajidit	løfte
baldit	skremme
bargat	arbeide
bassat	vaske
bassit	steike
basuhit	helligholde
beahkit	krype
beahttit	bedra
beahttit	narre
bealkit	skjenne
beastit	berge
beastit	frelse
beaškit	slamre
beaškit	smelle
berret	burde
berret	måtte
bidjat	legge
bidjat	sette
biebmat	fø
bieggat	blåse
biehkut	klynke
biehkut	sutre
biehtadit	benekte
biehtadit	nekte
biehttalit	fornekte
biestit	miste
biestit	slippe
bihtit	klare
biidnašuvvat	pines
biinnidit	pine
bilkidit	spotte
bindit	vare
bistit	vare
bisánit	stoppe
biđget	spre
biđget	ødelegge
biškut	gale
biškut	hyle
biškut	skrike
boagustit	flire
boagustit	le
boahtit	komme
boaibmut	pille
boaibmut	plukke
bohkat	bore
bohrraidit	fosse
bohrraidit	hvirvle
bohtanit	hovne
boktit	vekke
borahit	fore
borgat	fyke
borggistit	ryke
borgguhit	røyke
borjjastit	seile
boršut	fosse
boršut	sprute
bossut	blåse
botnjat	vri
bovdet	innby
bovdet	invitere
boŋkit	brake
boŋkit	dundre
buhtistit	rense
buhttet	erstatte
buokčalit	dykke
buoridit	forbedre
buoskut	fjerte
buoššudit	forherde
buoššudit	herde
buressivdnidit	velsigne
buvttihit	nå
buvttihit	rekke
buvvánit	kveles
buđaldit	pusle
buškkihit	smette
báddat	svulme
bágget	tvinge
báhccat	sprette
báhtarit	flykte
báhtarit	rømme
báhčit	skyte
báhčit	stikke
báidnit	påvirke
báisat	hovne
báisat	svulme
báitit	skinne
bálkáhit	betale
bálkáhit	leie
bánccardit	sprelle
bárgidit	flette
caggat	forhindre
cahkat	ulme
cahkkehit	tenne
ciehpat	gnage
ciellat	bjeffe
ciellat	gjø
cihcit	barke
cihraidit	pipe
cihraidit	pistre
cikcut	klype
cikcut	knipe
cirgut	sprute
cissat	pisse
cissat	tisse
civkit	kvitre
coahkkit	tikke
coahkut	minke
coahkut	synke
coakcut	fotfeste
coakcut	få
coggat	putte
coggat	stappe
cuiggodit	advare
cuiggodit	formane
cuoigut	påpeke
cuskit	fnyse
cábmit	banke
cábmit	slå
cáhpat	karve
dadjat	si
dahkat	gjøre
dahppat	lukke
dahppat	stenge
darrat	riste
darrat	skjelve
deaddit	trykke
deaivat	treffe
deaivvadit	møtes
dearpat	slå
deavdit	fylle
deaškut	klaske
diehtit	vite
dieđihit	melde
dieđihit	opplyse
diggidit	diskutere
diggidit	krangle
diggot	bestille
diggot	diskutere
diggot	trette
diktit	la
diktit	tillate
dikšut	pleie
dikšut	stelle
divvut	reparere
diškut	skvette
doadjit	bryte
doadjit	knekke
doahput	gripe
doahttalit	akte
doaimmahit	utføre
doaimmahit	utrette
doaivut	håpe
doaivut	tro
doallat	holde
doalvut	bortføre
doalvvástit	trave
doarggistit	skjelve
doarjalit	støtte
doarjut	støtte
doarridit	forfølge
doarrut	sloss
doarrut	stange
doddjot	brekke
dohkkehit	godta
dohkket	duge
doidit	skylle
dovddahit	røpe
dovddastit	bekjenne
dovddastit	innrømme
dubmet	dømme
duddjot	lage
duhkoraddat	leike
duhkoraddat	leke
duktet	gjødsle
dulbet	jevne
dulkot	tolke
duogŋat	lappe
duohpat	hale
duolbmat	tråkke
duolbmat	trø
duoldat	koke
duostat	tore
duostat	våge
duođaštit	bekrefte
duođaštit	vidne
durddidit	
durddidit	tilskitne
dutkat	forske
dutkat	granske
duvdit	puffe
duvdit	støtte
duđđat	tumle
duđđat	vase
duššat	omkomme
dádjut	tøve
dádjut	tøyse
dáhkidit	bekrefte
dáhkidit	garantere
dáhpáhuvvat	hende
dáhpáhuvvat	skje
dáhttut	ville
dáhttut	ønske
dáisut	tøve
dájuhit	narre
dállet	riste
dálset	tøyse
dálset	vrøvle
dáncat	trampe
dánsut	danse
dápmat	temme
dárbbašit	behøve
dárbbašit	trenge
dárkut	betrakte
dárkut	undersøke
dásset	jamne
dásset	jevne
dávistit	gjenlyde
eahpidit	tvile
eallit	leve
ealáskit	kvikne
earránit	skilles
earuhit	skille
earuhit	skjelne
einnostit	spå
evttohit	foreslå
fallehit	angripe
faskut	skrape
fađđut	vifte
fearrat	telje
ferdnet	kverne
ferdnet	male
fidnet	få
fieradit	rulle
fieradit	tumle
fierralit	dette
fierralit	falle
fierrat	rulle
fierrut	
fierrut	røre
fievrridit	frakte
fihttet	oppfatte
fillet	narre
fuobmát	oppdage
fuoikut	jamre
fuomášit	oppdage
fággádit	bryte
fáiput	vifte
fáktet	passe
fáktet	vokte
fállat	tilby
fárret	flytte
fáškut	flakse
fáškut	slenge
gahkit	gnage
gahčat	spørre
gahččat	falle
gaikkihit	rykke
gaikut	rive
gaikut	slite
gaikánit	revne
gaivát	glane
gaivát	glo
gakcut	klatre
galbmit	
galbmit	tilfryse
galbmot	fryse
galgat	skulle
galkat	sprette
galledit	besøke
gallet	besøke
garrudit	banne
garrudit	forbanne
gaskit	plukke
gaskit	ribbe
gaskkalduhttit	avbryte
gastit	nyse
gavvit	nappe
gazzut	klore
gažadit	intervjue
gažadit	spørre
geahkat	
geahkat	ymte
geahpedit	lette
geahpedit	minske
geahččalit	prøve
geaidit	trylle
gealdit	spenne
geallat	polere
geallat	pusse
gearjidit	tigge
geasehit	frakte
geasehit	kjøre
geassit	dra
geassit	trekke
geavahit	bruke
gerret	rose
gerret	skryte
giddet	feste
gieldit	forby
gieldit	nekte
gielistit	lyge
gierdat	tåle
giessat	nøste
giessat	surre
giessat	vikle
gihčat	knirke
giitit	takke
giktit	lokke
gilljut	brøle
gilljut	hyle
gillát	tåle
gilvalit	konkurrere
gilvit	plante
gilvit	så
gincut	sprelle
girdit	fly
givssidit	pine
givssidit	plage
giđđudit	flimre
giđđudit	vrimle
goahcat	bremse
goaikut	dryppe
goaivut	grave
goaivut	måke
goaivut	spa
goallut	fryse
goardit	steike
goardit	varme
goaridit	vanskjøtte
goarrut	sy
goarránit	vantrives
goarránit	visne
goasttidit	bekoste
goastut	
goastut	harskne
gohcit	våke
gohčodit	betegne
gohčodit	kalle
gohččut	be
gohččut	befale
goikadit	tørke
gokčat	dekke
goldit	rote
goldnat	visne
gomihit	velte
gopmánit	kvelve
gopmánit	veltes
gossat	hoste
govdut	flyte
govvidit	fotografere
govvidit	illustrere
gođđit	strikke
gođđit	veve
gudnejahttit	hedre
gudnejahttit	ære
guhkidit	forlenge
gulahit	bekjentgjøre
guldalit	lytte
gullot	høres
guoddalit	anklage
guoddalit	klage
guoddit	bære
guohcagit	råtne
guohpput	mugne
guohtut	beite
guoktiluššat	hykle
guolástit	fiske
guorahallat	undersøke
guorsat	hoste
guoskkahit	berøre
guoskkahit	røre
guossat	snuble
guossohit	servere
guossohit	traktere
guovlat	kike
guovlat	titte
guođohit	gjete
gurret	tømme
gužžat	tisse
gáddit	anta
gáddit	tro
gádjut	berge
gádjut	redde
gággat	bryte
gággat	velte
gáhtat	angre
gáhttet	vokte
gáibidit	kreve
gáidat	forsvinne
gáidat	vike
gáivut	fekte
gáivut	vifte
gálašit	bade
gálašit	vasse
gáldet	gjelde
gáldet	kastrere
gálgat	løse
gárdut	inngjerde
gárvvistit	forberede
gáržudit	innskrenke
gáskit	bite
gáskit	kastrere
gásttašit	døpe
gávastit	gjespe
gávdnat	finne
gávdnot	finnes
gávkat	glane
gávkat	glo
gávnnadit	møtes
gávppašit	handle
gáđaštit	misunne
harrat	knurre
heaibut	bryte
heailut	gynge
heailut	svaie
heaitit	slutte
healkkehit	
healkkehit	kvekke
heavvanit	drukne
heađuštit	forhindre
hehttet	forhindre
hehttet	hindre
heivet	høve
heivet	passe
hervet	dekorere
hilgut	forsmå
hilgut	vrake
hoavridit	mase
hohkahit	lokke
hohkahit	narre
hoigat	puffe
hoigat	skyve
holvut	hyle
holvut	ule
hommát	arbeide
hommát	sysle
hovdet	lede
hovdet	styre
huhttát	kure
huikit	rope
hukset	bygge
hupmat	snakke
huškut	banke
huškut	slå
háddjet	rote
háddjet	spre
háhkat	skaffe
háisut	lukte
háisut	stinke
hálahit	overtale
hálddašit	administrere
hálddašit	rå
háleštit	prate
háliidit	ville
hállat	snakke
hámsut	glefse
hárdit	erte
hárdit	terge
hástit	oppfordre
hástit	utfordre
hávdádit	begrave
hávkat	drukne
idjadit	overnatte
ijastaddat	overnatte
ipmirdit	forstå
ipmirdit	skjønne
irggástaddat	fri
iskat	prøve
iskat	undersøke
jalget	jevne
jeagadit	lyde
jeagadit	lystre
jearrat	spørre
jeđđet	trøste
jiellat	trekke
jienastit	stemme
joatkit	fortsette
joatkit	skjøte
jorahit	dreie
jorahit	snu
jorggihit	snu
jorgut	vrenge
jorrat	dreie
jozzidit	skravle
jozzidit	tøyse
juhcat	bruse
juhcat	suse
juhkat	drikke
julkit	drønne
julkit	dundre
jullat	brake
jullat	drønne
juogadit	dele
juohkit	dele
juoigat	joike
juolludit	avse
juolludit	bevilge
juorbut	rugge
juorbut	vagge
juovzut	vakle
jupmat	larme
jurddašit	tenke
jurrat	dure
jursit	gnage
jámálgit	besvime
jápmit	dø
jávkat	forsvinne
koasttidit	bekoste
lahcat	knake
lahcat	knirke
laigat	løsne
lapmat	sige
lasihit	tillegge
lasihit	øke
laskat	øke
lassánit	øke
leahkastit	åpne
leahkkut	åpne
leaikut	helle
leaikut	skjenke
leikošit	spøke
leikošit	vitse
libaidit	bevre
libaidit	glimte
libaidit	skjelve
ligget	varme
lihkahit	bevege
lihkahit	røre
lihkostuvvat	lykkes
lissat	skrante
livkit	fare
livkit	smette
livvadit	ligge
livzzistit	skjelve
livzzistit	vakle
liškut	skvette
liškut	skvulpe
loaggut	stabbe
loaggut	vagge
loahpahit	avslutte
loahpahit	slutte
loaiddastit	
loaiddastit	framtre
loavdit	tekke
lohkat	lese
lohkat	telle
lohpidit	love
loktet	løfte
lonuhit	bytte
lotnut	betale
ložžet	slakke
ložžet	slappe
luoddanit	revne
luoddanit	sprekke
luoddut	kløyve
luoibmat	jamre
luoikkahit	låne
luoitit	løse
luoitit	slippe
luoittihit	fare
luovvanit	løsne
luvvadit	bløyte
luvvet	løse
láddat	modnes
lágidit	ordne
lágidit	stelle
láhppit	miste
láhčit	re
láidet	leie
láigohit	leie
láitit	klandre
láitit	kritisere
lállit	ruge
lávet	bruke
lávet	pleie
lávkut	skritte
lávlut	synge
manahit	miste
mannat	dra
mannat	gå
mannat	reise
massit	miste
meahkut	breke
meaidit	hogge
meaidit	meie
meaidit	slå
meallut	padle
meannudit	behandle
mearkkašit	notere
mearkut	merke
mearridit	bestemme
menestuvvat	lykkes
merket	merke
meroštit	anslå
miehtat	innrømme
mieskat	morkne
mieđuštit	følge
mieđuštit	ledsage
mihtidit	måle
moaráskit	bli
moaráskit	rasende
moddját	smile
moivet	rote
molsut	bytte
molsut	skifte
moraštit	sørge
morihit	våkne
muitalit	fortelle
muittuhit	påminne
mulgut	skule
muohttit	snø
muollat	belje
muollat	brøle
muosáhit	oppleve
muosáhit	smake
murdit	rygge
máhccat	snu
máhccut	brette
máhttit	kunne
máidnut	prise
máidnut	rose
máinnastit	fortelle
máinnašit	omtale
máinnašit	rose
márrat	bruse
márrat	dure
mátkkoštit	ferdes
mátkkoštit	reise
mávssahit	gjengjelde
mávssahit	hevne
nagadit	greie
nagadit	klare
nahkehit	putte
nahkehit	stikke
namahit	nevne
nannet	bekrefte
nannet	styrke
navdit	kalle
navdit	mene
navdit	tro
navvit	pirke
navvit	plukke
neavvut	formane
neavvut	rådd
niegadit	drømme
nihttit	true
niktit	lokke
nimmorit	beklage
nirvut	grine
nissut	snufse
nissut	snyte
nivkut	nikke
njaldit	flekke
njaldit	flå
njaláhastit	gli
njamahit	die
njammat	patte
njammat	suge
njammat	sutte
njaskut	gnage
njaskut	rive
njađđit	tråkle
njeaidit	velte
njeazzát	geipe
njeađgat	fyke
njiedjat	dale
njiellat	sluke
njiellat	svelge
njihkut	kvine
njihkut	pipe
njoallut	slikke
njoarrat	skjenke
njoarrat	tappe
njuikkodit	hoppe
njuikut	hoppe
njuoskadit	bløyte
njuoskadit	væte
njuovadit	slakte
njuovvat	flå
njuovvat	slakte
njurgut	fløyte
njurgut	plystre
njuvdit	kline
njuvdit	smøre
njáhkat	smyge
njálbmut	skryte
njámmat	feie
njámmat	sope
njáskat	kviste
njávgut	mjaue
njávkat	stryke
nohkat	ende
nohkkat	sove
nohkkat	sovne
nordat	puffe
nordat	støte
notkat	stoppe
notkat	tette
nuvkkihit	nikke
nágget	krangle
nágget	påstå
nárrohaddat	krangle
návddašit	nyte
návddašit	smake
oaffaruššat	ofre
oaggut	fiske
oahpahit	lære
oahpahit	undervise
oahppat	lære
oaidnit	se
oaivvildit	mene
oalgguhit	friste
oalgguhit	oppmuntre
oastit	kjøpe
oažžut	få
ohcalit	savne
ohcat	leite
oidnot	synes
olahit	nå
olahit	rekke
olgguštit	diskriminere
olgguštit	tilsidesette
ollašuhttit	fullføre
ollit	nå
ollit	rekke
orustit	stanse
orustit	stoppe
oskkildit	tiltro
oskut	tro
ostet	barke
ostet	garve
prentet	prente
rahpat	åpne
rahtasit	rakne
rahtat	flerre
rahčat	streve
rassat	streve
ravgut	rykke
ravgut	slite
reavgit	rape
reaškit	skratte
reŋgot	tjenestegjøre
ribadit	
ribadit	strides
rievdat	drive
rievdat	reke
riidalit	krangle
riidit	forhindre
riidit	nekte
rivvet	røve
riššat	frese
riššat	sprute
roahkastit	huke
roahkastit	krøke
roaibut	geipe
roaibut	grine
roaiskut	piske
roaškut	slå
roaškut	smelle
rohkkáhit	angripe
rohkut	brøle
rohttet	rykke
rundit	slepe
rundit	slite
ruodjat	skråle
ruohkkat	klore
ruohkkat	klø
ruohčat	knake
ruostut	ruste
ruoškit	knake
russut	fnyse
russut	frese
ruvjet	partere
ruvssodit	rødme
ruvvet	gni
ruvvet	massere
rábmot	rose
rábmot	skryte
ráhkadit	lage
ráhkistit	elske
ráhkut	harke
ráhput	rake
ráhput	skrape
ráhtat	skramle
ráhtat	slamre
ráivut	famle
ráivut	kave
rámidit	prise
rámidit	rose
rámškut	flakse
rámškut	vifte
rátkit	skille
rávkat	vekke
rávvet	formane
ráđđet	herske
ráđđet	råde
ráđđádallat	drøfte
ráŋggáštit	straffe
ábuhit	gagne
ábuhit	nytte
áddet	forstå
ádjit	drive
ádjit	jage
áibbašit	lengte
áicat	oppdage
áigut	skulle
áigut	ville
áitit	true
ájahaddat	somle
álddagastit	lyne
álggahit	starte
álgit	begynne
ánssášit	fortjene
ánuhit	bønnfalle
ánuhit	tigge
árbet	arve
árvalit	ymte
árvidit	gjette
árvidit	skjønne
árvvoštallat	vurdere
ásahit	innrette
ásahit	ordne
ássat	bo
átnut	be
átnut	tigge
ávžžuhit	oppfordre
čaibmat	flire
čaibmat	le
čatnat	binde
čatnat	knyte
čavdet	lappe
čađahit	gjennomføre
čeargut	brøle
čeargut	tordne
čeassat	gli
čeassat	skli
čiehkat	gjømme
čiekčat	sparke
čiekčat	spenne
čielgat	klarne
čielggadit	forklare
čierrut	gråte
čilget	forklare
čiŋkut	halte
čiŋkut	hinke
čoagganit	samles
čoaggit	plukke
čoahkkanit	samles
čoalkit	banke
čoalkit	knakke
čoallut	
čoallut	sløye
čoavdit	løse
čohkat	spisse
čohkket	samle
čohkkát	sitte
čohkut	gre
čohkut	kjemme
čolgat	spytte
čollet	sløye
čorget	stelle
čujuhit	peke
čuodjat	klinge
čuodjat	lyde
čuoggut	stikke
čuohppat	skjære
čuojahit	ringe
čuolbmadit	knytte
čuoldit	skille
čuoldit	sortere
čuollat	hogge
čuorvut	rope
čuoskut	galoppere
čuovgat	lyse
čuovgat	skinne
čuovvut	følge
čuoččastit	stoppe
čuoččuhit	påstå
čuožžut	stå
čuskkodit	sprette
čuvggodit	lysne
čákŋat	krype
čállit	rispe
čállit	skrive
čárvut	klemme
čárvut	klype
čáskadit	slukke
čáskat	slukne
akrediteret	akreditere
aspireret	aspirere
astringeret	astringere
abandoneret	abandonere
abbonneret	abbonnere
abbrevieret	abbreviere
abdiseret	abdisere
abonneret	abonnere
aborteret	abortere
absenteret	absentere
absolveret	absolvere
absorberet	absorbere
abstraheret	abstrahere
acklimatiseret	acklimatisere
accelereret	accelerere
accentueret	accentuere
accepteret	acceptere
accompagneret	accompagnere
ackorderet	ackordere
ackumuleret	ackumulere
ackvireret	ackvirere
adstringeret	adstringere
adapteret	adaptere
adderet	addere
adhereret	adherere
adjektiveret	adjektivere
adsorberet	adsorbere
adviseret	advisere
affekteret	affektere
affikseret	affiksere
affiseret	affisere
affixeret	affixere
afrikaniseret	afrikanisere
ageret	agere
agglutineret	agglutinere
agiteret	agitere
akklimatiseret	akklimatisere
akkederet	akkedere
akkommoderet	akkommodere
akkompagneret	akkompagnere
akkorderet	akkordere
akkrediteret	akkreditere
akkumuleret	akkumulere
akkvireret	akkvirere
akselereret	akselerere
aksentueret	aksentuere
aksepteret	akseptere
aktioneret	aktionere
aktiviseret	aktivisere
aktualiseret	aktualisere
akšoneret	akšonere
akšuneret	akšunere
alfabetiseret	alfabetisere
alieneret	alienere
alkoholiseret	alkoholisere
allieret	alliere
allittereret	allitterere
allokeret	allokere
alluderet	alludere
altereret	alterere
alterneret	alternere
alumineret	aluminere
amalgameret	amalgamere
ambuleret	ambulere
amerikaniseret	amerikanisere
amortiseret	amortisere
amputeret	amputere
anesteseret	anestesere
anglifieret	anglifiere
anglifiseret	anglifisere
angliseret	anglisere
animaliseret	animalisere
animeret	animere
annekteret	annektere
annonseret	annonsere
annulleret	annullere
anodiseret	anodisere
anonymiseret	anonymisere
anteciperet	antecipere
antedateret	antedatere
antesiperet	antesipere
antikiseret	antikisere
appliceret	applicere
applikeret	applikere
appliseret	applisere
appreteret	appretere
approberet	approbere
approprieret	appropriere
apostroferet	apostrofere
apokoperet	apokopere
applauderet	applaudere
applåderet	applådere
apporteret	apportere
apteret	aptere
arkaiseret	arkaisere
arkebuseret	arkebusere
arkiveret	arkivere
armeret	armere
aromatiseret	aromatisere
arrangeret	arrangere
arreteret	arretere
arriveret	arrivere
arronderet	arrondere
artikuleret	artikulere
asfalteret	asfaltere
assimileret	assimilere
assisteret	assistere
associeret	associere
assorteret	assortere
assosieret	assosiere
assureret	assurere
attraheret	attrahere
atomiseret	atomisere
atrofieret	atrofiere
attacheret	attachere
attackeret	attackere
attakkeret	attakkere
attesteret	attestere
auktioneret	auktionere
aukšoneret	aukšonere
autoklaveret	autoklavere
avaleret	avalere
avanseret	avansere
averteret	avertere
bagatelliseret	bagatellisere
balkaniseret	balkanisere
balloteret	ballotere
ballotteret	ballottere
balsameret	balsamere
banaliseret	banalisere
bandageret	bandagere
bandasjeret	bandasjere
bandašeret	bandašere
barberet	barbere
barduneret	bardunere
barrikaderet	barrikadere
baseret	basere
basuneret	basunere
biljetteret	biljettere
billetteret	billettere
bivackeret	bivackere
bivuakkeret	bivuakkere
blameret	blamere
blasoneret	blasonere
blockeret	blockere
blokkeret	blokkere
bogseret	bogsere
bokstaveret	bokstavere
bombarderet	bombardere
boniteret	bonitere
botaniseret	botanisere
braveret	bravere
breseret	bresere
briketteret	brikettere
briljeret	briljere
broderet	brodere
bronseret	bronsere
broscheret	broschere
brosjeret	brosjere
brošeret	brošere
brutaliseret	brutalisere
budjeteret	budjetere
budšetteret	budšettere
bukseret	buksere
byråkratiseret	byråkratisere
celebreret	celebrere
cementeret	cementere
censureret	censurere
centraliseret	centralisere
centreret	centrere
centrifugeret	centrifugere
certifieret	certifiere
changeret	changere
charmantiseret	charmantisere
charmeret	charmere
chevroteret	chevrotere
chiffreret	chiffrere
cirkuleret	cirkulere
ciseleret	ciselere
citeret	citere
civiliseret	civilisere
cyanidiseret	cyanidisere
damasceret	damascere
danderet	dandere
dechiffreret	dechiffrere
deflateret	deflatere
defloreret	deflorere
degraderet	degradere
deklareret	deklarere
deklasseret	deklassere
deklineret	deklinere
deoxideret	deoxidere
deoksideret	deoksidere
depraveret	depravere
deprimeret	deprimere
deprivatiseret	deprivatisere
destrueret	destruere
debatteret	debattere
debiteret	debitere
debuteret	debutere
decentraliseret	decentralisere
decimeret	decimere
dediceret	dedicere
dediseret	dedisere
deduceret	deducere
deduseret	dedusere
defileret	defilere
deformeret	deformere
degenereret	degenerere
dehydreret	dehydrere
dekanteret	dekantere
dekateret	dekatere
dekomponeret	dekomponere
dekoreret	dekorere
dekorteret	dekortere
dekreteret	dekretere
dekuperet	dekupere
delabialiseret	delabialisere
deleret	delere
delikateret	delikatere
delireret	delirere
demaskeret	demaskere
dementeret	dementere
demilitariseret	demilitarisere
demisjoneret	demisjonere
demissioneret	demissionere
demišoneret	demišonere
demokratiseret	demokratisere
demobiliseret	demobilisere
demoleret	demolere
demonteret	demontere
demoraliseret	demoralisere
denationaliseret	denationalisere
denasjonaliseret	denasjonalisere
denaturaliseret	denaturalisere
denatureret	denaturere
denašonaliseret	denašonalisere
denoteret	denotere
denuderet	denudere
deponeret	deponere
deporteret	deportere
derangeret	derangere
derelinkveret	derelinkvere
deriveret	derivere
desarmeret	desarmere
desillutioneret	desillutionere
desillusjonerit	desillusjonere
desillušoneret	desillušonere
desinficeret	desinfisece
desinfiseret	desinfisere
desinformeret	desinformere
desintegreret	desintegrere
desoksideret	desoksidere
desorganiseret	desorganisere
desorienteret	desorientere
desoxideret	desoxidere
desavueret	desavuere
desentraliseret	desentralisere
deserteret	desertere
desideret	desidere
desimeret	desimere
detacheret	detachere
detasjeret	detasjere
detašeret	detašere
determineret	determinere
detoneret	detonere
detroniseret	detronisere
devalueret	devaluere
devieret	deviere
dialyseret	dialysere
differansieret	differansiere
differensieret	differensiere
differentieret	differentiere
differeret	differere
diffunderet	diffundere
diftongeret	diftongere
digitaliseret	digitalisere
diltet	dilte
dimentioneret	dimentionere
dimensjoneret	dimensjonere
dimenšoneret	dimenšonere
dimitteret	dimittere
dineret	dinere
diskrediteret	diskreditere
diskvalificeret	diskvalificere
diskvalifiseret	diskvalifisere
distraheret	distrahere
disenteret	disentere
disiplineret	disiplinere
diskonteret	diskontere
diskrimineret	diskriminere
diskuteret	diskutere
dispascheret	dispaschere
dispasjeret	dispasjere
dispašeret	dispašere
dispenseret	dispensere
disponeret	disponere
disputeret	disputere
dissekeret	dissekere
dissenteret	dissentere
dissimileret	dissimilere
dissocieret	dissociere
dissoneret	dissonere
dissosieret	dissosiere
distanseret	distansere
distingveret	distingvere
distribueret	distribuere
divergeret	divergere
diverteret	divertere
divideret	dividere
doktoreret	doktorere
dokumenteret	dokumentere
domineret	dominere
domisilieret	domisiliere
doneret	donere
doseret	dosere
dosseret	dossere
doteret	dotere
dramatiseret	dramatisere
draperet	drapere
drašeret	drašere
dreneret	drenere
dresseret	dressere
dräneret	dränere
duelleret	duellere
dupliceret	duplicere
dupliseret	duplisere
dubbleret	dubblere
dubleret	dublere
duperet	dupere
effektiviseret	effektivisere
effektueret	effektuere
egaliseret	egalisere
ejakuleret	ejakulere
ekonomiseret	ekonomisere
eksklameret	eksklamere
ekskluderet	ekskludere
eksplisitteret	eksplisittere
eksploateret	eksploatere
eksploderet	eksplodere
eksproprieret	ekspropriere
ekstraheret	ekstrahere
eksamineret	eksaminere
eksegeret	eksegere
eksekveret	eksekvere
ekselleret	eksellere
eksemplifiseret	eksemplifisere
ekseret	eksere
ekserperet	ekserpere
ekserseret	eksersere
ekshaleret	ekshalere
eksisteret	eksistere
ekskommuniseret	ekskommunisere
ekspanderet	ekspandere
ekspatrieret	ekspatriere
ekspederet	ekspedere
ekspediteret	ekspeditere
eksperimenteret	eksperimentere
ekspireret	ekspirere
eksponeret	eksponere
eksporteret	eksportere
ekstemporeret	ekstemporere
ekstenderet	ekstendere
ekstensiveret	ekstensivere
ekstrapoleret	ekstrapolere
eksámineret	eksáminere
ekviperet	ekvipere
ekvivaleret	ekvivalere
elektrifieret	elektrifiere
elektrifiseret	elektrifisere
elektriseret	elektrisere
eleveret	elevere
eligeret	eligere
elokseret	eloksere
eloxeret	eloxere
eluderet	eludere
emaljeret	emaljere
emanciperet	emancipere
emansiperet	emansipere
emballeret	emballere
embarkeret	embarkere
emigreret	emigrere
emitteret	emittere
employeret	employere
emulgeret	emulgere
endosseret	endossere
enerveret	enervere
engašeret	engašere
enkultureret	enkulturere
ensileret	ensilere
envegsreguleret	envegsregulere
enveisreguleret	enveisregulere
erigeret	erigere
eroderet	erodere
erotiseret	erotisere
eskaleret	eskalere
eskamoteret	eskamotere
eskaperet	eskapere
eskorteret	eskortere
estetiseret	estetisere
estimeret	estimere
etableret	etablere
etiketteret	etikettere
etterisoleret	etterisolere
ettersynkroniseret	ettersynkronisere
europeiseret	europeisere
evangeliseret	evangelisere
evaporeret	evaporere
exklameret	exklamere
exkluderet	exkludere
expliciteret	explicitere
exploateret	exploatere
exploderet	explodere
exproprieret	expropriere
extraheret	extrahere
examineret	examinere
exegeret	exegere
exekveret	exekvere
exelleret	exellere
exemplifieret	exemplifiere
exerceret	exercere
exeret	exere
exerperet	exerpere
exhaleret	exhalere
existeret	existere
exkommuniceret	exkommunicere
expanderet	expandere
expatrieret	expatriere
expederet	expedere
expediteret	expeditere
experimenteret	experimentere
expireret	expirere
exponeret	exponere
exporteret	exportere
extemporeret	extemporere
extenderet	extendere
extensiveret	extensivere
extrapoleret	extrapolere
fascineret	fascinere
fabrikeret	fabrikere
fabrikkeret	fabrikkere
fabuleret	fabulere
faksimileret	faksimilere
faktoriseret	faktorisere
faktureret	fakturere
falleret	fallere
falsifieret	falsifiere
falsifiseret	falsifisere
fantaseret	fantasere
fantiseret	fantisere
farseret	farsere
fasetteret	fasettere
fasongeret	fasongere
feilvurderet	feilvurdere
fembieret	fembiere
feminiseret	feminisere
ferieret	feriere
fermenteret	fermentere
fernisseret	fernissere
fernissit	fernisse
feteret	fetere
figureret	figurere
fikseret	fiksere
fileret	filere
fileteret	filetere
filmatiseret	filmatisere
filtreret	filtrere
fineret	finere
fingeret	fingere
fisioneret	fisionere
fisjoneret	fisjonere
fišoneret	fišonere
flamberet	flambere
flaneret	flanere
flankeret	flankere
flatteret	flattere
flekteret	flektere
flirtet	flirte
floragraferet	floragrafere
floreret	florere
fluktueret	fluktuere
fluoresceret	fluorescere
fluorideret	fluoridere
fluoriseret	fluorisere
fokuseret	fokusere
folieret	foliere
formeret	formere
formuleret	formulere
formáliseret	formálisere
forseret	forsere
fosforesceret	fosforescere
fotokopieret	fotokopiere
fotograferet	fotografere
fragmenteret	fragmentere
fraksjoneret	fraksjonere
fraktioneret	fraktionere
frakšoneret	frakšonere
frankeret	frankere
frapperet	frappere
fraseret	frasere
fraterniseret	fraternisere
frekventeret	frekventere
friseret	frisere
friteret	fritere
fronderet	frondere
frotteret	frottere
frustreret	frustrere
fráŋket	fráŋke
fundamenteret	fundamentere
funderet	fundere
fungeret	fungere
funksjoneret	funksjonere
funktioneret	funktionere
funkšoneret	funkšonere
furageret	furagere
furasjeret	furasjere
furašeret	furašere
furneret	furnere
fusioneret	fusionere
fusjoneret	fusjonere
fušoneret	fušonere
gageret	gagere
galopperet	galoppere
garanteret	garantere
garderet	gardere
garneret	garnere
garnisoneret	garnisonere
gasjeret	gasjere
gašeret	gašere
gemineret	geminere
genereret	generere
generet	genere
gereret	gerere
germaniseret	germanisere
gestikuleret	gestikulere
giljotineret	giljotinere
gireret	girere
glamoriseret	glamorisere
glaseret	glasere
glasseret	glassere
glorifieret	glorifiere
glorifiseret	glorifisere
graderet	gradere
gradueret	graduere
granuleret	granulere
grasseret	grassere
gratiidnet	gratiidne
gratineret	gratinere
gratuleret	gratulere
graviteret	gravitere
griljeret	griljere
grunderet	grundere
grupperet	gruppere
gummieret	gummiere
guteret	gutere
gymnastiseret	gymnastisere
habiliteret	habilitere
hallusineret	hallusinere
harmoniseret	harmonisere
harpeseret	harpesere
harpuneret	harpunere
harseleret	harselere
havareret	havarere
hektograferet	hektografere
hermetiseret	hermetisere
heroiseret	heroisere
herpeseret	herpesere
homogeniseret	homogenisere
honoreret	honorere
hospitaliseret	hospitalisere
hoveret	hovere
humaniseret	humanisere
ioniseret	ionisere
idealiseret	idealisere
ideologiseret	ideologisere
identifieret	identifiere
identifiseret	identifisere
idylliseret	idyllisere
ignoreret	ignorere
illuderet	illudere
illumineret	illuminere
implanteret	implantere
implementeret	implementere
impliceret	implicere
impliseret	implisere
imploderet	implodere
improviseret	improvisere
imagineret	imaginere
immatrikuleret	immatrikulere
immigreret	immigrere
immortaliseret	immortalisere
immuniseret	immunisere
imponeret	imponere
importeret	importere
inaktiveret	inaktivere
inaugureret	inaugurere
inflammeret	inflammere
inflateret	inflatere
influeret	influere
injiceret	injicere
injiseret	injisere
injurieret	injuriere
inklineret	inklinere
inkluderet	inkludere
inspekteret	inspektere
inspireret	inspirere
inspiseret	inspisere
institueret	instituere
institusjonaliseret	institusjonalisere
institutionaliseret	institutionalisere
institušonaliseret	institušonalisere
instrueret	instruere
inciteret	incitere
indekseret	indeksere
indikeret	indikere
individualiseret	individualisere
indoktrineret	indoktrinere
induceret	inducere
induseret	indusere
infameret	infamere
infantiliseret	infantilisere
inficeret	inficere
infiseret	infisere
inhaleret	inhalere
inhereret	inherere
inhiberet	inhibere
initieret	initiere
inkarneret	inkarnere
inkorporeret	inkorporere
inokuleret	inokulere
insemineret	inseminere
insinueret	insinuere
insisteret	insistere
instrumenteret	instrumentere
intellektualiseret	intellektualisere
intenderet	intendere
intensifieret	intensifiere
intensiveret	intensivere
interpreteret	interpretere
interesseret	interessere
interfereret	interferere
interfolieret	interfoliere
internasjonaliseret	internasjonalisere
internationaliseret	internationalisere
internašonaliseret	internašonalisere
internašunaliseret	internašunalisere
interneret	internere
interpelleret	interpellere
interpoleret	interpolere
interveneret	intervenere
intimideret	intimidere
intoneret	intonere
intresseret	intressere
introduceret	introducere
introduseret	introdusere
invaderet	invadere
invalidiseret	invalidisere
inverteret	invertere
inviteret	invitere
involveret	involvere
iriseret	irisere
ironiseret	ironisere
irrigeret	irrigere
irriteret	irritere
islamiseret	islamisere
itereret	iterere
jassifiseret	jassifisere
jazzifieret	jazzifiere
jazzifiseret	jazzifisere
joderet	jodere
jodiseret	jodisere
journaliseret	journalisere
jubileret	jubilere
juryeret	juryere
justeret	justere
kadmieret	kadmiere
kakuminaliseret	kakuminalisere
kalandreret	kalandrere
kalcineret	kalcinere
kalibreret	kalibrere
kalkeret	kalkere
kalkuleret	kalkulere
kalkyleret	kalkylere
kalligraferet	kalligrafere
kalsineret	kalsinere
kamperet	kampere
kamufleret	kamuflere
kandideret	kandidere
kandiseret	kandisere
kanneleret	kannelere
kanoniseret	kanonisere
kanselleret	kansellere
kapitaliseret	kapitalisere
kapituleret	kapitulere
kapuneret	kapunere
karakteriseret	karakterisere
karaktäriseret	karaktärisere
karikeret	karikere
karteret	kartere
kartoneret	kartonere
kasseret	kassere
kastreret	kastrere
katalogiseret	katalogisere
katalyseret	katalysere
kategoriseret	kategorisere
katekiseret	katekisere
katoliseret	katolisere
kausjoneret	kausjonere
kautioneret	kautionere
kaušoneret	kaušonere
kaveret	kavere
klareret	klarere
klassificeret	klassificere
klassifiseret	klassifisere
klausuleret	klausulere
klicheret	klichere
klimatiseret	klimatisere
klisjeret	klisjere
klišeret	klišere
kloreret	klorere
kloroformeret	kloroformere
koaguleret	koagulere
kockeleret	kockelere
kodifieret	kodifiere
kodifiseret	kodifisere
koketteret	kokettere
kokkeleret	kokkelere
kokkereret	kokkerere
kollaboreret	kollaborere
kollasjoneret	kollasjonere
kollationeret	kollationere
kollašoneret	kollašonere
kollektiviseret	kollektivisere
kollideret	kollidere
kollokveret	kollokvere
koloreret	kolorere
kolporteret	kolportere
komprimeret	komprimere
kompromitteret	kompromittere
kombineret	kombinere
kommanderet	kommandere
kommenderet	kommendere
kommersialiseret	kommersialisere
kommunaliseret	kommunalisere
kommuniceret	kommunicere
kommuniseret	kommunisere
kommuteret	kommutere
kompareret	komparere
kompenseret	kompensere
kompileret	kompilere
kompletteret	komplettere
kompliceret	komplicere
komplimenteret	komplimentere
kompliseret	komplisere
komposteret	kompostere
konfronteret	konfrontere
kongrueret	kongruere
konskriberet	konskribere
konspireret	konspirere
konstitueret	konstituere
konstrueret	konstruere
kontraheret	kontrahere
koncentreret	koncentrere
koncipieret	koncipiere
kondemneret	kondemnere
kondenseret	kondensere
kondisjoneret	kondisjonere
konditioneret	konditionere
kondišoneret	kondišonere
kondoleret	kondolere
konfereret	konferere
konfiskeret	konfiskere
konjugeret	konjugere
konkurreret	konkurrere
konnoteret	konnotere
konsentreret	konsentrere
konserteret	konsertere
konsigneret	konsignere
konsiperet	konsipere
konsolideret	konsolidere
konstateret	konstatere
konsumeret	konsumere
konteret	kontere
kontet	konte
kontingenteret	kontingentere
kontinueret	kontinuere
kontoriseret	kontorisere
kontrasigneret	kontrasignere
kontrasteret	kontrastere
kontribueret	kontribuere
konvergeret	konvergere
konverseret	konversere
konverteret	konvertere
konvoieret	konvoiere
konvojeret	konvojere
konvoluteret	konvolutere
konvolutteret	konvoluttere
koopereret	kooperere
kopuleret	kopulere
koreograferet	koreografere
korporativiseret	korporativisere
korresponderet	korrespondere
korrigeret	korrigere
korroderet	korrodere
korrugeret	korrugere
korrumperet	korrumpere
kostymeret	kostymere
krackeleret	krackelere
krakeleret	krakelere
krediteret	kreditere
kreeret	kreere
kremeret	kremere
kreneleret	krenelere
kreperet	krepere
kriminaliseret	kriminalisere
kristalliseret	kristallisere
krockeret	krockere
krokeret	krokere
krokkeret	krokkere
kronikkeret	kronikkere
krypteret	kryptere
kryptifieret	kryptifiere
kryptifiseret	kryptifisere
krystalliseret	krystallisere
krönikeret	krönikere
kuberet	kubere
kujoneret	kujonere
kulmineret	kulminere
kultiveret	kultivere
kumuleret	kumulere
kuperet	kupere
kureret	kurere
kurseret	kursere
kursiveret	kursivere
kurtiseret	kurtisere
kvadreret	kvadrere
kvalificeret	kvalificere
kvalifiseret	kvalifisere
kvantifieret	kvantifiere
kvantifiseret	kvantifisere
kvantiteret	kvantitere
kveruleret	kverulere
kvitteret	kvittere
kvoteret	kvotere
kåseret	kåsere
labialiseret	labialisere
lackeret	lackere
lakkeret	lakkere
lakseret	laksere
lamineret	laminere
lanseret	lansere
laseret	lasere
latiniseret	latinisere
legaliseret	legalisere
legeret	legere
lemmatiseret	lemmatisere
levereret	leverere
leveret	levere
liberaliseret	liberalisere
licensieret	licensiere
lignifiseret	lignifisere
likvideret	likvidere
lisensieret	lisensiere
lisiteret	lisitere
litograferet	litografere
logeret	logere
lombarderet	lombardere
longeret	longere
lorgnetteret	lorgnettere
losjeret	losjere
lošeret	lošere
lukreret	lukrere
lukseret	luksere
lydisoleret	lydisolere
maskineret	maskinere
magasineret	magasinere
magnetiseret	magnetisere
makadamiseret	makadamisere
maksimaliseret	maksimalisere
maksimeret	maksimere
makuleret	makulere
maltrakteret	maltraktere
manifesteret	manifestere
manikyreret	manikyrere
manipuleret	manipulere
mankeret	mankere
manuduseret	manudusere
marginaliseret	marginalisere
marineret	marinere
markeret	markere
marmoreret	marmorere
maršeret	maršere
maskuliniseret	maskulinisere
massakreret	massakrere
masseproduseret	masseprodusere
masseret	massere
masturberet	masturbere
materialiseret	materialisere
matteret	mattere
maximaliseret	maximalisere
maximeret	maximere
maŋŋekalkuleret	maŋŋekalkulere
mašineret	mašinere
medicineret	medicinere
medisineret	medisinere
meleret	melere
memoreret	memorere
menstrueret	menstruere
meriteret	meritere
meritteret	merittere
metalliseret	metallisere
migreret	migrere
mikroskoperet	mikroskopere
militariseret	militarisere
militäriseret	militärisere
mineret	minere
miniatyriseret	miniatyrisere
minimaliseret	minimalisere
minimeret	minimere
misjoneret	misjonere
missioneret	missionere
mišoneret	mišonere
mišuneret	mišunere
mobiliseret	mobilisere
modelleret	modellere
modereret	moderere
modifieret	modifiere
modifiseret	modifisere
moduleret	modulere
molesteret	molestere
monoftongeret	monoftongere
monopoliseret	monopolisere
monteret	montere
moraliseret	moralisere
mortifieret	mortifiere
mortifiseret	mortifisere
mosjoneret	mosjonere
motioneret	motionere
motoriseret	motorisere
mousseret	moussere
moveret	movere
mošoneret	mošonere
muljeret	muljere
mulkteret	mulktere
multipliceret	multiplicere
multipliseret	multiplisere
mumifieret	mumifiere
mumifiseret	mumifisere
mumiseret	mumisere
musiceret	musicere
musiseret	musisere
musseret	mussere
muteret	mutere
mystifieret	mystifiere
mystifiseret	mystifisere
möbleret	möblere
møbleret	møblere
narkotiseret	narkotisere
nasaleret	nasalere
naturaliseret	naturalisere
navigeret	navigere
nazifieret	nazifiere
nazifiseret	nazifisere
našonaliseret	našonalisere
negeret	negere
negligeret	negligere
neglisjeret	neglisjere
neglišeret	neglišere
nettobudjeteret	nettobudjeterit
nettobudsjetteret	nettobudsjetterit
nettobudšetteret	nettobudšettere
nettobusjetteret	nettobusjetterit
nettobušeteret	nettobušetere
nettobušetteret	nettobušettere
nitreret	nitrere
nitrifiseret	nitrifisere
nivelleret	nivellere
nomadiseret	nomadisere
nomineret	nominere
nonchaleret	nonchalere
normaliseret	normalisere
noteret	notere
notifiseret	notifisere
nummereret	nummerere
nyanseret	nyansere
nøytraliseret	nøytralisere
obduceret	obducere
obduseret	obdusere
objektiveret	objektivere
observeret	observere
obstrueret	obstruere
ockulteret	ockultere
ockuperet	ockupere
offereret	offerere
okkulteret	okkultere
okkuperet	okkupere
oksideret	oksidere
oksyderet	oksydere
okuleret	okulere
onaneret	onanere
onduleret	ondulere
opalesceret	opalescere
opaliseret	opalisere
operasjonaliseret	operasjonalisere
operationaliseret	operationalisere
operašonaliseret	operašonalisere
opteret	optere
optimaliseret	optimalisere
optimeret	optimere
orienteret	orientere
ordineret	ordinere
orkestreret	orkestrere
ornamenteret	ornamentere
oscilleret	oscillere
oxideret	oxidere
patroniseret	patronisere
pacificeret	pacificere
pagineret	paginere
palataliseret	palatalisere
palleteret	palletere
palperet	palpere
panegyreret	panegyrere
paneret	panere
panoreret	panorere
parafraseret	parafrasere
paragraferet	paragrafere
paraderet	paradere
paraferet	parafere
parafineret	parafinere
parallelliseret	parallellisere
paralyseret	paralysere
parasitteret	parasittere
parcelleret	parcellere
pareret	parere
parfymeret	parfymere
parkeret	parkere
parlamenteret	parlamentere
parleret	parlere
parodieret	parodiere
parselleret	parsellere
parteret	partere
participeret	participere
partisiperet	partisipere
pasifiseret	pasifisere
passeret	passere
passiveret	passivere
passiviseret	passivisere
pasteuriseret	pasteurisere
pastöriseret	pastörisere
patenteret	patentere
patineret	patinere
patruljeret	patruljere
pauseret	pausere
pelleteret	pelletere
pensioneret	pensionere
pensjoneret	pensjonere
penetreret	penetrere
penšoneret	penšonere
penšuneret	penšunere
perspireret	perspirere
perenneret	perennere
perfeksjoneret	perfeksjonere
perfektioneret	perfektionere
perfekšoneret	perfekšonere
perforeret	perforere
pergamenteret	pergamentere
perkoleret	perkolere
perkuteret	perkutere
permitteret	permittere
permuteret	permutere
persifleret	persiflere
persiperet	persipere
persisteret	persistere
personifieret	personifiere
personifiseret	personifisere
perturberet	perturbere
perverteret	pervertere
pigmenteret	pigmentere
piruetteret	piruettere
planeret	planere
plasseret	plassere
platineret	platinere
plederet	pledere
pletteret	plettere
plisseret	plissere
plomberet	plombere
pläderet	plädere
pocheret	pochere
poengteret	poengtere
poetiseret	poetisere
poängteret	poängtere
pokuleret	pokulere
polariseret	polarisere
polemiseret	polemisere
poleret	polere
politiseret	politisere
pollineret	pollinere
polymeriseret	polymerisere
pomadiseret	pomadisere
ponceret	poncere
poneret	ponere
populariseret	popularisere
populäriseret	populärisere
porsjoneret	porsjonere
portioneret	portionere
portretteret	portrettere
porträtteret	porträttere
poršoneret	poršonere
poseret	posere
posisjoneret	posisjonere
positioneret	positionere
posišoneret	posišonere
postdateret	postdatere
posteret	postere
postuleret	postulere
potenseret	potensere
pošeret	pošere
praktiseret	praktisere
preskriberet	preskribere
preciseret	precisere
predestineret	predestinere
predetermineret	predeterminere
predikeret	predikere
predisponeret	predisponere
prefabrikkeret	prefabrikkere
prefereret	preferere
prekaveret	prekavere
preluderet	preludere
premieret	premiere
prenumereret	prenumerere
prepareret	preparere
presenteret	presentere
preserveret	preservere
presideret	presidere
presiseret	presisere
presteret	prestere
presumeret	presumere
presupponeret	presupponere
pretenderet	pretendere
privatiseret	privatisere
privilegeret	privilegere
priviligeret	priviligere
prognoseret	prognosere
prognostiseret	prognostisere
proklameret	proklamere
proskriberet	proskribere
prospekteret	prospektere
prostitueret	prostituere
proberet	probere
problematiseret	problematisere
procederet	procedere
processeret	processere
produceret	producere
produseret	produsere
profaneret	profanere
profesjonaliseret	profesjonalisere
professionaliseret	professionalisere
profeteret	profetere
profešonaliseret	profešonalisere
profiteret	profitere
profitteret	profittere
projekteret	projektere
proletariseret	proletarisere
prolongeret	prolongere
promeneret	promenere
promoveret	promovere
promulgeret	promulgere
proneret	pronere
pronominaliseret	pronominalisere
propaganderet	propagandere
propageret	propagere
proponeret	proponere
proporsjoneret	proporsjonere
proportioneret	proportionere
proporšoneret	proporšonere
prosederet	prosedere
prosesseret	prosessere
prosjekteret	prosjektere
protegeret	protegere
protesjeret	protesjere
protešeret	protešere
protokolleret	protokollere
provianteret	proviantere
provideret	providere
provoseret	provosere
prošekteret	prošektere
psykoanalyseret	psykoanalysere
publiceret	publicere
publiseret	publisere
pulseret	pulsere
punkteret	punktere
rabatteret	rabattere
raderet	radere
radieret	radiere
radikaliseret	radikalisere
raljeret	raljere
ramponeret	ramponere
rangeret	rangere
raporteret	raportere
rappelleret	rappellere
rapporteret	rapportere
raseret	rasere
rasjonaliseret	rasjonalisere
rasjoneret	rasjonere
ratificeret	ratificere
ratifiseret	ratifisere
rationeret	rationere
rašonaliseret	rašonalisere
rašoneret	rašonere
reageret	reagere
reaktiveret	reaktivere
reassureret	reassurere
reflekseviseret	refleksevisere
reflekteret	reflektere
reflexeviseret	reflexevisere
regjeret	regjere
reinvesteret	reinvestere
rekreeret	rekreere
reorganiseret	reorganisere
repliceret	replicere
repliseret	replisere
representeret	representere
reproduceret	reproducere
reproduseret	reprodusere
respekteret	respektere
respireret	respirere
restitueret	restituere
rebelleret	rebellere
recenseret	recensere
recirkuleret	recirkulere
reciteret	recitere
redigeret	redigere
redupliseret	reduplisere
reduceret	reducere
reduseret	redusere
refereret	referere
refunderet	refundere
refuseret	refusere
regaleret	regalere
regenereret	regenerere
regisseret	regissere
reglementeret	reglementere
regulariseret	regularisere
regummeret	regummere
regummieret	regummiere
rehabiliteret	rehabilitere
rejiseret	rejisere
rekapituleret	rekapitulere
rekognoseret	rekognosere
rekommanderet	rekommandere
rekonstrueret	rekonstruere
rekruteret	rekrutere
rekrutteret	rekruttere
rekryteret	rekrytere
rektifieret	rektifiere
rektifiseret	rektifisere
rekvireret	rekvirere
relateret	relatere
relativiseret	relativisere
relegeret	relegere
relokeret	relokere
remplasseret	remplassere
remburseret	rembursere
reminisceret	reminiscere
reminiseret	reminisere
remiseret	remisere
remiteret	remitere
remitteret	remittere
remonteret	remontere
renonseret	renonsere
renoveret	renovere
repatrieret	repatriere
repeteret	repetere
reserveret	reservere
resideret	residere
residiveret	residivere
resigneret	resignere
resiperet	resipere
resirkuleret	resirkulere
resisteret	resistere
resiteret	resitere
resocialiseret	resocialisere
resolveret	resolvere
resorberet	resorbere
resosialiseret	resosialisere
responderet	respondere
resteret	restere
resulteret	resultere
resumeret	resumere
resymeret	resymere
retarderet	retardere
retineret	retinere
retireret	retirere
returneret	returnere
retuscheret	retuschere
retusjeret	retusjere
retušeret	retušere
revalueret	revaluere
revanscheret	revanschere
revansjeret	revansjere
revanšeret	revanšere
reverseret	reversere
revideret	revidere
revolteret	revoltere
revolusjoneret	revolusjonere
revolutioneret	revolutionere
revolušoneret	revolušonere
rikoschetteret	rikoschettere
rikosjetteret	rikosjettere
rikošetteret	rikošettere
riposteret	ripostere
risikeret	risikere
ristorneret	ristornere
ritualiseret	ritualisere
rivaliseret	rivalisere
robotiseret	robotisere
rocket	rocke
rokeret	rokere
romaniseret	romanisere
romantiseret	romantisere
romsteret	romstere
roteret	rotere
ruineret	ruinere
rubriceret	rubricere
rubriseret	rubrisere
rulleret	rullere
rumsteret	rumstere
russifieret	russifiere
russifiseret	russifisere
rustifiseret	rustifisere
røntgenfotograferet	røntgenfotografere
saboteret	sabotere
saluteret	salutere
salutteret	saluttere
sameksisteret	sameksistere
sanforiseret	sanforisere
satineret	satinere
satiriseret	satirisere
satisfieret	satisfiere
satisfiseret	satisfisere
schamponeret	schamponere
schematiseret	schematisere
segregeret	segregere
sedimenteret	sedimentere
segmenteret	segmentere
seksjoneret	seksjonere
sektioneret	sektionere
sekulariseret	sekularisere
sekunderet	sekundere
sekšoneret	sekšonere
selekteret	selektere
semaforeret	semaforere
sementeret	sementere
semineret	seminere
sensureret	sensurere
sentimentaliseret	sentimentalisere
sentraliseret	sentralisere
sentreret	sentrere
sentrifugeret	sentrifugere
sentrifuget	sentrifuge
separeret	separere
serrateret	serratere
sertifiseret	sertifisere
serveret	servere
sesongdebuteret	sesongdebutere
sexdebuteret	sexdebutere
siffreret	siffrere
sifreret	sifrere
signaleret	signalere
signaliseret	signalisere
signeret	signere
sikkerhetsklareret	sikkerhetsklarere
simplifieret	simplifiere
simplifiseret	simplifisere
simuleret	simulere
sirkuleret	sirkulere
siseleret	siselere
siteret	sitere
siviliseret	sivilisere
sjamponeret	sjamponere
sjarmantiseret	sjarmantisere
skaleret	skalere
skalperet	skalpere
skamferet	skamfere
skandaliseret	skandalisere
skanderet	skandere
skarifiseret	skarifisere
skeletteret	skelettere
skisseret	skissere
skjeletteret	skjelettere
skjematiseret	skjematisere
skoleret	skolere
skraveret	skravere
skreddereret	skredderere
skulpteret	skulptere
skvadroneret	skvadronere
snekkereret	snekkerere
socialiseret	socialisere
solidariseret	solidarisere
solliciteret	sollicitere
sollisiteret	sollisitere
solmiseret	solmisere
sonderet	sondere
sordineret	sordinere
sosialiseret	sosialisere
spanderet	spandere
spankuleret	spankulere
spaseret	spasere
spatseret	spatsere
specialiseret	specialisere
spesialiseret	spesialisere
spesifieret	spesifiere
spesifiseret	spesifisere
spesiáliseret	spesiálisere
spiraliseret	spiralisere
spoleret	spolere
stabiliseret	stabilisere
stafferet	staffere
stagneret	stagnere
stasjoneret	stasjonere
stationeret	stationere
statueret	statuere
stašoneret	stašonere
stencileret	stencilere
stenograferet	stenografere
stenografet	stenografe
stensileret	stensilere
stereotyperet	stereotypere
stigmatiseret	stigmatisere
stiliseret	stilisere
stipuleret	stipulere
stoltseret	stoltsere
stranguleret	strangulere
stratifieret	stratifiere
stratificeret	stratificere
stratifiseret	stratifisere
subordineret	subordinere
subskriberet	subskribere
substitueret	substituere
subtraheret	subtrahere
sublimeret	sublimere
subsidieret	subsidiere
substantiveret	substantivere
subsumeret	subsumere
subveneret	subvenere
succederet	succedere
suffleret	sufflere
suffigeret	suffigere
suffikseret	suffiksere
suggereret	suggerere
suksederet	suksedere
summeret	summere
suppliceret	supplicere
supplikeret	supplikere
supplikkeret	supplikkere
supprimeret	supprimere
superet	supere
supineret	supinere
suppleeret	suppleere
suppleret	supplere
supponeret	supponere
suspenderet	suspendere
suteneret	sutenere
sympatiseret	sympatisere
synkroniseret	synkronisere
synkoperet	synkopere
syntetiseret	syntetisere
tabellariseret	tabellarisere
tabuleret	tabulere
takseret	taksere
takteret	taktere
tangeret	tangere
tapetseret	tapetsere
tatoveret	tatovere
tatueret	tatuere
taxeret	taxere
teknifieret	teknifiere
teknifiseret	teknifisere
tekstureret	teksturere
telefoneret	telefonere
telekseret	teleksere
telemetreret	telemetrere
telexeret	telexere
tematiseret	tematisere
tempereret	temperere
tenderet	tendere
terrasseret	terrassere
terroriseret	terrorisere
testamenteret	testamentere
textureret	texturere
tiltet	tilte
titreret	titrere
tituleret	titulere
tolereret	tolerere
torpederet	torpedere
torteret	tortere
tortureret	torturere
toucheret	touchere
trabeleret	trabelere
traderet	tradere
trafikeret	trafikere
trafikkeret	trafikkere
trakasseret	trakassere
trakteret	traktere
trancheret	tranchere
transcenderet	transcendere
transpireret	transpirere
trancheret	tranchere
transplanteret	transplantere
transskriberet	transskribere
transfereret	transferere
transfigureret	transfigurere
transformeret	transformere
transfunderet	transfundere
transistoriseret	transistorisere
transiteret	transitere
transitiveret	transitivere
transitteret	transittere
transjeret	transjere
translittereret	translitterere
transmitteret	transmittere
transponeret	transponere
transporteret	transportere
tranšeret	tranšere
traseret	trasere
trasseret	trassere
traverseret	traversere
travesteret	travestere
tremuleret	tremulere
treneret	trenere
trianguleret	triangulere
triumferet	triumfere
trivialiseret	trivialisere
träneret	tränere
tuperet	tupere
turneret	turnere
tuscheret	tuschere
tusjeret	tusjere
tušeret	tušere
typifieret	typifiere
typifiseret	typifisere
typiseret	typisere
typologiseret	typologisere
uniformeret	uniformere
universaliseret	universalisere
urbaniseret	urbanisere
urgeret	urgere
urineret	urinere
usurperet	usurpere
vaccineret	vaccinere
vagabonderet	vagabondere
vaksineret	vaksinere
valanderet	valandere
valideret	validere
validiteret	validitere
valuteret	valutere
valveret	valvere
vandaliseret	vandalisere
vatteret	vattere
vegeteret	vegetere
ventileret	ventilere
verbaliseret	verbalisere
verifieret	verifiere
verifiseret	verifisere
vernaliseret	vernalisere
verseret	versere
versifieret	versifiere
versifiseret	versifisere
vibreret	vibrere
vigileret	vigilere
vikarieret	vikariere
vindiceret	vindicere
vindiseret	vindisere
viriliseret	virilisere
viseret	visere
visiteret	visitere
vitaliseret	vitalisere
vitaminiseret	vitaminisere
vivisekeret	vivisekere
vokaliseret	vokalisere
volteret	voltere
voltigeret	voltigere
vomeret	vomere
voteret	votere
vulgariseret	vulgarisere
vulgäriseret	vulgärisere
vulkaniseret	vulkanisere
vurderet	vurdere
xerograferet	xerografere
xylograferet	xylografere
økonomiseret	økonomisere
šamponeret	šamponere
šarmantiseret	šarmantisere
šarmeret	charmere
šarmeret	sjarmere
šatteret	chattere
šatteret	sjattere
šatteret	šattere
šeneret	genere
šeneret	sjenere
šeneret	šenere
šikaneret	chikanere
šikaneret	sjikanere
šikaneret	šikanere
šockeret	chokkere
šokkeret	sjokkere
šokkeret	šokkere
šongleret	sjonglere
šongleret	šonglere
