aisttan	aisttan+Pr
aitto	aitto+Pcle
almma	almma+Pcle
anne	anne+Adv
áhtan	áhtat+V+TV+Der3+Der/n+N+Sg+Nom
álbmái	álbmái+A+Sg+Nom
álga	álga	+?
ándagassii	ándagassii+Adv
á†estus	á†estus	+?
ba	ba+Pcle
bajá	bajá+Adv
bat	bat+Pcle
bále	bále+Po
báljo	báljo+Adv
báris	báris+A+Sg+Nom
bealde	bealde+Po
bealde	bealde+Pr
bearrái	bearrái+Adv
bieđggus	bieđggus+A+Sg+Nom
boibmot	boaibmut+V+TV+Der/PassS+V+Inf
bojá	bojá+N+Sg+Nom
borrot	borrat+V+TV+Der/PassS+V+Inf
botka	botka	+?
božán	božán+N+Sg+Nom
buozan	buozan+N+Sg+Nom
čanan	čanan+N+Sg+Nom
čavččat	čavččat+N+Sg+Nom
čábbát	čáppat+A+Adv
čábbát	čáppis+A+Adv
čázit	čázit+N+Sg+Nom
čiehčča	čiehčča	+?
čieža	čieža+Num+Sg+Nom
čirrot	čierrat+V+IV+Der/PassS+V+Inf
čirrot	čierrut+V+TV+Der/PassS+V+Inf
čirrot	čirrat+V+IV+Der/PassS+V+Inf
čirrot	čirrot+V+IV+Inf
dađe	dađe+Adv
dađe	dađe+CS
dáfus	dáfus+Po
dearvan	dearvan+Adv
dolvot	doalvut+V+TV+Der/PassS+V+Inf
duđan	duđan+N+Sg+Nom
duođat	duohta+A+Adv
duohki	duohki+N+Sg+Nom
dustot	duostat+V+IV+Der/PassS+V+Inf
dustot	duostut+V+TV+Der/PassS+V+Inf
eahpe	eahpe	+?
eandalii	eandalii+Adv
eapmi	eapmi+N+Sg+Nom
earret	earret+Pr
eise	eise	+?
endor	endor+N+Sg+Nom
erdot	eardut+V+IV+Der/PassS+V+Inf
fal	fal+Adv
fas	fas+Adv
feara	feara+Adv
fearidit	fearidit	+?
feret	feret+V+IV+Inf
fulkkeš	fulkkeš+Adv
gabbosat	gabbosat	+?
gaccat	gaccat+N+Sg+Nom
gappus	gappus	+?
gárren	gárret+V+TV+Der3+Der/n+N+Sg+Nom
gáttit	gáddi+N+Adv
gázzi	gázzi+N+Sg+Nom
geažil	geažil+Po
geažil	geažil+Pr
giitemeahtun	giitemeahtun	+?
giljádit	giljádit+V+TV+Inf
gis	gis+Pcle
goal	goal+Adv
goasse	goasse+Adv
golgu	golgu+N+Sg+Nom
golgu	golgu+A+Sg+Nom
gottur	gottur+N+Sg+Nom
gubmot	gupmat+V+IV+Der/PassS+V+Inf
gubmot	guopmat+V+TV+Der/PassS+V+Inf
guddot	guoddit+V+TV+Der/PassS+V+Inf
guhpiid	guhpiid	+?
gul	gul+Adv
gullut	gullut+Po
gullut	gullut+Pr
gummá	gummá+A
guoskevaš	guoskevaš+A+Sg+Nom
guovssu	guovssu+N+Sg+Nom
guovttá	guovttá+Adv
gurrii	gurrii+Adv
gurrii	gurrii+Po
gusto	gusto+Adv
haga	haga+Adv
haga	haga+Po
han	han+Pcle
headja	heajat+N+SgNomCmp
heajut	headju+A+Adv
heibot	heaibat+V+IV+Der/PassS+V+Inf
heibot	heaibut+V+IV+Der/PassS+V+Inf
heŋgot	heaŋgut+V+TV+Der/PassS+V+Inf
ihkinassii	ihkinassii+Pron+Indef
ilbmi	ilbmat+V+IV+Der2+Actor+N+Sg+Nom
ilbmi	ilbmi+N+Sg+Nom
kámmár	kámmár+N+Sg+Nom
kristtalaß	kristtalaß	+?
lagaš	lagaš+N+Sg+Nom
láddot	láddat+V+IV+Der/PassS+V+Inf
lágán	lágán+A+Sg+Nom
lágáš	láhki+N+Der1+Der/Dimin+N+Sg+Nom
lágáš	lágáš+N+Sg+Nom
leahppi	leahppi+N+Sg+Nom
leavššut	leavššut	+?
lebbot	leabbut+V+TV+Der/PassS+V+Inf
leđgot	leađgut+V+IV+Der/PassS+V+Inf
lehkkot	leahkkut+V+TV+Der/PassS+V+Inf
leikot	leaikut+V+TV+Der/PassS+V+Inf
loaččit	loažži+N+Adv
mađe	mađe+Adv
mađe	mađe+Po
mađe	mađe+CS
man	man+Adv
man	man+Adv
maŋá	maŋá	+?
maŋŋe	maŋŋe	+?
máttás	máttás+Adv
mellot	meallut+V+IV+Der/PassS+V+Inf
miehte	miehte	+?
mihá	mihá+Adv
mihkke	mihkke+Pron+Indef+Sg+Nom
movt	movt+Adv
movt	movt+CS
muovja	muovja	+?
musiika	musiika	+?
mutuvra	mutuvra+N+Sg+Nom
na	na+Pcle
naba	naba+Adv
navválit	navválit+V+IV+Inf
njoammu	njoammu+N+Sg+Nom
njoammu	njoammut+V+IV+Der2+Actor+N+Sg+Nom
njoammu	njoammu+A+Sg+Nom
njuolga	njuolga+Adv
nuorta	nuorta+N+Sg+Nom
nuossat	nuossat+V+IV+Inf
oalle	oalle+Adv
ođđet	ođđet+V+TV+Inf
oggot	oaggut+V+TV+Der/PassS+V+Inf
okci	ovcci+Num+Sg+Nom
okci	okci+N+Sg+Nom
olmmoščearda	olmmoš+N+SgNomCmp#čearda+N+Sg+Nom
olmmoščearda	olmmoš#čearda+N+Sg+Nom
ovddal	ovddal+Po
poletiika	poletiika	+?
ravkit	ravkit+V+IV+Inf
rábit	rábit+N+Sg+Nom
ráje	ráje+Po
rekčot	rekčot+V+IV+Inf
ribat	ribat+N+Sg+Nom
riggát	rikkis+A+Adv
rittut	riddu+N+Adv
roađđi	roađđi+N+Sg+Nom
ruohtta	ruohtta+N+Sg+Nom
ruossalassii	ruossalassii+Adv
sajus	sajus+N+Sg+Nom
sivvu	sivvu+N+Sg+Nom
skážas	skážas+N+Sg+Nom
skoalbmi	skoalbmi+N+Sg+Nom
suonat	suonat+N+Sg+Nom
valat	valat+N+Sg+Nom
vare	vare+Adv
váldu	váldu+N+Sg+Nom
válljogas	válljogas	+?
veaitalas	veaitalas	+?
veara	+Der3+Der/veara+A+Sg+Nom
veara	veara+A+Sg+Nom
veardde	veardde+Po
veardde	veardde+Pr
veattán	veattán+N+Sg+Nom
vuhtii	vuhtii+Adv
vuojihit	vuodjit+V+TV+Der1+Der/h+V+Inf
vuojihit	vuojihit+V+TV+Inf
vuolá	vuolá+Adv
vuolle	vuolle	+?
vuonat	vuotna+N+Adv
