njuoras A: ydmyk A; mild A; svak A _ øm A, mild A, svak A
jábálaš A: velstående A; rik A _ rik A
oahppováillat A: utdanningsskadelidt A; utdanningsskadelidende A _ uten utdanning A
hilbat A: uskikkelig A; rampet A _ vilter A, skøyeraktig A
balddihahtti A: urovekkende A; skremmende A _ skremmende A
boasttu- A: uriktig A _ feil A, uriktig A
oahppameahttun A: uoppdragen A _ ulærd A
dohkketmeahttun A: uholdbar A; uakseptabel A _ ubrukelig A, udugelig A, uakseptabel A
ávdin A: ubebodd A; øde A _ øde A
eahpečielggas A: uavklart A; uklar A _ uklar A
áddjái A: tidkrevende A; sein A _ sein A, tidkrevende A
váibbas A: søvnig A; trøtt A _ trøtt A
seaggi A: sped A; smal A; tynn A _ tynn A, spinkel A
bahánihkkán A: slem A _ uskikkelig A
árvvas A: sjenerøs A; gavmild A _ generøs A, gavmild A
starggas A: robust A; stiv A _ stiv A, stø A
válmmaš A: rede A; ferdig A _ ferdig A
mearkkalaš A: pussig A; merkelig A _ merkelig A
oktageardán A: primitiv A; naiv A; enkel A _ enkel A
ebmui A: prektig A; flott A _ flott A
nággár A: opposisjonell A; gjenstridig A _ sta A, stridig A
jierbmái A: oppegående A; intelligent A; klok A; smart A _ klok A
návccaheapme A: næringssvak A; svak A _ svak A, veik A
dárogielat A: norsktalende A; norsk A; norskspråklig A _ norskspråklig A
dárogiel A: norsk A; norskspråklig A _ norskspråklig A
šlundi A: nedslått A _ motløs A, bedrøvet A
suohtas A: moro A; morsom A; hyggelig A _ morsom A, hyggelig A
hállái A: meddelsom A _ pratsom A
máŋggabealat A: mangeartet A; allsidig A _ allsidig A, mangesidig A
vigiheapme A: lytefri A; uskyldig A _ uskyldig A
lágalaš A: lovmessig A; rettslig A; lovlig A _ lovlig A; rettsgyldig A
eleš A: livskraftig A _ kvikk og livlig A; livsdyktig A; lengelevende A
beakkálmas A: legendarisk A; kjent A _ kjent A, berømt A
riikkaviidosaš A: landsomfattende A; landsdekkende A; nasjonal A _ riksdekkende A
gelbbolaš A: kompetent A; verdig A _ dugelig A; verdig A
vuoiŋŋalaš A: immateriell A; åndelig A; religiøs A; mental A _ åndelig A
muittoheapme A: glemsk A _ glømsk A, glemsom A, distre A
várrugas A: føre var A; var A _ forsiktig A
máđoheapme A: formidabel A _ forskrekkelig A
dáláš A: eksisterende A _ nåtidens N
dálá A: eksisterende A _ nåtidig A
láiki A: doven A _ lat A
jállu A: djerv A; modig A _ modig A
njuolgat A: direkte A; rett A _ rett A, bein A
njálggat A: deilig A _ velsmakende A, søt A
šealgat A: blinkende A _ blank A
mearrideaddji A: avgjørende A _ bestemmende A
anihahtti A: anvendelig A; anvendbar A _ brukbar A
falli A: sportslig A; rask A _ rask A
roastil A: uredd A _ dristig A
dábálaš A: allmenn A; ordinær A; normal A; standard A; vanlig A _ vanlig A, alminnelig A
erenoamáš A: særlig A; særskilt A; spesiell A _ spesiell A, ekstra A
vásedin A: særlig A; særskilt A _ særskilt A
ahkit A: trist A; kjedelig A _ kjedelig A, utrivelig A
ovttaskas A: enkelt A _ enslig A
eaŋkil A: enkelt A; enkel A _ enkel A
duhtavaš A: tilfreds A; fornøyd A _ fornøyd A
geasuheaddji A: attraktiv A _ tiltrekkende A
bivnnut A: attraktiv A; populær A _ omsvermet A, godt likt A
jearggalaš A: konsekvent A; fornuftig A; rasjonell A _ fornuftig A
garas A: streng A; sterk A; voldsom A; hard A _ hard A
čavgat A: streng A _ stram A
goavvi A: streng A; vanskelig A _ hensynsløs A
áddehahtti A: brukervennlig A; forståelig A _ forståelig A
udju A: beskjeden A _ sjenert A
girjái A: variert A; mangfoldig A _ spraglet A, flekket A
dohkálaš A: forsvarlig A _ høvelig A, tjenlig A
ráfálaš A: harmonisk A; fredelig A _ fredelig A
soabalaš A: harmonisk A; fredelig A _ fredelig A, forsonlig A
olgguldas A: ekstern A; ytre A _ ytre A, utvendig A
roahkkat A: utadvendt A; åpen A _ freidig A
čorgat A: ryddig A _ renslig A
ovddit A: fremre A; foregående A _ tidligere A, foregående A, forrige A; fremre A
ovddimus A: fremre A; første A _ først A, fremst A
bargonávccalaš A: yrkesaktiv A _ arbeidsfør A
heivvolaš A: hensiktsmessig A; egnet A; passelig A _ passelig A
ávkkálaš A: hensiktsmessig A; nyttig A _ nyttig A; formålstjenlig A
ovttalágan A: lik A _ samme slags A
seammalágan A: lik A; tilsvarende A _ likedan A
dárbbašmeahttun A: unødig A; unødvendig A _ unødvendig A
soddjil A: dynamisk A; fleksibel A _ bøyelig A
bistevaš A: permanent A; fast A; langvarig A _ varig A, fast A
bissovaš A: permanent A; kronisk A; fast A _ vedvarende A
njoahci A: sakte A; sein A; treg A; sen A _ sein A, langsom A
ođđaáigásaš A: tidsriktig A; moderne A _ moderne A
moivvas A: forvirrende A; uklar A _ uklar A, grumset A
báhkas A: opphetet A; varm A _ varm A
viiddis A: omfattende A; vid A; bred A _ vid A, utstrakt A
alvvalaš A: offensiv A _ energisk A
bahá A: ond A; alvorlig A _ sint A
gutneheapme A: uverdig A; frekk A _ frekk A
árvvoheapme A: uverdig A; vanskelig A _ vanskelig A, brysom A; verdiløs A
hearki A: utsatt A; sårbar A; svak A _ øm A, følsom A
seammasullasaš A: tilsvarende A; lignende A _ lignende A
sullasaš A: tilsvarende A; liknende A; lignende A _ liknende A
oskkáldas A: trofast A; lojal A _ pålitelig A
ruđalaš A: finansiell A; økonomisk A; rik A _ pengemessig A; rik A
gánnáhahtti A: bærekraftig A; lønnsom A _ lønnsom A
bajimuš A: overordnet A _ øverst A
bajit A: overordnet A; øvre A _ øvre A
válddálaš A: uttrykkelig A; mektig A; myndig A _ mektig A, myndig A
váilevaš A: mangelfull A; manglende A _ manglende A
sámegielat A: samisk A _ samiskspråklig A
elektrovnnalaš A: elektronisk A _ elektronisk A _ SAME
vuosttaš A: første A; første A _ først A
vuosttas A: første A; første A _ først A
ovddemus A: første A _ først A
vuosttamuš A: første A _ først A
fiinnis A: flott A; fin A _ fin A
áddemeahttun A: uforståelig A _ uforståelig A _ SAME
áddetmeahttun A: uforståelig A _ uforståelig A _ SAME
almmolaš A: offisiell A; offentlig A _ offentlig A, offisiell A
beaktil A: næringsrik A; effektiv A _ næringsrik A
álbmái A: næringsrik A _ kraftig A
boahtteáigásaš A: fremtidsrettet A; fremtidig A; framtidig A _ fremtidsrettet A, fremtidig A
liekkas A: varm A _ varm A _ SAME
liekkus A: varm A; hyggelig A _ hyggelig A, koselig A
dearvvašlaš A: sunn A _ sunn A _ SAME
dearvvaslaš A: sunn A _ sunn A _ SAME
dearvvaš A: sunn A; frisk A _ frisk A
dárki A: viss A; sikker A _ viss A, sikker A
dihto A: viss A; bestemt A _ viss A
vissis A: viss A; bestemt A; sikker A _ sikker A; bestemt A, viss A
duihmi A: dum A _ dum A, tungnem A
jalla A: dum A _ dum A _ SAME
doavki A: dum A _ dum A _ SAME
duođalaš A: alvorlig A; høytidelig A; reell A _ alvorlig A
ovddolaš A: underlig A; merkelig A _ underlig A, merkelig A
ártet A: underlig A; merkelig A; rar A _ rar A, merkelig A
eaimmaskas A: underlig A _ snodig A, underlig A
ealas A: livlig A; kvikk A; levende A _ livlig A, kvikk A, energisk A
virkui A: livlig A; kvikk A; vital A _ kvikk A, livlig A
vitmat A: kvikk A; skarp A; dyktig A _ lærenem A, skarp A
áŋgir A: flittig A; ambisiøs A; ivrig A _ ivrig A, flittig A
viššal A: flittig A; aktiv A _ flittig A
ealjár A: flittig A; dyktig A _ flittig A
fasti A: stygg A; fæl A _ stygg A, fæl A
ropmi A: stygg A _ stygg A _ SAME
čáppat A: fin A; pen A; vakker A _ pen A
friddja A: fri A _ fri A _ SAME
friija A: fri A _ fri A _ SAME
luovus A: fri A; løs A _ løs A, laus A
veaittalas A: fri A _ fri A, på egen hånd A
fuolaheapme A: likegyldig A _ likegyldig A _ SAME
headju A: dårlig A; svak A; negativ A _ dårlig A, skral A
heittot A: dårlig A; svak A _ dårlig A, svak A
fuotni A: dårlig A; svak A; negativ A _ dårlig A
galmmas A: kald A _ kald A _ SAME
čoaskkis A: kald A _ kjølig A
geatnegas A: ansvarlig A _ pliktig A; ansvarlig A
návccalaš A: sterk A; dyktig A _ sterk A, dyktig A
searalaš A: sterk A; dyktig A; selvstendig A _ sterk A, dyktig A
gievra A: sterk A; sterk A; sterk A _ sterk A
nanus A: sterk A _ solid A, sterk A
gárži A: smal A; trang A _ trang A, smal A
hiđis A: sein A; sen A _ sein A
hutkái A: kreativ A _ kreativ A _ SAME
jegolaš A: lydig A _ lydig A _ SAME
siivui A: lydig A; rolig A; snill A _ snill A, rolig A
suvrris A: sur A; sur A _ sur A
jiesas A: sur A _ sur A, blåsur A
lihkolaš A: heldig A; lykkelig A _ lykkelig A, heldig A
lámis A: ufør A _ vanfør A, ufør A, lam A
lášmat A: smidig A; snar A _ smidig A, snar A
miellagiddevaš A: interessant A _ interessant A _ SAME
movttet A: optimistisk A; glad A _ i godt humør A, optimistisk A
mášoheapme A: urolig A _ rastløs A, urolig A
muoseheapme A: urolig A _ urolig A _ SAME
riekta A: rett A; riktig A; korrekt A _ riktig A
oanehaš A: kort A _ kort A _ SAME
ollislaš A: fullverdig A; total A _ fullverdig A
ovttageardán A: naiv A; ensidig A; enkel A _ enfoldig A, naiv A
ođas A: ny A _ ny A _ SAME
rabas A: åpen A; ledig A _ åpen A
rehálaš A: hederlig A; ærlig A; rettferdig A _ ærlig A, hederlig A
rákkis A: treg A _ treg A _ SAME
normála A: normal A _ normal A _ SAME
seksuálalaš A: seksuell A _ seksuell A _ SAME
sierra A: særskilt A _ særskilt A; adskilt A
sivaheapme A: uskyldig A _ uskyldig A _ SAME
villas A: vill A _ vill A, vilter A
vilddas A: vill A _ ustyrlig A, vilter A
bastil A: skarp A; kvass A _ kvass A
viđát A: femte A _ femte A _ SAME
vuollegaš A: lav A _ lav A _ SAME
unni A: lav A; liten A _ liten A
váttis A: vanskelig A _ vanskelig A _ SAME
váivái A: vanskelig A; ubehagelig A _ vanskelig A, ubehagelig A
váigat A: vanskelig A; kjedelig A _ kjedelig A, vanskelig A
čavddis A: urørt A _ tett A, uten hull A; urørt A
čielggas A: tydelig A; klar A _ klar A, tydelig A
ekonomalaš A: økonomisk A _ økonomisk A _ SAME
sosiála A: sosial A _ sosial A _ SAME
olmmošlaš A: høflig A; folkelig A; menneskelig A; grei A _ høflig A; menneskelig A
čearddalaš A: etnisk A _ etnisk A _ SAME
etnalaš A: etnisk A _ etnisk A _ SAME
máŋggakultuvrralaš A: flerkulturell A _ flerkulturell A _ SAME
geavatlaš A: praktisk A _ praktisk A _ SAME
oainnus A: synlig A _ synlig A _ SAME
eaktodáhtolaš A: frivillig A _ frivillig A _ SAME
iešdáhtolaš A: frivillig A _ forsettlig A
eŋgelas A: engelsk A _ engelsk A _ SAME
eaŋgals A: engelsk A _ engelsk A _ SAME
oktonas A: ensom A _ alene A
buiga A: ekte A _ ekte A, virkelig A
teknihkalaš A: teknisk A _ teknisk A _ SAME
ilolaš A: glad A; gledelig A _ gledelig A
almmus A: tilgjengelig A; offentlig A _ offentlig A
mearkkašahtti A: betydelig A; påfallende A; vesentlig A _ betydningsfull A
issoras A: enorm A _ forferdelig A
máŧoheapme A: enorm A; umulig A _ umulig A
áibmadas A: enorm A _ kolossal A
gaskaboddosaš A: foreløpig A; midlertidig A _ midlertidig A
jeagoheapme A: tverr A _ ulydig A
govdat A: stolt A; bred A _ brei A, bred A
čeavlái A: stolt A _ overlegen A, hoven A
vuovdnái A: stolt A _ pågående A, energisk A; staselig A
ilgat A: voldsom A _ nifs A
stáđis A: stabil A; fast A _ stø A, fast A
otná A: dag N _ dagens N
otnáš A: dag N _ dagens N
mávssolaš A: verdifull A; viktig A _ dyrebar A; viktig A
muttát A: moderat A; passelig A; rimelig A _ passelig A
rašši A: sårbar A; svak A _ veik A, skjør A
agálaš A: uendelig A; evig A _ evig A
jáhkehahtti A: troverdig A _ trolig A, sannsynlig A
vuollásaš A: underliggende A _ underlagt A
imaš A: påfallende A; merkelig A; rar A _ merkelig A
risttalaš A: kristelig A; kristen A _ kristen A
kristtalaš A: kristelig A; kristen A _ kristen A
jaskat A: stille A; rolig A; taus A _ rolig A, stille A, taus A
boahtte A: kommende A _ kommende A _ SAME
boahttevaš A: kommende A; fremtidig A; framtidig A _ kommende A
dánskalaš A: dansk A _ dansk A _ SAME
dánska A: dansk A _ dansk A _ SAME
suorggahahtti A: skremmende A _ skremmende A _ SAME
seavdnjat A: mørk A _ mørk A _ SAME
čáhppesvarat A: mørk A _ mørk A _ SAME
ránis A: grå A _ grå A _ SAME
albma A: skikkelig A _ ordentlig A, skikkelig A
alit A: blå A _ blå A _ SAME
allat A: høy A _ høy A, høg A
amas A: fremmed A; ukjent A _ fremmed A, ukjent A
vieris A: fremmed A _ fremmed A _ SAME
asehaš A: tynn A _ tynn A _ SAME
njárbat A: tynn A _ tynn A; glissen A
goiddas A: tynn A; svak A _ tynn A, svak A
bahča A: bitter A _ bitter A _ SAME
rihča A: bitter A _ besk A, bitter A
baski A: trang A _ trang A _ SAME
bassi A: hellig A _ hellig A _ SAME
beaivválaš A: daglig A _ daglig A _ SAME
dovddus A: kjent A _ kjent A _ SAME
oahpis A: kjent A _ kjent A _ SAME
bealjeheapme A: døv A _ døv A, tunghørt A
buoidi A: feit A _ feit A _ SAME
báikkálaš A: lokal A _ lokal A _ SAME
bávččas A: vond A _ vond A, smertefull A
coagis A: grunn A _ grunn A _ SAME
dearvvas A: frisk A _ frisk A _ SAME
dehálaš A: viktig A _ viktig A _ SAME
deaŧalaš A: viktig A _ viktig A _ SAME
diehtemeahttun A: uvitende A _ uvitende A _ SAME
diehttalas A: naturlig A _ viss A, naturlig A
lunddolaš A: naturlig A _ naturlig A _ SAME
dieđalaš A: vitenskapelig A _ vitenskapelig A _ SAME
linis A: myk A _ myk A _ SAME
dimis A: myk A; mjuk A _ myk A, mjuk A
divrras A: dyr A; kostbar A _ dyr A, kostbar A
dihtomielalaš A: bevisst A _ bevisst A _ SAME
diđolaš A: bevisst A _ bevisst A _ SAME
doaŋgi A: stiv A _ stiv A, støl A, slapp A
stirddas A: stiv A _ stiv A _ SAME
duhtameahttun A: misfornøyd A _ misfornøyd A _ SAME
duđavaš A: fornøyd A _ fornøyd A _ SAME
duiska A: tysk A _ tysk A _ SAME
duolbbas A: flat A _ flat A _ SAME
sieiva A: vanlig A; ren A _ vanlig A, alminnelig A
dárkil A: grundig A _ nøyaktig A, grundig A
vuđolaš A: grundig A; grunnleggende A _ grundig A, grunnleggende A
earálágan A: annerledes A; ulik A; forskjellig A _ ulik A, forskjellig A, annerledes A
nuppelágan A: annerledes A; forskjellig A _ annerledes A, forskjellig A
unohas A: ubehagelig A; uheldig A _ uhøvelig A, ubehagelig A
eatnjehas A: ubehagelig A _ ubehagelig A, nifs A
vahátlaš A: skadelig A _ skadelig A _ SAME
fiskat A: gul A _ gul A _ SAME
fágalaš A: faglig A _ faglig A _ SAME
fámolaš A: mektig A _ mektig A _ SAME
gallji A: vid A _ vid A, rommelig A
gaskamearálaš A: gjennomsnittlig A _ gjennomsnittlig A _ SAME
suohkat A: tykk A; frodig A _ tjukk A, tett A
assái A: tykk A _ tjukk A
gassat A: tykk A; dyp A; dyp A; grov A _ tykk A; dyp A; dyp A, grov A
váfi A: tykk A; svær A; trygg A; sikker A; frodig A _ svær A, tjukk A; sikker A, trygg A
čieŋal A: dyp A _ dyp A, djup A
roakkas A: dyp A; grov A _ dyp A, grov A
roattus A: dyp A; grov A _ grov A, dyp A
roavis A: grov A; rå A _ grov A
geafi A: fattig A _ fattig A _ SAME
healpu A: lett A _ lett A, lettvint A
álki A: lett A; enkel A _ lett A, lettvint A
geahpas A: lett A _ lett A _ SAME
geahppat A: lett A _ lett A _ SAME
gelddolaš A: spennende A _ spennende A _ SAME
gierdameahttun A: utålmodig A _ utålmodig A _ SAME
giitevaš A: takknemlig A _ takknemlig A _ SAME
gillil A: utrettelig A _ utrettelig A, tålmodig A
árjjalaš A: ivrig A; aktiv A _ ivrig A, energisk A
givas A: ivrig A; modig A _ ivrig A, modig A
goalmmát A: tredje A _ tredje A _ SAME
guorus A: tom A; ledig A _ tom A
guovttegielat A: tospråklig A _ tospråklig A _ SAME
guovttegielalaš A: tospråklig A _ tospråklig A _ SAME
gurut A: venstre A _ venstre A _ SAME
guđát A: sjette A _ sjette A _ SAME
válmmas A: ferdig A; klar A _ ferdig A, klar A
gárvvis A: ferdig A; klar A _ ferdig A
gávccát A: åttende A _ åttende A _ SAME
hávski A: morsom A; hyggelig A _ morsom A, hyggelig A
hearvái A: morsom A _ herlig A, morsom A
hávskái A: morsom A; hyggelig A _ hyggelig A, morsom A
somá A: morsom A; artig A _ morsom A, artig A
vuogas A: passelig A _ høvelig A, passelig A, behagelig A
hirbmat A: svær A _ svær A _ SAME
hálbi A: billig A; rimelig A _ billig A
hálddahuslaš A: administrativ A _ administrativ A _ SAME
smáđáhkis A: hyggelig A; grei A _ hyggelig A
iešlágan A: merkelig A _ merkelig A, noe for seg selv A
imašlaš A: merkelig A _ merkelig A _ SAME
jahkásaš A: årlig A _ årsgammel A; årlig A
lodji A: rolig A _ tam A, rolig A
jávoheapme A: taus A _ taus A _ SAME
jierpmálaš A: fornuftig A _ fornuftig A _ SAME
viissis A: klok A _ klok A, vis A
joavdelas A: unødvendig A _ unyttig A, unødvendig A
jorbat A: rund A _ rund A _ SAME
jáhkkemeahttun A: utrolig A _ utrolig A _ SAME
luovos A: løs A _ løs A _ SAME
loažžat A: løs A _ slapp A, løs A
lobiheapme A: ulovlig A _ ulovlig A _ SAME
lobálaš A: lovlig A _ lovlig A _ SAME
logát A: tiende A _ tiende A _ SAME
máizzas A: lunken A _ lunken A _ SAME
loikkas A: lunken A _ lunken A _ SAME
lossat A: tung A _ tung A _ SAME
mánnálaš A: barnslig A _ barnslig A _ SAME
mánálaš A: barnslig A _ barnslig A _ SAME
veadjemeahttun A: umulig A _ umulig A _ SAME
máŧolaš A: mulig A _ mulig A _ SAME
vejolaš A: mulig A; eventuell A _ mulig A
njealját A: fjerde A _ fjerde A _ SAME
njuoskkas A: våt A; rå A _ våt A, bløt A
njálmmálaš A: muntlig A _ muntlig A _ SAME
nuorra A: ung A _ ung A _ SAME
nuoski A: urenslig A _ urenslig A _ SAME
oarbbis A: foreldreløs A _ foreldreløs A _ SAME
oktasaš A: felles A _ felles A _ SAME
olgeš A: høyre A _ høyre A _ SAME
oppalaš A: generell A; total A _ generell A
obbalaš A: generell A; total A _ generell A, fullstendig A
ovccát A: niende A _ niende A _ SAME
vuoigat A: riktig A _ åpenhjertig A; riktig A
historjjálaš A: historisk A _ historisk A _ SAME
politihkalaš A: politisk A _ politisk A _ SAME
ruoksat A: rød A _ rød A _ SAME
ruoná A: grønn A _ grønn A _ SAME
ruonas A: grønn A _ grønn A _ SAME
ruosttas A: rusten A _ rusten A _ SAME
ruošša A: russisk A _ russisk A _ SAME
loahpalaš A: endelig A _ endelig A _ SAME
ráhkis A: kjær A _ kjær A _ SAME
ráhpat A: flink A _ bra A, flink A
čeahppi A: flink A; dyktig A _ flink A
ránska A: fransk A _ fransk A _ SAME
šiega A: snill A _ snill A _ SAME
siskkáldas A: intern A _ det indre A, innbyrdes A, intern A
sitkat A: seig A _ seig A, utholdende A
áššálaš A: skyldig A; saklig A _ skyldig A, tiltalt A
sujalaš A: skyldig A _ skyldig A _ SAME
sivalaš A: skyldig A _ skyldig A _ SAME
velggolaš A: skyldig A _ skyldig A _ SAME
smávis A: liten A _ liten A _ SAME
uhcci A: liten A _ liten A _ SAME
čiegus A: hemmelig A _ hemmelig A _ SAME
suollemas A: hemmelig A _ hemmelig A _ SAME
diehtoáŋgir A: nysgjerrig A _ nysgjerrig A _ SAME
sáhkkái A: nysgjerrig A _ nysgjerrig A; snakkesalig A
sáhkkii A: nysgjerrig A _ nysgjerrig A; snakkesalig A
varas A: fersk A _ fersk A _ SAME
vielgat A: hvit A _ kvit A, hvit A
váimmolaš A: hjertelig A _ hjertelig A _ SAME
váralaš A: farlig A _ farlig A _ SAME
várálaš A: farlig A _ farlig A _ SAME
ábolaš A: nyttig A _ nyttig A _ SAME
árbevirolaš A: tradisjonell A _ tradisjonell A _ SAME
čalmmeheapme A: svaksynt A _ blind A, svaksynt A
čihččet A: sjuende A; syvende A _ sjuende A
čuovvovaš A: følgende A _ følgende A _ SAME
čáhppat A: svart A _ svart A _ SAME
čálalaš A: skriftlig A _ skriftlig A _ SAME
čáppis A: pen A; vakker A _ pen A, vakker A
kultuvrralaš A: kulturell A _ kulturell A _ SAME
gullevaš A: tilhørende A _ tilhørende A _ SAME
šállošahtti A: beklagelig A _ beklagelig A _ SAME
váidalahtti A: beklagelig A _ beklagelig A _ SAME
dalá A: daværende A _ daværende A _ SAME
persovnnalaš A: personlig A _ personlig A _ SAME
dáiddalaš A: kunstnerisk A _ kunstnerisk A _ SAME
berošteaddji A: interessert A _ interessert A _ SAME
vuolit A: nedre A _ nedre A _ SAME
ovttajienalaš A: enstemmig A _ enstemmig A _ SAME
ivdnái A: fargerik A _ fargerik A _ SAME
gonagaslaš A: kongelig A _ kongelig A _ SAME
girkolaš A: kirkelig A _ kirkelig A _ SAME
mánnosaš A: månedlig A _ månedlig A _ SAME
sávahahtti A: ønskelig A _ ønskelig A _ SAME
vahkkosaš A: ukentlig A _ ukentlig A _ SAME
botniheapme A: bunnløs A _ bunnløs A _ SAME
gráfalaš A: grafisk A _ grafisk A _ SAME
klassihkalaš A: klassisk A _ klassisk A _ SAME
veahkkái A: hjelpsom A _ hjelpsom A _ SAME
láittas A: kjedelig A _ kjedelig A _ SAME
doaresfágalaš A: tverrfaglig A _ tverrfaglig A _ SAME
eanaš A: mange A _ det meste A, de fleste A
eanas A: mange A _ det meste A
máilmmiviidosaš A: global A _ global A _ SAME
fávru A: vakker A _ skjønn A, vakker A
hámálaš A: vakker A _ staselig A, vakker A
ovttabealat A: ensidig A _ ensidig A _ SAME
bivval A: mild A _ mild A _ SAME
láđis A: mild A _ mild A, blid A
láivi A: mild A; svak A; svak A _ svak A
rikkis A: rik A _ rik A _ SAME
boandái A: rik A _ rik A _ SAME
boaris A: gammel A _ gammel A _ SAME
vuoras A: gammel A _ gammel A _ SAME
ovddeš A: gammel A; tidlig A _ tidligere A
dološ A: gammel A _ gammeldags A
ollis A: full A; hel A _ hel A, full A
dievaslaš A: full A _ fullstendig A
dievas A: full A _ full A, fullstendig A
oadjebas A: trygg A; trygg A _ trygg A
dorvvolaš A: trygg A; trygg A; sikker A _ trygg A, tillitsfull A
sihkar A: trygg A; trygg A; sikker A; sikker A _ sikker A
dárbbašlaš A: nødvendig A _ nødvendig A _ SAME
vealtameahttun A: nødvendig A _ uunngåelig A
geamus A: uklar A _ uklar A, disig A
iešguđetlágan A: ulik A; forskjellig A _ forskjellige slags A
sierranas A: forskjellig A _ atskilt A
jođán A: rask A; snar A _ hurtig A, rask A
johtil A: rask A; snar A _ hurtig A
valli A: rask A _ hurtig A, rask A
guovddáš A: sentral A _ sentral A _ SAME
stánddalaš A: dyktig A; stødig A _ stødig A, dyktig A
fávdnát A: dyktig A _ bra A, dyktig A
geahnoheapme A: svak A _ udugelig A, svak A
čuorbi A: svak A _ klønete A, udugelig A
šiervi A: svak A _ spinkel A, svak A
sealvi A: klar A _ klar A, normal A
gearggus A: klar A _ klar A _ SAME
šearrat A: klar A _ blank A, klar A
girkat A: klar A _ klar A, skinnende A
geažos A: hel A _ hel A _ SAME
oppa A: hel A _ hel A, all A
duostil A: modig A _ dristig A
váibmui A: modig A _ modig A _ SAME
guhkki A: lang A _ lang A _ SAME
gummá A: rar A _ rart A
guovttegeardásaš A: dobbel A _ dobbel A _ SAME
háhppil A: snar A _ kjapp A, snar A
iešheanalaš A: selvstendig A _ selvstendig A _ SAME
iešráđálaš A: selvstendig A; uavhengig A _ egenmektig A, selvstendig A
jalgat A: jevn A _ slett A, jevn A
lagas A: nær A _ nærliggende A, nær A
lagaš A: nær A _ nær A _ SAME
molssaevttolaš A: alternativ A _ alternativ A _ SAME
riikkaidgaskasaš A: internasjonal A _ internasjonal A _ SAME
internationála A: internasjonal A _ internasjonal A _ SAME
gaskariikkalaš A: internasjonal A _ internasjonal A _ SAME
ráinnas A: ren A _ rein A, ren A
buhtis A: ren A _ rein A
rávis A: voksen A _ voksen A _ SAME
eallilan A: voksen A _ godt voksen A, som har levd en stund A
stuoris A: stor A _ stor A _ SAME
stuorebuš A: stor A _ litt større A
luohttevaš A: stødig A _ tillitsfull A
vuoiggalaš A: rettferdig A _ redelig A
vánhurskkis A: rettferdig A _ gudfryktig A; rettferdig A
árrat A: tidlig A _ tidlig A _ SAME
positiivvalaš A: positiv A; positiv A _ positiv A
positiiva A: positiv A; positiv A _ positiv A
negatiiva A: negativ A; negativ A _ negativ A
eahpesihkar A: usikker A _ usikker A _ SAME
dorvvuheapme A: usikker A _ motløs A
nationála A: nasjonal A; nasjonal A _ nasjonal A
govttolaš A: rimelig A _ rimelig A _ SAME
sorjjasmeahttun A: uavhengig A _ uavhengig A _ SAME
formálalaš A: formell A _ formell A _ SAME
priváhta A: privat A _ privat A _ SAME
maŋit A: sist A _ bakre A
hillján A: sen A _ langsom A, makelig A
áigeguovdil A: aktuell A _ tidsaktuell A
guoskevaš A: aktuell A _ angående A
oskkolaš A: religiøs A _ troende A
duohta A: reell A _ sann A
lihkoheapme A: uheldig A _ ulykkelig A
dávggas A: fleksibel A _ elastisk A, spenstig A
juohkelágan A: allsidig A _ allslags A
dássásaš A: likeverdig A _ jevnbyrdig A; jevnhøy A
bolffas A: frodig A _ lodden A
