rohkki N: avdød A _ avdød N
čoahkkináigi N: møtesekvens N; møtetidspunkt N _ møtetid N
njiŋŋálas N: hunnlaks N _ hunndyr N, av hunkjønn N
šibitdállu N: gardsdrift N _ gårdsbruk med husdyr N
prográmmafálaldat N: programtjeneste N; programtilbud N _ programtilbud N
oahpahusguovddáš N: utdanningsenhet N; utdanningssentral N; utdanningssentrum N; utdanningssenter N _ undervisningssenter N
mánáidgárdeláhka N: barnehagetjeneste N; barnehagelov N _ barnehagelov N
beaivedikšu N: omsorgsdøgn N _ dagpleie N
badjemánná N: reindriftsunge N; flyttsamebarn N; reindriftsbarn N _ reindriftsbarn N
telefonoktavuohta N: telefonforbindelse N; telefonkontakt N _ telefontilknytning N
máksinnákca N: betalingsevne N; likviditetsforvaltning N; likviditet N _ likviditet N
johtolatplána N: jernbanebevilgning N _ trafikkplan N
dáiddaoahppu N: kunstutdannelse N; kunstutdanning N _ kunstutdanning N
duodječájáhus N: sløydutstilling N _ duodjiutstilling N
festiváladoarjja N: festivaltilskudd N; festivalstøtte N _ festivalstønad N
diibmu N: lønnsslipp N; time N _ time N; ur N, klokke N
ráđđehusovttasbargu N: regjeringssamarbeid N _ regjeringssamarbeid N _ SAME
njealjejuvllat N: terrengsykkel N; firhjuling N _ firehjulssykkel N
oalgecealkka N: leddsetning N _ bisetning N
lotnolasealáhus N: næringskombinasjonsavtale N; næringskombinasjon N _ næringskombinasjon N
boazu N: miniatyrrein N; reinsdyr N; rein N _ rein N, reinsdyr N
oljoopmodat N: oljeformue N _ oljeressurser N
prinsihppadigaštallan N: prinsippdiskusjon N _ prinsippdebatt N
gihpa N: studiehefte N; brosjyre N; hefte N _ hefte N
luonddunamahus N: naturbetegnelse N _ naturbenevnelse N
fuolkevuođanamahus N: slektskapsbenevnelse N _ slektsskapsbenevnelse N
rámmajuolludeapmi N: rammetilskudd N; rammeoverføring N _ rammebevilgning N
rámmadoarjja N: rammetilskudd N _ rammestøtte N
jienastuslohku N: samemanntall N; manntall N; valgmanntall N _ manntall N, valgmanntall N
válljenmunni N: valgmulighet N; utvalg N _ utvalg N
oahpposadji N: læreplass N; studieplass N; plass N _ studieplass N
riikkasearvi N: landsforbund N; riksforbund N _ landsforening N
giellabeassi N: språkleir N; språkreir N _ språkreir N
ovddasvástádussuorgi N: ansvarsområde N _ ansvarsfelt N
kulturlávdegoddi N: kulturkomite N _ kulturkomité N
servodatsuorgi N: samfunnsområde N; samfunnssektor N _ samfunnssektor N
iskkus N: prøveuttak N; prøve N; undersøkelse N _ prøve N
válgalávdegoddi N: valgkomite N _ valgkomité N
bargomátki N: tjenestereise N _ arbeidsreise N
doarjja N: støttespiller N; tilskudd N; bidrag N; støtte N; støtte N _ stønad N; støtte N
dáiddaguovddáš N: kunstnersenter N _ kunstsenter N
badjesápmelaš N: reindriftsame N; reindriftssame N _ reindriftssame N
boazosápmelaš N: reindriftsame N; reindriftssame N _ reindriftssame N
ealáhuslávdegoddi N: næringskomite N; næringskomité N _ næringsutvalg N, næringskomité N
guovllukantuvra N: regionkontor N; områdekontor N; underkontor N; distriktskontor N _ distriktskontor N, regionskontor N
rápmaeaktu N: rammevilkår N; rammebetingelse N _ rammebetingelse N
rámmaeaktu N: rammevilkår N; rammebetingelse N _ rammebetingelse N
ovttasbargoguoibmi N: samarbeidspart N; samarbeidspartner N _ samarbeidspartner N
prošeaktadoarjja N: prosjektstøtte N _ prosjektstønad N
ássanguovlu N: bosettingsområde N; bosetningsområde N _ bosetningsområde N
oktasaščoavddus N: pakkeløsning N; fellesløsning N _ fellesløsning N
biebmoávnnas N: næringsstoff N; næringsmiddel N _ næringsmiddel N
bivdokultuvra N: fangstkultur N _ jaktkultur N
veahkaváldi N: voldsutøver N; makt N; vold N; overgrep N _ vold N, makt N, overgrep N
gámasuoidni N: sennagress N; sennegras N _ sennegress N
valáštallansuorgi N: idrettsgren N; idrettsområde N _ idrettsgrein N
bearjjas N: vindskjul N _ røykskjerm N
kulturdeaivvadeapmi N: kulturmøte N _ kulturtreff N
gávpotstivra N: bystyregruppe N; bystyre N _ bystyre N
fápmodilli N: maktstilling N; kraftsituasjon N _ styrkeforhold N
leansmánnibálvá N: lensmannsfullmektig N _ lensmannsbetjent N
govvačájáhus N: bildeutstilling N _ billedutstilling N
boazodávda N: reinsjukdom N; reinsykdom N _ reinsykdom N
jugešvuohta N: misbruksproblem N; alkoholmisbruk N _ drukkenskap N
investerendoarjja N: investeringstilskudd N; investeringsstøtte N _ investeringsstønad N
matematihkkagirji N: matematikkverk N _ matematikkbok N
álgoálbmotguovlu N: urfolksregion N; urfolksområde N _ urbefolkningsområde N
vealaheapmi N: forskjellsbehandling N; diskriminering N _ diskriminering N
deaivvadanbáiki N: møtested N; møteplass N _ treffsted N
stáhtadoarjja N: statstilskudd N _ statsstøtte N
buvttadandoarjja N: produksjonstilskudd N; produksjonsstøtte N _ produksjonsstøtte N
bargovuohki N: arbeidsform N; arbeidsmåte N; arbeidsmetode N; prosedyre N _ arbeidsmetode N; prosedyre N
lassiealáhus N: tilleggsnæring N _ attåtnæring N, bierverv N
orohatjuohkin N: distriktsinndeling N _ reinbeitedistriktsinndeling N
gáicadoallu N: geitbruk N; geitehold N _ geitebruk N
lohkkiidčálus N: leserinnlegg N _ leserbrev N
prográmmadoaibma N: programaktivitet N; programvirksomhet N _ programvirksomhet N
oamastanvuoigatvuohta N: eierrettighet N; eiendomsrett N _ eiendomsrett N
bealdu N: jordbearbeiding N; innmark N _ åker N
kulturdoarjja N: kulturstøtte N _ kulturstønad N
gássabohkan N: gassutvinning N _ gassboring N
oahpahusministtar N: utdanningsminister N _ undervisningsminister N
ovddidandoarjja N: utviklingstilskudd N _ utviklingsstønad N
oahpahuspolitihkka N: opplæringspolitikk N; utdanningspolitikk N _ utdanningspolitikk N
eamiálbmotguovlu N: urfolksområde N _ urbefolkningsområde N
dárkkistanlávdegoddi N: revisjonsutvalg N; kontrollkomité N _ kontrollkomité N
nákkosgirji N: doktorgradsavhandling N; doktoravhandling N _ doktoravhandling N
eanetlohkoráđđehus N: flertallsregjering N _ flertallsregjering N _ SAME
vearrodássi N: skattenivå N _ skattenivå N _ SAME
giellaváttisvuohta N: språkvanske N; språkproblem N _ språkproblem N
boazodoallošiehtadallan N: reindriftsavtaleforhandling N; reindriftsforhandling N _ reindriftsforhandling N
lohkanmearri N: pensumlitteratur N; pensum N _ pensum N
bivdoguovlu N: fiskeområde N _ fangstområde N
niitu N: utmarksslått N _ natureng N
buohccedivššár N: sykesøster N; sykepleier N _ sykepleier N
jienastanvuohki N: avstemningsmåte N _ voteringsprosedyre N
doarjjaortnet N: tilskuddsordning N; støtteordning N _ støtteordning N
nissonoassi N: kvinneandel N _ kvinneandel N _ SAME
giehtaduodji N: håndverksprodukt N; håndarbeid N; håndverk N _ håndarbeid N
boazodoallohoavda N: reindriftssjef N _ reindriftssjef N _ SAME
mánáidgárdefálaldat N: barnehagedekning N; barnehagetilbud N _ barnehagetilbud N
oahppodilli N: undervisningssituasjon N; opplæringssituasjon N _ læresituasjon N
sátnegeavaheapmi N: begrepsbruk N _ ordbruk N
birasgáhttenossodat N: miljøvernavdeling N _ miljøvernenhet N
konvoluhtta N: omslagskonvolutt N; konvolutt N _ konvolutt N
ovdanamma N: personnavn N; fornavn N _ fornavn N
stáhtafápmu N: statsmakt N _ statsmakt N _ SAME
álgoálbmotguovddáš N: urfolksenter N; urfolkssenter N _ urfolkssenter N
čearda N: stammefolk N; art N _ art N
oahppofálaldat N: opplæringstilbud N; studietilbud N; utdanningstilbud N; undervisningstilbud N _ undervisningstilbud N
oktasašskuvla N: fellesskole N; enhetsskole N _ enhetsskole N
válgavuohki N: valgordning N _ valgprosedyre N
válgaortnet N: valgordning N _ valgordning N _ SAME
kulturviessu N: kulturbygg N; kulturhus N _ kulturhus N
bággonjuovvan N: tvangsslakting N _ tvangsslaktning N
giellaruhta N: språkmiddel N _ språkpenger N
eamiálbmotvuoigatvuohta N: urfolksrettighet N _ urbefolkningsrettighet N
álgoálbmotvuoigatvuohta N: urfolksrettighet N _ urbefolkningsrettighet N
boazodoallohálddahus N: reindriftsforvaltning N _ reindriftsadministrasjon N
oahppolávdegoddi N: utdanningskomite N _ studieutvalg N
eamiálbmot N: urfolk N _ urbefolkning N
álgoálbmot N: urfolk N _ urbefolkning N
bargoeaktu N: arbeidsvilkår N _ arbeidsbetingelse N
oahpahusdepartemeanta N: undervisningsdepartement N _ utdanningsdepartement N
muohtačalbmi N: snøkrystall N _ snøfnugg N
turistabáiki N: turistattraksjon N _ turiststed N
datneárpu N: metalltråd N _ tinntråd N
gurutbellodat N: venstreparti N _ venstreparti N _ SAME
riikkarádji N: landegrense N _ riksgrense N
njuovvanboazu N: slaktedyr N; slakt N _ slakterein N
skuvlavisti N: skolehus N; skolebygg N; skolebygning N _ skolebygning N
skuvlamátki N: skoleveg N; skoletur N _ skoletur N
dálkkas N: medikament N; legemiddel N; medisin N _ medisin N
bealljelasta N: øreflipp N _ det ytre øre N
juovlanigá N: nisse N; julenisse N _ julenisse N
báikkálašsearvi N: lokallag N; lokalforening N _ lokalforening N
garraduodji N: trearbeid N; tresløyd N _ sløyd N
lihkusávaldat N: gratulasjon N _ lykkeønskning N
láhttenvuohki N: handlemåte N; adferd N _ oppførsel N
areálaplána N: arealplan N _ arealplan N _ SAME
huksenbargu N: byggearbeid N _ byggearbeid N _ SAME
riikkačoahkkin N: riksmøte N; landsmøte N _ landsmøte N
čuohtejahki N: hundreår N; århundre N _ århundre N
álbmotstivra N: folkestyre N _ folkestyre N _ SAME
fágaolmmoš N: fagfolk N _ fagperson N
luonddugáhtten N: naturvern N; miljøvern N _ miljøvern N
politiijabálvá N: politimann N _ politibetjent N
dutkkus N: studie N; eksamen N _ eksamen N
niesti N: skolemat N _ niste N
guohtuneana N: beiteområde N _ beiteland N, beiteareal N
ámmát N: verv N; embete N; stilling N _ embete N, stilling N
bargodilli N: arbeidssituasjon N; arbeidsliv N; arbeidsforhold N _ arbeidsforhold N
spiidni N: purk N; gris N; svin N _ gris N, svin N
viellja N: storebror N; søsken N _ bror N
moarri N: affekt N _ vrede N, raseri N
njálggis N: godteri N _ slikkeri N
čoalli N: innvoll N; tarm N _ tarm N; lengden på garnets øverste del N
sáttu N: singel N; sand N _ sand N
unnimusmearri N: minimumsfaktor N; minstestandard N _ minimum N; minstestandard N
biergobihttá N: kjøttbit N; kjøttstykke N _ kjøttstykke N
dákti N: knokkel N; bein N _ bein N
šlápma N: ståhei N; støy N _ støy N, larm N
bátni N: tannsett N; tann N _ tann N
ođđabeairuohtta N: nyttårskveld N _ nyttårsaften N
vađđa N: sletteland N; slette N _ åpen slette med skog rundt N
máttaráddjá N: tippoldefar N _ oldefar N, stamfar N
jumeš N: tvillingpar N; tvilling N _ tvilling N
lubma N: lom N _ lomme N
hearva N: pryd N _ stas N, pynt N
superlatiiva N: superlativ N _ superlativ N _ SAME
biebmodilli N: ernæringssituasjon N; matsituasjon N; kosthold N _ matsituasjon N
lavdnjegoahti N: jordgamme N; torvgamme N _ torvgamme N
lávka N: ryggsekk N _ ransel N; bag N
sieđga N: vier N _ vidje N
boradanboddu N: matpause N _ spisepause N
boaresbárdni N: ungkar N _ gammelungkar N
náhkkebivttas N: pels N _ skinnplagg N
galmmihanrusttet N: fryseanlegg N _ kjøleanlegg N
bárehuoš N: guttunge N _ halvvoksen gutt N
visti N: paviljong N; hus N; bygning N _ hus N, bygning N
soggi N: ytterkant N _ plass innerst ved veggen N
mearrajohtolat N: skipsfart N; sjøfart N; sjøtransport N _ sjøtrafikk N
vázzinsoabbi N: spaserstokk N _ gåstav N
váikkuheapmi N: medvirkning N; påvirkning N; innflytelse N _ påvirkning N
láhtti N: gulv N; golv N _ golv N
inuihtta N: inuitt N _ inuit N
lassá N: terskel N; dørstokk N _ dørstokk N; firkantet ramme av tre N
uksabealis N: terskel N _ dørkarm N, plassen ved siden av døra N
šielbmá N: terskel N; dørstokk N _ dørstokk N
bealátkeahtesvuohta N: habilitet N _ ugildhet N
hehttehus N: hinder N; ulempe N; hindring N _ hindring N
gonagas N: kong N _ konge N
geinnodat N: trase N _ flyttevei N
šillju N: tun N; plass N _ gårdsplass N; plass N
oalgi N: nisje N _ skulder N
feaskkir N: korridor N; gang N _ bislag N, entre N, gang N
vuoibmi N: kondisjon N; makt N; styrke N _ styrke N, makt N
hivvodat N: volum N; masse N _ mengde N, masse N
opmodatvearru N: formuesskatt N; formueskatt N _ formueskatt N
dearvvuohta N: hilsen N _ hilsning N
materiála N: materiell N; materiale N _ materiale N
ruonas N: grønt N _ grønnsak N
caggi N: barriere N; bærebjelke N; støtte N _ støtte N, avstiver N
bagadeapmi N: instruksjon N; veiledning N _ rettledning N
ávvu N: jubileum N; begeistring N _ fryd N
suohkanbáhppa N: sogneprest N; sokneprest N _ sokneprest N
almmuheapmi N: utgivelse N _ offentliggjøring N
beavdeliidni N: duk N _ bordduk N
suhttu N: aggresjon N; sinne N _ sinne N
veajet N: yngel N _ fiskeyngel N
stohpogálvu N: innbo N; inventar N; møbel N _ møbel N
soadji N: ving N _ vinge N; erme N; fløy N
oktavuohta N: samhold N; forbindelse N; fellesskap N; tilknytning N _ forbindelse N, kontakt N
eallineaktu N: livsvilkår N; levevilkår N; levekår N _ levevilkår N
ođđajahki N: nyår N _ nyttår N
bázahus N: avfall N; rest N; levning N; slam N _ rest N
guhkkodat N: lengde N _ utstrekning N
oaivvuš N: utløp N _ elveos N, elveutløp N
duođalašvuohta N: virkelighet N; alvor N _ alvorlighet N
finnmárkulaš N: finnmarking N _ finnmarksværing N
huksen N: utbygging N; bygg N; bygging N _ bygging N
čilgehus N: redegjørelse N; definisjon N _ forklaring N
dihtor N: pc N; data N; datamaskin N _ datamaskin N, computer N
beaggin N: omdømme N _ rykte N
áigemearri N: frist N _ tidsfrist N
dieđihanáigemearri N: frist N; påmeldingsfrist N _ påmeldingsfrist N
duktásadji N: tuft N; hustuft N _ hustuft N; tomt N
márkanbáiki N: markedsplass N; kirkested N _ kirkested N
fidnodoaibma N: yrkesaktivitet N _ yrkesforetak N
mearreáigi N: åremål N _ termin N
meardi N: merd N _ ruse N
láse N: glas N; vindu N; glass N _ glass N, vindusrute N
oaivámuš N: høvding N _ overhode N
giliviessu N: grendehus N _ bygdehus N
herven N: dekorasjon N; ornamentikk N _ ornamentikk N
neahpi N: nevø N _ onkelbarn N; manns nevø eller niese N
gárvu N: klær N _ klesplagg N
bivttas N: klær N _ klesplagg N
oktiigullevašvuohta N: solidaritet N; samhørighet N _ tilhørighet N
ovttaseallin N: sameksistens N; samliv N _ samliv N
einnostus N: preg N; spådom N; prognose N _ spådom N; prognose N
gollu N: bekostning N; kostnad N; slitasje N; utgift N _ kostnad N; slitasje N
stašuvdna N: base N _ stasjon N
jeagil N: lav N _ reinlav N
gorži N: vannfall N; foss N _ foss N
čálgu N: velvære N; trivsel N; velferd N _ trivsel N; velferd N
siepman N: spir N; sæd N _ frø N, sæd N
prentehus N: trykkeri N; trykking N; opplag N _ trykking N
váldolávdegoddi N: hovedutvalg N _ hovedkomité N
boallu N: tast N _ knapp N
noaidi N: noaide N _ sjaman N
válla N: vald N; skrål N _ bråk N, skrål N
báikegoddi N: lokalsamfunn N _ grend N; landdistrikt N
ráŋggáštus N: sanksjon N; straff N _ straff N
álbmotallaskuvla N: folkehøyskole N _ folkehøgskole N
nammačuorvun N: opprop N; navneopprop N _ navneopprop N
čikŋa N: dekor N _ pynt N, stas N
gávpegálvu N: konsern N _ handelsvare N
mánná N: småbarn N; barn N _ barn N
lastamuorra N: lauvskog N _ løvtre N
šibitdoavttir N: veterinær N; dyrlege N _ dyrlege N
diggeriekti N: tingsrett N; tingrett N _ tingrett N
sátnevájas N: ordspråk N; ordtak N _ ordtak N
earru N: skille N; skilsmisse N; avskjed N _ avskjed N; skilsmisse N
gihppu N: sett N _ bunt N, klase N
ládju N: slått N; høyslått N _ slåttonn N
fággi N: ankerfeste N _ ryggtak N
fális N: hval N _ kval N
kruvdno N: kr. N; krone N _ krone N
dávvirvuorká N: musé N; museum N _ museum N; lager N, oppbevaringssted N
musea N: musé N; museum N _ museum N
johtolat N: ferdsel N; trafikk N _ flyttevei N; trafikk N
vuodjin N: ferdsel N; kjøring N _ kjøring N
buhtadus N: kompensasjon N; godtgjørelse N; erstatning N _ erstatning N
mátki N: reis N; reise N _ reise N
snihkkár N: håndverker N; snekker N _ snekker N
rihtu N: ras N; storm N _ skred N
uđas N: ras N _ snøskred N
kilomehter N: km N; kilometer N _ kilometer N
guovddáš N: sentral N; senter N _ sentrum N, senter N
rievssatbivdu N: rypefangst N _ rypejakt N
riegádanbeaivi N: fødselsdato N; fødselsdag N _ fødselsdag N
servodatoahppu N: samfunnskunnskap N; samfunnsfag N _ samfunnsfag N
mánnabiigá N: barnepass N _ barnevakt N
dáhpi N: sedvane N _ skikk N
vierru N: sedvane N; rutine N _ skikk N, vane N; rutine N
ovttaskasolmmoš N: enkeltperson N; enkeltmenneske N _ enkeltmenneske N
eaŋkilolmmoš N: enkeltperson N; enkeltmenneske N _ enkeltmenneske N
čállinvuohki N: ortografi N; skrivemåte N _ skrivemåte N
mearrabivdu N: sjøfiske N; fiske N _ fiske N
fievru N: transportmiddel N; framkomstmiddel N; kjøretøy N _ framkomstmiddel N
erenoamášvuohta N: spesialitet N; særpreg N _ eiendommelighet N; særpreg N
ruhtadeapmi N: finans N _ finansiering N
muorra N: trevirke N; brensel N; tre N _ tre N; ved N
davvisámegiella N: nordsamisk N _ nordsamisk A
dokumentára N: dokumentarfilm N; dokumentar N _ dokumentar N
areálageavaheapmi N: arealbruk N _ arealdisponering N
bargoveahka N: stab N; personell N _ arbeidsstyrke N
dávgeruohtu N: parentes N _ parentes N _ SAME
ruohtu N: parentes N _ parentes N _ SAME
bánno N: kjele N; kjel N _ steikepanne N
teáhterčájálmas N: teaterstykke N; teaterforestilling N _ teaterforestilling N
fágadoaba N: faguttrykk N; fagterm N _ fagterm N
háhkan N: anskaffelse N; rekruttering N _ erverv N; rekruttering N
muorraduodji N: tresløyd N _ sløyd N
dállu N: småbruk N; gård N; hus N _ gård N; hus N
goikket N: skalle N _ skalle sydd av leggskinn N
nuvttot N: skalle N _ skalle sydd av leggskinn N
finánsalávdegoddi N: finanskomité N _ finansutvalg N
rehkenastin N: oppgjør N; beregning N; regning N _ det å regne sammen N
geatnegasvuohta N: forpliktelse N; plikt N; ansvar N _ plikt N; ansvar N
allaskuvlaoahppu N: høyskoleutdanning N; høgskoleutdanning N _ høgskoleutdanning N
oljobohkan N: oljeproduksjon N; oljevirksomhet N; oljeutvinning N _ oljeboring N
válgaboađus N: valgoppgjør N; valgresultat N _ valgresultat N
vuođđooahppu N: grunnopplæring N; grunnutdanning N _ grunnutdanning N
astoáiggedoaibma N: fritidsinteresse N; fritidsaktivitet N _ hobby N, fritidssyssel N
giellaoahpahus N: språkopplæring N _ språkundervisning N
hárjehallan N: øving N; øvelse N; prøve N; trening N _ trening N; prøve N
sátnefriddjavuohta N: ytringsfrihet N _ ytringsfrihet N _ SAME
fidnooahppu N: yrkesutdanning N; yrkesopplæring N _ yrkesopplæring N
gaskaoapmi N: virkemiddel N; middel N; redskap N; verktøy N _ middel N
joatkka N: videreføring N _ forlenger N
njuikun N: vevgrind N _ hopping N; grindvev N
árvolassáneapmi N: verdiskapning N; verdiskaping N _ verdiskaping N
árvu N: verdighet N; status N; verdi N _ verdi N, verd N; status N
buresbirgejupmi N: velstand N; velferd N _ velferd N
geaidnočuovga N: vegbelysning N _ gatelys N
gáivo N: vannbrønn N; brønn N _ brønn N
dorvvuhisvuohta N: utrygghet N _ motløshet N
eretfárren N: utflytting N; fraflytting N _ fraflytting N
stuibmi N: urolighet N; opprør N _ bråk N; opprør N
bargonávccahisvuohta N: uførhet N _ arbeidsuførhet N
unohasvuohta N: ubehag N _ ubehagelighet N
hirsa N: tømmer N _ tømmerstokk N
dimbbar N: tømmer N _ tømmerstokk N
čulku N: tvangstrøye N _ kubbe N
bárru N: tsunami N; bølge N _ bølge N
smáhkkomuorra N: trestamme N _ hoggestabbe N
guovttegielalašvuođaruhta N: tospråklighetsmiddel N _ tospråklighetspenger N
lohpádus N: tilsagn N _ løfte N
heiveheapmi N: tilrettelegging N; tilpasning N _ tilpassing N
leahttu N: tempo N _ fart N
leaktu N: tempo N _ fart N, hastighet N
govvaráidu N: tegnefilm N; tegneserie N _ tegneserie N
duostilvuohta N: tapperhet N; mot N _ mot N
báhčinguovlu N: skytefelt N _ skyteområde N
báhčinšillju N: skytefelt N _ skytebane N
huikkas N: skrik N; skrål N _ vedvarende roping N
earráneapmi N: skillsmisse N; skilsmisse N _ skilsmisse N
vearrogeasus N: skattefradrag N; skattetrekk N _ skattetrekk N
vuotta N: skallebånd N; komagbånd N _ komagbånd N
iešgovva N: sjølbilde N; selvbilde N _ selvbilde N
iešstivrejupmi N: selvstyre N; autonomi N _ autonomi N
iešdieđáhus N: selvangivelse N; egenerklæring N _ egenmelding N
oktiibidjan N: sammensetning N _ sammenføyning N
áššesuorgi N: saksområde N; saksfelt N _ saksområde N
boraspirevahát N: rovvilttap N; rovdyrskade N _ rovdyrskade N
riektedilli N: rettsforhold N; rettsstilling N _ rettsstilling N, rettslig stilling N
vuorru N: rekkjefølgje N; omgang N; rekkefølge N _ tur N, omgang N; skift N
mátkeealáhus N: reiseliv N; turistnæring N _ turistnæring N
geahpádus N: reduksjon N; lettelse N _ lettelse N, minskning N
rehálašvuohta N: redelighet N _ redelighet N, ærlighet N
nállevealaheapmi N: rasediskriminering N; rasisme N _ rasisme N
cuiggodeapmi N: påpekning N; merknad N; kritikk N _ påpeking N, kritikk N
muittuhus N: påminnelse N _ påminning N
áŋgirvuohta N: pågangsmot N; innsatsvilje N; iver N; motivasjon N _ iver N
hearvabáddi N: pyntebånd N; pynteband N _ pynteband N
uvssot N: portal N _ teltdør N
máŋggaidlohku N: pluralitet N; pluralis N; flertall N _ flertall N, pluralis N
čuokkis N: pkt. N; punkt N _ prikk N, punkt N, punktum N; poeng N
geađgejuolgi N: pilar N; plattform N _ grunnmur N
searvevuohta N: partnerskap N; fellesskap N _ fellesskap N
bealli N: part N; del N _ del N, halvpart N
oasálaš N: part N; aktør N; deltaker N _ medvirkende N, partisipant N, deltaker N; deleier N
geahčastat N: oversikt N _ blikk N, øyekast N
sátneriggodat N: ordrikdom N; ordforråd N _ ordforråd N
lášmmohallan N: opptrening N; kroppsøving N; kroppsøvning N; gymnastikk N _ gymnastikk N
lohkan N: opptelling N; lesing N _ lesing N
bargojuohku N: oppgavefordeling N; arbeidsdeling N _ arbeidsdeling N
bargojuogadeapmi N: oppgavefordeling N _ arbeidsfordeling N
heahtedilli N: nødsituasjon N; krise N _ krise N, nødssituasjon N
váimmus N: nav N; kjerne N _ marg i tre N; kjerne N
moalla N: målstrek N; mål N _ mål N, blink N
njálbmi N: munning N _ munn N
multimedia N: multimedium N _ multimedia N
balaheapmi N: mistenksomhet N _ sjalusi N
muitoboddu N: minnemarkering N; minnestund N _ minnestund N
meassut N: messe N _ festlighet N
dieđihangaskaoapmi N: medium N _ media N
mielmearrideapmi N: medbestemmelse N _ medbestemmelse N _ SAME
biebmogálvu N: matprodukt N; matvare N; næringsmiddel N _ næringsmiddel N
biebmogoallus N: matkjede N; næringskjede N _ næringskjede N
lastagoahti N: løvhytte N _ løvløe N
oahppaplána N: læreplan N _ læreplanverk N
oahppoplána N: læreplan N; studieplan N; læreplanverk N _ studieplan N
geahpesdávda N: lungelidelse N; kols N _ lungesykdom N
ovttadássásašvuohta N: likeverdighet N; likeverd N; likestilling N _ likestilling N
dásseárvu N: likeverd N; likestilling N _ likestilling N
fuollameahttunvuohta N: likegyldighet N _ grov uaktsomhet N
leaksoveahkki N: leksehjelper N; leksehjelp N _ leksehjelp N
láigošiehtadus N: leieavtale N; festekontrakt N _ leiekontrakt N; festekontrakt N
láigosoahpamuš N: leieavtale N _ leiekontrakt N
bargguhisvuohta N: ledighet N; arbeidsledighet N _ arbeidsløshet N
čoarvegiella N: lassoløkke N _ lassoring av horn N, hornøgle N
riikkadássi N: landsbasis N _ riksplan N
earri N: kvote N _ mengde N
bivdoearri N: kvote N _ jaktkvote N
almmuhus N: kunngjøring N; deklarasjon N _ annonse N; deklarasjon N
kulturbargu N: kulturutøvelse N; kulturarbeid N _ kulturarbeid N
kulturdoaibma N: kulturtiltak N _ kulturaktivitet N
kulturruhta N: kulturmiddel N _ kulturpenger N
gáranasruitu N: kråkebolle N _ sjøpinnsvin N, sjøpinnsvin N
allodat N: kroppshøyde N; høyde N _ høyde N
fápmojođas N: kraftledning N _ strømledning N
ruvdna N: kr N; krone N _ krone N
ruvdno N: kr N; krone N _ krone N
kruvdnu N: kr N; krone N _ krone N
gáma N: kommag N; sko N _ fottøy N; komag N, skalle N
lávdegoddi N: komite N; utvalg N _ komité N, utvalg N; nemnd N
komitea N: komite N _ komité N
duppalčuokkis N: kolon N _ kolon N _ SAME
gáktegoarrun N: koftesying N; koftesøm N _ koftesøm N
juotna N: knep N _ list N, intrige N; disposisjon N
eanaspábba N: klode N; jordklode N; jord N _ jordklode N
biergobuvttadeapmi N: kjøttavkastning N; kjøttproduksjon N _ kjøttproduksjon N
guoddalus N: kjæremål N; anmeldelse N _ anklage N, anmeldelse N
kásus N: kasus N _ kasus N _ SAME
miessemearkun N: kalvemerking N _ reinkalvmerking N
giehtaváđđu N: juksamaskin N _ jukse N
bargovejolašvuohta N: jobbmulighet N; arbeidsmulighet N _ arbeidsmulighet N
fuolaheapmi N: ivaretakelse N; omsorg N _ omsorg N
badjelgeahččanvuohta N: intoleranse N _ overlegenhet N
jierbmi N: intelligens N; hjerne N _ forstand N, fornuft N
čuojanas N: instrument N _ musikkinstrument N
bagadus N: instruks N; veiledning N _ rettledning N
vuosteháhku N: innvending N; motstand N _ motstand N
sisaboahtovejolašvuohta N: inntektsmulighet N _ inntektsmulighet N _ SAME
cealkámuš N: innspill N; resolusjon N; utsagn N; uttalelse N _ uttalelse N; resolusjon N
hutkkus N: innovasjon N _ påfunn N
sáivaguolásteapmi N: innlandsfiske N; ferskvannsfiske N _ ferskvannsfiske N
sáivaguolli N: innlandsfisk N; ferskvannsfisk N _ ferskvannsfisk N
oastinšiehtadus N: innkjøpsavtale N; kjøpekontrakt N _ kjøpekontrakt N
gohččun N: innkalling N; kommando N; pålegg N _ innkallelse N; reskript N
gulaskuddan N: høring N _ forespørsel N
guolga N: hårlag N _ pelshår N; kroppshår N
siibma N: håndsnøre N _ fortom N
ruovttudoallu N: husholdning N; heimkunnskap N _ heimkunnskap N
dállodoallu N: hushold N; gårdsbruk N; husstand N _ husstand N
šibitdoallu N: husdyrhold N _ storfehold N
váldodoaibma N: hovedfunksjon N; hovedoppgave N _ hovedbeskjeftigelse N
váldocealkka N: hovedbudskap N; helsetning N _ hovedsetning N
čoarbbealli N: hoft N; lår N _ lår N, hofte N
ruovttubargu N: hjemmelekse N _ hjemmearbeid N
aisttonmearka N: hermetegn N _ anførselstegn N
ruovttudoallooahppu N: heimstadlære N; heimkunnskap N _ heimkunnskap N
eanahálddašeapmi N: grunnforvaltning N _ jordforvaltning N
váldočoahkkin N: generalforsamling N _ generalforsamling N _ SAME
šibitbiebmu N: fôr N; dyrefor N _ dyrefor N
ovttastupmi N: fusjon N _ sammenslutning N; koalisjon N
astoáiggeortnet N: fritidsordning N _ skolefritidsordning N
ráfáiduhttinmearrádus N: fredningsvedtak N; fredningsbestemmelse N _ fredningsbestemmelse N
govva N: foto N; bilde N; fotografi N _ bilde N
juolgenohta N: fotnote N _ fotnote N _ SAME
ovdakantuvra N: forværelse N _ forkontor N
hálddašanovddasvástádus N: forvaltningsansvar N _ forvaltningsansvar N _ SAME
ovdamunni N: fortrinn N; fordel N; privilegium N _ fordel N; privilegium N
dáruiduhttinpolitihkka N: fornorskingspolitikk N; fornorskningspolitikk N _ fornorskningspolitikk N
dáruiduhttin N: fornorsking N; fornorskning N _ fornorskning N
dajaldat N: formulering N; setning N; uttrykk N _ setning N, uttrykk N
soahpamuš N: forlik N; konvensjon N; kontrakt N; avtale N _ avtale N; kontrakt N
ovdagihtiijienasteapmi N: forhåndsstemmegivning N; forhandsstemmegivning N _ forhåndsstemming N
buorredáhttu N: forgodtbefinnende N; velvilje N _ velvilje N
veadju N: forfatning N; kraft N; evne N _ kraft N; evne N
sáhkku N: forelegg N _ mulkt N
juohku N: fordeling N _ deling N
cuvccas N: folkesagn N; myte N; eventyr N _ sagn N, eventyr N, myte N
TV-prográmma N: fjernsynsprogram N; TV-program N _ TV-program N
guollešládja N: fiskeslag N _ fiskeart N
guolleearri N: fiskerikvote N; fiskekvote N _ fiskekvote N
sámemiššuvdna N: finnemisjon N; samemisjon N _ samemisjon N
sorbmi N: fare N; død N _ noe livsfarlig N; dødsulykke N
várra N: fare N; risiko N _ forsiktighet N
bivdoroggi N: fangstgrop N _ dyregrav N
rehket N: faktura N; regning N _ regning N
guite N: faktura N _ kvittering N
árvvoštallan N: evaluering N; anmeldelse N; vurdering N; kritikk N _ anmeldelse N, kritikk N, vurdering N
ovttaidlohku N: entall N _ entall N, singularis N
vuorrádus N: engstelse N; uro N _ knipe N
geažus N: endelse N _ endelse N _ SAME
náitaleapmi N: ekteskapsinngåelse N _ giftemål N
eallinvuođđu N: eksistensgrunnlag N; livsgrunnlag N _ livsgrunnlag N
birgenláhki N: eksistensgrunnlag N; levekår N; livsgrunnlag N _ levekår N
iešvuohta N: egenart N; egenskap N _ egenskap N
duodjedoaibma N: duodjivirksomhet N; formingsaktivitet N _ formingsaktivitet N
hádja N: duft N; lukt N _ lukt N
readdju N: dress N; frakk N; jakke N _ jakke N, frakk N
skearru N: diskos N; plate N _ rund skive N; grammofonplate N
oalli N: dimensjon N _ djupål N; bakstykke N
oassemáksu N: delutbetaling N _ avdrag N
bursa N: børs N _ pengepung N
čalbmeláset N: brille N _ briller N
bielká N: bordtak N _ bjelke N
govvadáidda N: billedkunst N _ bildekunst N
báktedoaibma N: bergverksvirksomhet N; bergverk N _ bergverk N
gálssot N: belling N _ vinterbelling N
biddu N: belling N _ vinterbelling for kvinner N; leggvarmer N
noađđi N: belastning N; byrde N _ bør N, byrde N
ágga N: begrunnelse N; argument N; grunn N _ unnskyldning N; argument N
buorádus N: bedring N; forbedring N _ forbedring N; omvendelse N
vuojadanálddis N: basseng N _ svømmebasseng N
mánáidsuodjalanbálvalus N: barnevernstjeneste N _ barnevernstjeneste N _ SAME
jienastanortnet N: avstemmingsmåte N; avstemningsordning N _ voteringsrekkefølge N
bargolohpi N: arbeidstilltalelse N; arbeidstillatelse N _ arbeidstillatelse N
bargoráfi N: arbeidsro N _ arbeidsfred N
bargodienas N: arbeidsinntekt N; arbeidsfortjeneste N _ arbeidsfortjeneste N
áppes N: abc-bok N _ ABC-bok N
bargoduogáš N: yrkeserfaring N; arbeidserfaring N; praksis N _ praksis N
bargovásihus N: yrkeserfaring N; arbeidserfaring N _ arbeidserfaring N
nuoraiddássi N: ungdomstrinn N _ ungdomstrinn N _ SAME
lullisápmi N: sørsameområde N; sørsame N _ sørsame N
oppalašárvosátni N: standpunktvurdering N; standpunktkarakter N _ standpunktkarakter N
gielladoaibma N: språktiltak N; språkarbeid N _ språkaktivitet N
njuolggadus N: retningslinje N; regel N _ regel N
boazodoallovuoigatvuohta N: reindriftsrett N; reindriftsrettighet N _ reindriftsrettighet N, rett til å utøve reindrift N
ovdasiidogovva N: omslagsbilde N; forsidebilde N _ forsidebilde N
heahteveahkki N: nødhjelp N; førstehjelp N _ førstehjelp N
birasgáhttendepartemeanta N: miljøverndepartement N _ miljødepartement N
olmmošárvu N: menneskeverd N _ menneskeverd N _ SAME
eanavuovdinláhka N: jordslagslov N _ jordsalgslov N
álgosátni N: innledning N; forord N _ forord N
bálká N: honorar N; betaling N; lønn N _ betaling N
ovdasátni N: føreord N; forord N _ forord N
girdijohtolat N: flytrafikk N _ lufttrafikk N
fágasuorgi N: fagområde N _ fagfelt N
sohkardávda N: diabetes N _ sukkersyke N
bázzi N: skulptur N; støtte N _ monument N, støtte N
biire N: krets N; reinbeitedistrikt N _ reinbeitedistrikt N
bierggas N: gjenstand N; ting N; sak N; utstyr N _ ting N, sak N; genitalia N
dávvir N: gjenstand N; eiendel N; skatt N; verdi N; utstyr N _ eiendel N, skatt N, verdi N
rávesolmmoš N: voksen A _ voksen A _ SAME
ollesolmmoš N: voksen A _ voksen A _ SAME
jugus N: drikke N _ drikke N _ SAME
juhkamuš N: drikke N _ drikk N
siskkoš N: innmat N _ det indre N
šilta N: skilt N _ skilt N _ SAME
galba N: skilt N _ nederste del av reinhorn N; skilt N; skjold N
skuvlamánná N: elev N; skolebarn N _ skolebarn N
návdi N: pelsdyr N; rovdyr N; ulv N _ rovdyr N; ulv N
skeittá N: skøyte N _ skøyte N _ SAME
luiste N: skøyte N _ skøyte N _ SAME
assisteanta N: assistent N _ assistent N _ SAME
sávzanávet N: sauefjøs N _ sauefjøs N _ SAME
preterihtta N: fortid N _ preteritum N, fortid N
sektor N: sektor N _ sektor N _ SAME
suorgi N: sektor N; linje N; område N _ forgreining N, linje N; felt N
skuvlaálgin N: skolestart N _ skolestart N _ SAME
eastadanbargu N: forebyggingsarbeid N _ forebyggingsarbeid N _ SAME
mihtilmasvuohta N: særpreg N _ særegenhet N, særtrekk N
dánsa N: dans N _ dans N _ SAME
dánsun N: dans N _ dansing N
bohtal N: flaske N _ flaske N _ SAME
latiidna N: latin N _ latin N _ SAME
latiinnagiella N: latin N _ latinsk N
lagasvuohta N: nærhet N _ nærhet N _ SAME
lahkavuohta N: nærhet N _ nærhet N _ SAME
kondoma N: kondom N _ kondom N _ SAME
hoidu N: opplegg N _ opplegg N _ SAME
disposišuvdna N: disposisjon N _ disposisjon N _ SAME
dramatihkar N: dramatiker N _ dramatiker N _ SAME
duottarskuvla N: fjellskole N _ fjellskole N _ SAME
balddonasmuitalus N: spøkelseshistorie N _ spøkelseshistorie N _ SAME
astu N: fritid N _ fritid N _ SAME
astoáigi N: fritid N _ fritid N _ SAME
friddjaáigi N: fritid N _ fritid N _ SAME
sihkkeloaivesuodji N: sykkelhjelm N _ sykkelhjelm N _ SAME
servodatviessu N: samfunnshus N _ samfunnshus N _ SAME
njuorjju N: kobbe N; sel N _ sel N, kobbe N
njuorju N: kobbe N; sel N _ sel N, kobbe N
láseráigi N: vindu N _ vindu N _ SAME
glássa N: vindu N; glass N _ vindu N; glass N _ SAME
čoavddus N: fasit N; løsning N _ fasit N, løsning N
čoavddagirji N: fasit N _ fasit N _ SAME
boallobeavdi N: tastatur N _ tastatur N _ SAME
grammatihkka N: grammatikk N _ grammatikk N _ SAME
johttisápmelaš N: flyttsame N _ flyttsame N _ SAME
johttisápmi N: flyttsame N _ flyttsame N _ SAME
badjeolmmoš N: flyttsame N; reindriftssame N; reineier N _ reindriftssame N
bargiidbellodat N: arbeiderparti N _ arbeiderparti N _ SAME
instituhtta N: institutt N _ institutt N _ SAME
vuordámuš N: forventning N _ forventning N _ SAME
stivrralahttu N: styremedlem N _ styremedlem N _ SAME
mánnávuohta N: barndom N _ barndom N _ SAME
hommá N: tiltak N _ tiltak N, gjøremål N
doaibma N: tiltak N; drift N; funksjon N; virksomhet N; aktivitet N; oppgave N; handling N; oppdrag N _ virksomhet N, gjøremål N, aktivitet N; drift N; tiltak N
doaibmabidju N: tiltak N _ tiltak N _ SAME
justiisalávdegoddi N: justiskomité N _ justiskomité N _ SAME
olmmošlohku N: innbyggertall N; folketall N _ innbyggertall N
militeara N: militær N _ militær N _ SAME
váidalus N: klage N _ klage N, anklage N
moaitámuš N: klage N; kritikk N _ bebreidelse N, klage N
moaitta N: klage N; kritikk N _ klage N
váidda N: klage N _ anklage N
bivdinjoavku N: jaktlag N _ jaktlag N _ SAME
bivdojoavku N: jaktlag N _ jaktlag N _ SAME
valáštallansearvi N: idrettslag N _ idrettslag N _ SAME
rámbuvra N: butikk N _ butikk N _ SAME
rámbuvri N: butikk N _ butikk N _ SAME
buvda N: butikk N _ butikk N _ SAME
gávpi N: butikk N; salg N; handel N _ handel N; forretning N
el-rávdnji N: elektrisitet N; strøm N _ elektrisitet N
elrávdnji N: elektrisitet N; strøm N _ elektrisitet N, strøm N
šleađga N: elektrisitet N; strøm N _ strøm N; elektrisitet N
stivrenjoavku N: styringsgruppe N _ styringsgruppe N _ SAME
luonddugáhttenlihttu N: naturvernforbund N _ naturvernforbund N _ SAME
luonddugáhttensearvi N: naturvernforbund N _ miljøvernforening N
boahttevuohta N: framtid N; fremtid N _ framtid N
boahtteáigi N: framtid N; fremtid N _ fremtid N
birasgáhttenministtar N: miljøvernminister N _ miljøvernminister N _ SAME
jahkečuohti N: århundre N _ århundre N _ SAME
boazodoalloeiseváldi N: reindriftsmyndighet N _ reindriftsmyndighet N _ SAME
mirko N: gift N _ gift N _ SAME
gielladilli N: språksituasjon N _ språksituasjon N _ SAME
miellačájeheapmi N: demonstrasjon N _ demonstrasjon N _ SAME
miellačájáhus N: demonstrasjon N _ demonstrasjon N _ SAME
fuorrágávppašeapmi N: prostitusjon N _ prostitusjon N _ SAME
nuorravuohta N: ungdom N _ ungdom N _ SAME
nuorra N: ungdom N _ ungdom N _ SAME
birasgáhtten N: miljøvern N _ miljøvern N _ SAME
loahppaboahtu N: sluttprodukt N _ sluttprodukt N _ SAME
bargoskihpár N: kollega N _ kollega N _ SAME
bargoskibir N: kollega N _ kollega N _ SAME
bargoustit N: kollega N _ kollega N _ SAME
stuorradiggi N: storting N _ storting N _ SAME
vihki N: sykdom N; feil N _ feil N; sykdom N
buohcu N: sykdom N _ sykdom N _ SAME
buozalmas N: sykdom N _ sykdom N _ SAME
dávda N: sykdom N _ sykdom N _ SAME
buozanvuohta N: sykdom N _ sykdom N _ SAME
jaskatvuohta N: stillhet N _ stillhet N _ SAME
jávohisvuohta N: stillhet N; taushet N _ taushet N
dutkanásahus N: forskningsinstitusjon N _ forskningsinstitusjon N _ SAME
logijahki N: tiår N _ tiår N _ SAME
meašttirgilvu N: mesterskap N _ mesterskap N _ SAME
duhátjahki N: tusenår N _ tusenår N _ SAME
jahkeduhát N: tusenår N _ årtusen N
dáhton N: dato N _ dato N _ SAME
vuosttaškonsuleanta N: førstekonsulent N _ førstekonsulent N _ SAME
gieldadepartemeanta N: kommunaldepartement N _ kommunaldepartement N _ SAME
biebmoluossa N: oppdrettslaks N _ oppdrettslaks N _ SAME
ámmátskuvla N: yrkesskole N _ yrkesskole N _ SAME
ovdánahttinfitnodat N: utviklingsselskap N _ utviklingsselskap N _ SAME
eanavuoigatvuohta N: landrettighet N _ landrettighet N _ SAME
eananvuoigatvuohta N: landrettighet N _ jordrettighet N
álbmotbellodat N: folkeparti N _ folkeparti N _ SAME
bivdovuohki N: fangstmetode N _ fangstmetode N _ SAME
sámegielmáhttu N: samiskkunnskap N _ samiskkunnskap N _ SAME
geavahanvuoigatvuohta N: bruksrettighet N; bruksrett N _ bruksrettighet N
geavahanriekti N: bruksrettighet N; bruksrett N _ bruksrett N
valáštallan N: idrett N _ sport N, idrett N
faláštallan N: idrett N _ idrett N _ SAME
lasáhus N: tillegg N; økning N _ tillegg N
lasiheapmi N: tillegg N _ tillegg N _ SAME
lassi N: tillegg N _ tillegg N; aksessorisk A
boastakantuvra N: postkontor N _ postkontor N _ SAME
olgoriikkaministtar N: utenriksminister N _ utenriksminister N _ SAME
boranávdevahát N: rovdyrskade N _ rovdyrskade N _ SAME
hálddašanvuoigatvuohta N: forvaltningsrett N _ forvaltningsrett N _ SAME
dearvvašvuođabearráigeahčču N: helsetilsyn N _ helsetilsyn N _ SAME
láhkačeahppi N: jurist N _ jurist N _ SAME
giellamáhttu N: språkkunnskap N _ språkkunnskap N _ SAME
sátnevuorká N: ordforråd N _ ordforråd N _ SAME
oktiičaskin N: sammenslåing N _ sammenslåing N _ SAME
válgalistu N: valgliste N _ valgliste N _ SAME
dásseárvobargu N: likestillingsarbeid N _ likestillingsarbeid N _ SAME
sárdneolmmái N: predikant N _ predikant N _ SAME
oamastus N: eie N; eierskap N _ eie N
johtu N: bevegelse N; gang N _ fart N, bevegelse N, gang N
lihkastat N: bevegelse N _ bevegelse N _ SAME
lihkadus N: bevegelse N _ rørelse N, åndelig bevegelse N
reasta N: rest N _ rest N _ SAME
máŋggabealatvuohta N: mangfoldighet N; mangfold N _ mangfoldighet N
giittus N: takk N _ takk N _ SAME
giitu N: takk N _ takk N _ SAME
giittos N: takk N _ takk N _ SAME
giitámuš N: takk N _ noe å takke for N
luonddumeahcci N: naturreservat N _ naturreservat N _ SAME
luonddureserváhtta N: naturreservat N _ naturreservat N _ SAME
gelddolašvuohta N: spenning N _ spenning N _ SAME
gealdda N: spenning N _ spenning N _ SAME
ambulánsabálvalus N: ambulansetjeneste N _ ambulansetjeneste N _ SAME
stádagirku N: statskirke N _ statskirke N _ SAME
sosiálabálvalus N: sosialtjeneste N _ sosialtjeneste N _ SAME
restoráŋŋa N: restaurant N _ restaurant N _ SAME
láhkateaksta N: lovtekst N _ lovtekst N _ SAME
dáhkádusfitnodat N: forsikringsselskap N _ forsikringsselskap N _ SAME
vuoiŋŋamašvardin N: hjerneblødning N _ hjerneblødning N _ SAME
gudneáŋgirvuohta N: ambisjon N _ ambisjon N, ærgjerrighet N
idjadanruhta N: nattillegg N _ nattillegg N _ SAME
almmolašvuođaláhka N: offentlighetslov N _ offentlighetsloven N
aláš N: bakketopp N; høyde N _ høyde N, bakketopp N
várrečohkka N: bakketopp N; fjelltopp N _ fjelltopp N
amasgiella N: fremmedspråk N _ fremmedspråk N _ SAME
vierrogiella N: fremmedspråk N _ fremmedspråk N _ SAME
arvevuovdi N: regnskog N _ regnskog N _ SAME
arvi N: regn N _ regn N _ SAME
arvedálki N: regn N _ regnvær N
atnu N: bruk N; nytte N _ bruk N, nytte N
geavaheapmi N: bruk N _ bruk N _ SAME
geavahus N: bruk N; konsum N; praksis N _ bruk N; konsum N
doallu N: bruk N; drift N; driftsenhet N _ driftsenhet N; drift N
atnudiŋga N: bruksting N _ bruksting N _ SAME
atnubierggas N: bruksting N _ bruksgjenstand N
baika N: skit N _ skit N _ SAME
dušši N: skit N; tull N _ ingenting N, bagatell N
bajoščáhci N: overflatevann N _ overflatevann N _ SAME
bargofápmodoaimmahat N: arbeidsmarkedsetat N _ arbeidsmarkedsetat N _ SAME
bargofápmu N: arbeidskraft N _ arbeidskraft N _ SAME
bargoheaitta N: streik N _ streik N _ SAME
bargohárjáneapmi N: arbeidserfaring N; erfaring N _ arbeidserfaring N
bargovásáhus N: arbeidserfaring N; erfaring N _ arbeidserfaring N
bargosadji N: arbeidsplass N _ arbeidsplass N _ SAME
bargu N: arbeid N; oppgave N; oppdrag N _ arbeid N
vahkkoloahppa N: helg N _ helg N _ SAME
bassi N: helg N; helligdag N _ helligdag N; helg N
beaktu N: effekt N _ effekt N _ SAME
oassi N: del N; utdrag N; passus N; andel N _ del N; passus N; akt N; lodd N
gáhppálat N: del N; eksemplar N _ stykke N, del N
oasáš N: del N _ liten del N
bealátvuohta N: inhabilitet N _ inhabilitet N _ SAME
beanna N: penn N _ penn N _ SAME
beanná N: penn N _ penn N _ SAME
peanna N: penn N _ penn N _ SAME
veahka N: familie N; makt N; styrke N _ styrke N, makt N; mannskap N; familie N
bearaš N: familie N _ familie N _ SAME
joavku N: familie N; husstand N; flokk N; gruppe N _ flokk N, gruppe N; lag N; husstand N
fuolki N: familie N; slektning N _ slektning N
bearjadat N: fredag N _ fredag N _ SAME
beroštupmi N: interesse N; omsorg N; engasjement N _ omsorg N, interesse N; engasjement N
beroštusriidu N: interessekonflikt N _ interessekonflikt N _ SAME
beroštusvuostálasvuohta N: interessemotsetning N _ interessemotsetning N _ SAME
biebmolassi N: matauk N _ matauk N _ SAME
biebmováhnen N: fosterforelder N _ fosterforelder N _ SAME
bietna N: detalj N _ detalj N _ SAME
bievla N: barmark N _ barmark N _ SAME
bihttá N: lekse N; utdrag N; bit N _ stykke N, bit N; lekse N; utdrag N
leaksu N: lekse N _ lekse N _ SAME
ruovttubihttá N: lekse N _ hjemmeoppgave N
bihttábordin N: puslespill N _ puslespill N _ SAME
biibbalhistorjá N: bibelhistorie N _ bibelhistorie N _ SAME
orohat N: reinbeitedistrikt N; distrikt N _ boplass N; oppholdssted N; reinbeitedistrikt N
biras N: miljø N; omslag N _ miljø N, omgivelse N; del av mannslue N; kulisse N; omslag N
birgendássi N: levestandard N _ levestandard N _ SAME
eallindássi N: levestandard N _ levestandard N _ SAME
bivdda N: anmodning N; bønn N _ bønn N; anmodning N
ávžžuhus N: anmodning N; anbefaling N _ oppfordring N, anbefaling N
huksehus N: bygg N; konstruksjon N _ bygg N; konstruksjon N _ SAME
bivgi N: bygg N _ bygg N _ SAME
bláđđi N: magasin N; blad N _ blad N, magasin N
boaldámuš N: brensel N; drivstoff N _ brensel N; brennstoff N, drivstoff N
boanda N: bonde N _ bonde N _ SAME
boarrásiidsiida N: aldershjem N _ aldershjem N _ SAME
čoahkkinortnet N: dagsorden N; forretningsorden N _ dagsorden N, forretningsorden N
áššelistu N: dagsorden N; saksliste N _ saksliste N, dagsorden N, møtekart N
bohcci N: rør N _ rør N, sugerør N; nålfutteral N
revre N: rør N _ rør N _ SAME
boraspire N: rovdyr N _ rovdyr N _ SAME
náhkki N: skinn N _ skinn N, hud N
sisti N: skinn N _ garvet skinn N
borgi N: skinn N _ skinn N _ SAME
buhtadas N: godtgjørelse N _ erstatning N, godtgjørelse N, vederlag N
buohcceviessu N: sykehus N _ sykehus N _ SAME
báhkin N: hedning N _ hedning N _ SAME
báhkka N: varme N _ varme N, hete N
bázahas N: levning N _ levning N _ SAME
bážan N: skytevåpen N _ skytevåpen N _ SAME
deaddu N: press N; vekt N _ tyngde N, vekt N; press N, trykk N
deatta N: press N _ vekt N, trykk N, press N
deappu N: tare N _ brunalge N, tare N
dárra N: tare N _ tare N _ SAME
dearvvašvuohta N: helse N _ helse N _ SAME
diida N: overtro N _ overtro N _ SAME
tiida N: overtro N; forestilling N _ forestilling N, overtro N
dikšu N: terapi N; behandling N _ pleie N; terapi N
dilli N: forhold N; situasjon N _ forhold N, tilstand N
dilálašvuohta N: forhold N; anledning N; situasjon N; omstendighet N _ anledning N; forhold N, tilstand N
gaskavuohta N: forhold N; relasjon N _ forhold N, relasjon N
gorri N: forhold N; relasjon N _ proporsjon N; relasjon N
liiba N: anledning N _ sjanse N, høve N
čoaltu N: klump N _ klump N _ SAME
doahkki N: klump N _ klump N; fugleflokk N
duoggi N: klump N _ klump N _ SAME
doarjjastivra N: tilskuddsstyre N _ tilskuddsstyre N _ SAME
doavttirskuvla N: medisinstudium N _ medisinstudium N _ SAME
dolgi N: fjær N _ fjær N _ SAME
dávgi N: fjær N _ bue N; fjær N
dorski N: torsk N _ torsk N _ SAME
duopmu N: dom N _ dom N _ SAME
duođaštus N: attest N; dokumentasjon N; bekreftelse N _ bekreftelse N, bevitnelse N; attest N; bevis N, dokumentasjon N
bargoduođaštus N: attest N _ arbeidsattest N
dáhpedorbmi N: tilfelle N _ tilfelle N _ SAME
dáhpáhus N: tilfelle N; hendelse N _ hendelse N
dáhttu N: ønske N; vilje N _ ønske N, vilje N
árji N: ønske N _ ønske N, trang N
sávaldat N: ønske N _ ønske N _ SAME
háliidus N: ønske N _ lengsel N, lyst N
oapmi N: eiendel N; ting N _ eiendel N, ting N; kreatur N
eadni N: mor N _ mor N _ SAME
eallinvuohki N: levesett N; levemåte N; livsstil N _ levesett N, levemåte N, livsstil N
ealáhus N: næringsvei N; næring N; næringsliv N _ næring N, næringsvei N
eanaeaiggát N: grunneier N _ grunneier N _ SAME
eana N: land N; jord N; eiendom N _ jord N, jorde N; land N, mark N; eiendom N
nannán N: land N; fastland N _ fastland N; kontinent N
eatnanmuorji N: jordbær N _ jordbær N _ SAME
eananmuorji N: jordbær N _ jordbær N _ SAME
rávdnji N: strøm N; strøm N _ strøm N
erohus N: forskjell N; avvik N _ forskjell N
evttohanvuoigatvuohta N: forslagsrett N _ forslagsrett N _ SAME
evttohas N: kandidat N _ kandidat N; kandidatur N
kandidáhtta N: kandidat N _ kandidat N _ SAME
evttohus N: forslag N _ forslag N _ SAME
árvalus N: forslag N; tanke N; innstilling N _ tanke N; forslag N
eŋgelasgiella N: engelsk N _ engelsk språk N
eaŋgalasgiella N: engelsk N _ engelsk språk N
fidnu N: yrke N _ yrke N, beskjeftigelse N
fylkkadiggi N: fylkesting N _ fylkesting N _ SAME
gárri N: fat N _ fat N; trau N
fáhtta N: fat N _ fat N _ SAME
lihtti N: fat N; kar N _ kjørel N, kar N, kopper N
fálaldat N: tilbud N _ tilbud N _ SAME
fárru N: følge N; reisefølge N _ følge N, reisefølge N
čuovus N: følge N; følgeskriv N; konsekvens N _ følgeskriv N; følge N
garra N: skall N _ skall N, skorpe N
skálžu N: skall N; skjell N _ skjell N
gaska N: mellomrom N; opphold N; avstand N _ mellomrom N, avstand N
loapmi N: mellomrom N; åpning N _ åpning N, mellomrom N
ruhta N: middel N _ penge N
gažaldatskovvi N: spørreskjema N _ spørreskjema N _ SAME
geahččalanprošeakta N: prøveprosjekt N _ prøveprosjekt N _ SAME
geaidnu N: vei N; veg N _ vei N, veg N
luodda N: vei N; veg N _ spor N, vei N
máđidja N: vei N; løype N _ vei N, fast løype N
máđii N: vei N _ vei N, fast løype N
raŧŧi N: vei N; veg N _ vei N, veg N, vintervei N
bálggis N: vei N; veg N _ sti N; veg N
geardi N: etasje N; generasjon N; gang N _ gang N; etasje N; aldersklasse N
gearggusvuohta N: beredskap N _ beredskap N _ SAME
geasus N: fradrag N _ fradrag N _ SAME
geađgi N: stein N _ stein N _ SAME
geres N: pulk N _ pulk N _ SAME
giddagas N: fengsel N _ fengsel N _ SAME
giehtačála N: håndskrift N _ håndskrift N _ SAME
giehtačálus N: manus N _ manus N _ SAME
giella N: språk N _ språk N; snare N
giellaguovddáš N: språksenter N _ språksenter N _ SAME
giellakursa N: språkkurs N _ språkkurs N _ SAME
giellagursa N: språkkurs N _ språkkurs N _ SAME
sámegielgursa N: språkkurs N; samiskkurs N _ samiskkurs N
gievdni N: kjel N; bøtte N _ bøtte N, kjel N
váivi N: plage N _ besvær N, plage N
giksi N: plage N; bryderi N _ plage N
šuokŋa N: klang N; tone N; melodi N _ klang N
gilkkas N: klang N _ klang N _ SAME
skádja N: klang N _ ekko N; etterklang N
gilli N: bygd N _ bygd N _ SAME
gillámuš N: lidelse N _ lidelse N _ SAME
girdibileahtta N: flybillett N _ flybillett N _ SAME
lávvomuorra N: teltstang N _ teltstang til lavvo N
goahtemuorra N: teltstang N _ teltstang N _ SAME
goahti N: gamme N _ gamme N; vintertelt N
goalmmádas N: tredjedel N _ tredjedel N, tredel N
goargu N: heder N; etternavn N _ stas N, heder N; familienavn N
gudni N: heder N; ære N _ ære N
goavki N: gløtt N; åpning N _ gløtt N, åpning N
gohppu N: kopp N _ kopp N _ SAME
kohppa N: kopp N _ kopp N _ SAME
goldin N: drivgarnfiske N _ drivgarnsfiske N
gore N: kurv N _ kurv N _ SAME
mársu N: kurv N _ kurv N _ SAME
gudji N: gate N; passasje N _ gate N, passasje N
gáhta N: gate N _ gate N _ SAME
gulloapparáhtta N: høreapparat N _ høreapparat N _ SAME
guolbba N: slette N _ slette N, mo N
jalga N: slette N _ slette N _ SAME
guolenáhkki N: fiskeskinn N _ fiskeskinn N _ SAME
čuopma N: fiskeskinn N _ fiskeskinn N _ SAME
guollerusttet N: fiskebruk N _ fiskebruk N _ SAME
guolli N: fisk N _ fisk N _ SAME
guolásteapmi N: fiskeri N; fiske N _ fiskeri N; fiske N _ SAME
guolástus N: fiskeri N; fiske N _ fiske N
guolástuspolitihkka N: fiskeripolitikk N _ fiskeripolitikk N _ SAME
guovllustivra N: områdestyre N _ områdestyre N _ SAME
guovlu N: reinsogn N; retning N; område N; distrikt N; region N; areal N; territorium N _ trakt N, distrikt N; område N; reinsogn N; retning N
boazosuohkan N: reinsogn N; reindriftskommune N _ reindriftskommune N
gáffeboddu N: kaffepause N _ kaffepause N _ SAME
gáfeboddu N: kaffepause N _ kaffepause N _ SAME
gáffádat N: kafe N _ kafe N _ SAME
kaféa N: kafe N _ kafé N
gáibádus N: fordring N; krav N _ krav N; fordring N
gálbi N: kalv N _ kalv N _ SAME
miessi N: kalv N _ reinkalv N
gálvu N: vare N; produkt N _ vare N, bagasje N
gáržžideapmi N: begrensning N; restriksjon N _ begrensning N, restriksjon N
hoavda N: sjef N; leder N _ leder N, sjef N
njunuš N: sjef N; ledelse N _ tet N, ledelse N, fortropp N
hálddahus N: administrasjon N _ administrasjon N _ SAME
hárjehus N: øvelse N _ øvelse N _ SAME
iešdovdu N: selvfølelse N _ selvfølelse N _ SAME
iešluohttámuš N: selvtillit N _ selvtillit N _ SAME
iešsorbmen N: selvmord N _ selvmord N _ SAME
iešsuodjalus N: selvforsvar N _ selvforsvar N _ SAME
ipmil N: gud N _ gud N _ SAME
ipmilbálvalus N: gudstjeneste N _ gudstjeneste N _ SAME
áddejupmi N: forståelse N; oppfatning N; syn N _ syn N, forståelse N
ipmárdus N: forståelse N; oppfatning N _ forståelse N
jahkebargu N: årsverk N _ årsverk N _ SAME
jahkodat N: årgang N; årssyklus N _ årstid N; årssyklus N; årgang N
jienastanvuoigatvuohta N: stemmerett N _ stemmerett N _ SAME
jienasteapmi N: avstemning N _ avstemning N _ SAME
johttisámedilli N: reinnomadisme N _ reinnomadisme N _ SAME
jorbodat N: sirkel N _ runding N, sirkel N
gierdu N: sirkel N; ring N _ ring N, runding N; linebøyel N; spektrum N
čiekčanspábba N: fotball N _ fotball N _ SAME
juolgespábba N: fotball N _ fotball N _ SAME
spábbačiekčan N: fotball N _ fotballkamp N
juovlamuorra N: juletre N _ juletre N _ SAME
juovlabeahci N: juletre N _ julefuru N
juovlamánnu N: desember N _ desember N _ SAME
juvla N: hjul N _ hjul N _ SAME
ráhtis N: hjul N _ hjul N _ SAME
kaleanddar N: kalender N _ kalender N _ SAME
kantiidna N: kantine N _ kantine N _ SAME
boradanlatnja N: kantine N _ spiserom N
kaseahtta N: kassett N _ kassett N _ SAME
jietnabáddi N: kassett N _ lydbånd N
kilo N: kilo N _ kilo N _ SAME
konferánsa N: konferanse N _ konferanse N _ SAME
konfirmašuvdna N: konfirmasjon N _ konfirmasjon N _ SAME
konvenšuvdna N: konvensjon N _ konvensjon N _ SAME
kulturmuitoláhka N: kulturminnelov N _ kulturminneloven N
kulturmuitosuodjaleapmi N: kulturminnevern N _ kulturminnevern N _ SAME
lasseárvodivat N: merverdiavgift N _ merverdiavgift N _ SAME
latnja N: sprekk N; rom N; lokale N; åpning N _ rom N; sprekk N; åpning N
sálvu N: sprekk N _ sprekk N; fuge N
leahki N: dal N _ dal N _ SAME
vággi N: dal N _ dal N, liten dalsenkning N
leahpu N: fred N; ro N _ fred N, ro N
ráfi N: fred N _ fred N _ SAME
máššu N: ro N _ ro N _ SAME
leahttorádji N: fartsgrense N _ fartsgrense N _ SAME
loatna N: lån N _ lån N _ SAME
lokta N: loft N _ loft N _ SAME
luohkká N: klasse N _ klasse N; bakke N; skåkbue N
ceahkki N: klasse N; grad N; trinn N _ trinn N; grad N
luohkkáceahkki N: klassetrinn N _ klassetrinn N _ SAME
luođđa N: kule N; skudd N _ kule N
šládja N: slag N; type N; art N; art N _ slag N, sort N
lágáš N: slag N _ slag N _ SAME
láhkaásahus N: forskrift N _ forskrift N _ SAME
láseliidni N: gardin N _ gardin N _ SAME
lássaliidni N: gardin N _ gardin N _ SAME
lávlla N: sang N _ sang N _ SAME
lávlu N: sang N; sanger N _ sang N
lávlun N: sang N _ synging N
olmmái N: venn N; mann N; kamerat N _ mann N; venn N, kamerat N
lávvi N: venn N _ god kjenning N, venn N
skihpár N: venn N; kamerat N _ kamerat N, venn N
skibir N: venn N; kamerat N _ venn N, kamerat N
ustit N: venn N; kamerat N _ venn N, kamerat N
mearka N: merke N; signal N; reinmerke N; tegn N; tegn N; tegn N _ merke N, signal N; fiskemed N
mearragáddi N: kyst N _ kyst N _ SAME
riddu N: kyst N _ kyst N; strand N
miehtebiegga N: medvind N _ medvind N _ SAME
mielddus N: følgeskriv N; vedlegg N _ følgeskriv N, vedlegg N
miella N: sinn N _ sinn N; humør N; lyst N
miestta N: busk N _ busk N _ SAME
mihttomearri N: målsetting N; mål N _ målsetting N
miila N: mil N _ mil N _ SAME
mokta N: optimisme N; motivasjon N _ humør N, optimisme N; motivasjon N
muitalus N: fortelling N; historie N _ fortelling N
máinnas N: fortelling N; eventyr N _ eventyr N
muohta N: snø N _ snø N _ SAME
máhcastat N: brett N _ fold N, brett N
máhttu N: ferdighet N; kunnskap N; kompetanse N; kvalifikasjon N _ kunnskap N, ferdighet N; kvalifikasjon N
mánáidskuvla N: barneskole N _ barneskole N _ SAME
márkan N: kirkested N; marked N; tettsted N _ marked N; kirkested N, tettsted N
nieida N: jente N; datter N _ jente N; datter N _ SAME
nieidamánná N: jente N _ jentebarn N
niestelávka N: nistesekk N _ nistesekk N, matransel N
njealjádas N: fjerdedel N _ fjerdedel N _ SAME
náittosgovva N: bryllupsbilde N _ brudebilde N, bryllupsbilde N
oaidnu N: synspunkt N; syn N _ syn N; synspunkt N
olmmoščearda N: folkeslag N; nasjon N _ folkeslag N; nasjon N _ SAME
ortnet N: orden N; orden N; ordning N _ orden N
skihkka N: orden N _ skikk N; orden N
ovdagoddi N: formannskap N _ formannskap N _ SAME
ovdagovva N: ideal N; forbilde N _ ideal N
ovdaolmmoš N: formann N; leder N _ leder N, formann N, forkvinne N
ovttasbargu N: samarbeid N _ samarbeid N _ SAME
paneladigaštallan N: paneldebatt N _ paneldebatt N _ SAME
prošeakta N: prosjekt N _ prosjekt N _ SAME
raddi N: bryst N _ bryst N; barm N
čižži N: bryst N; pupp N _ kvinnebryst N
rektor N: rektor N _ rektor N _ SAME
riika N: rike N _ rike N _ SAME
roaiská N: pisk N _ pisk N _ SAME
spihčá N: pisk N _ svepe N
roaškkas N: rabalder N _ smelling N, rabalder N
ruhtagollu N: utgift N _ utgift N _ SAME
olggosgollu N: utgift N _ utgift N _ SAME
rumaš N: kropp N _ legeme N, kropp N
gorut N: kropp N _ skrott N
ruoŧagiella N: svensk N _ svensk N _ SAME
rusttet N: installasjon N; byggverk N; anlegg N _ anordning N, installasjon N, anlegg N; byggverk N; etablissement N
ráhkkanas N: innretning N; greie N _ innretning N, greie N
ráhpi N: slam N _ slam N, søle N
rášša N: høyfjellsområde N _ høyfjellsområde N _ SAME
sabet N: ski N _ ski N _ SAME
čuoigan N: ski N; langrenn N; skirenn N _ skirenn N
seahtu N: stand N; stilling N _ stand N, stilling N
searvegoddi N: menighet N _ menighet N _ SAME
servodat N: samfunn N _ samfunn N _ SAME
servodatfága N: samfunnsfag N _ samfunnsfag N _ SAME
sirdin N: overføring N; flytting N _ flytting N; overføring N
sisdoallu N: innholdsfortegnelse N; innhold N _ innhold N; innholdsfortegnelse N
skohter N: snøscooter N; scooter N _ scooter N, snøscooter N
muohtaskohter N: snøscooter N; snøskuter N _ snøskuter N
skuovva N: sko N; støvel N _ sko N
sohkagoddi N: slekt N _ slekt N _ SAME
sohka N: slekt N _ slekt N, ætt N; slektning N
sogalaš N: slekt N; slektning N _ slektning N
stoahkanapparáhtta N: lekeapparat N _ lekeapparat N _ SAME
stoarbma N: storm N _ storm N _ SAME
suopman N: dialekt N; stemme N _ stemme N, røst N; dialekt N
sárggis N: linje N; strek N _ strek N
linjá N: linje N _ linje N _ SAME
linnjá N: linje N _ linje N _ SAME
suovva N: røyk N _ røyk N _ SAME
duhpát N: røyk N; tobakk N _ tobakk N
ságastallan N: samtale N; debatt N; dialog N _ samtale N; dialog N
sáivačáhceguolli N: ferskvannsfisk N _ ferskvannsfisk N _ SAME
sámediggi N: sameting N _ sameting N _ SAME
unnitlohku N: mindretall N; minoritet N _ mindretall N
ustitvuohta N: vennskap N _ vennskap N _ SAME
viidna N: vin N _ vin N, brennevin N
viidni N: vin N; brennevin N _ vin N
vuogádat N: system N _ framgangsmåte N; system N
vuoigŋa N: ånd N _ ånd N _ SAME
vuoiŋŋalašvuohta N: ånd N _ åndelighet N
vuoitu N: fordel N; gevinst N _ seier N; fordel N; gevinst N; avkastning N
vuoiŋŋanas N: pust N _ pust N _ SAME
vuoiŋŋahat N: pust N _ åndedrett N
vuoksá N: okse N _ okse N _ SAME
sarvvis N: okse N _ reinsbukk N
bárggeš N: komagbånd N _ flettet snor til komagbånd N
vuođđojurdda N: ideologi N; prinsipp N _ prinsipp N; ideologi N
váhnenčoahkkin N: foreldremøte N _ foreldremøte N _ SAME
válga N: valg N _ valg N _ SAME
várrepresideanta N: visepresident N _ visepresident N _ SAME
várri N: fjell N; råd N _ fjell N; råd N _ SAME
duottar N: fjell N _ vidde N
áhta N: element N; ting N _ ting N; element N
áigodat N: intervall N; sesong N _ intervall N; tidsperiode N
áigumuš N: intensjon N; vilje N _ vilje N, hensikt N; intensjon N
álbmotbeaivi N: nasjonaldag N _ nasjonaldag N _ SAME
árpu N: tråd N _ tråd N _ SAME
láigi N: tråd N; garn N _ garn N, ulltråd N
stáhtus N: status N _ status N _ SAME
ásahus N: ordning N; institusjon N; organ N _ ordning N, foranstaltning N; institusjon N, organ N
ávnnas N: emne N; materiale N _ emne N, skurlast N
fáddá N: emne N; tema N; motiv N _ tema N, motiv N
áššebábir N: saksdokument N; dokument N; sakspapir N _ sakspapir N, aktstykke N, saksdokument N
áššegollu N: sakskostnad N _ sakskostnad N _ SAME
čađaheapmi N: gjennomgang N; gjennomføring N _ gjennomgang N, gjennomføring N
geahčadeapmi N: gjennomgang N _ innsyn N
čielgi N: ryggrad N; rygg N _ rygg N, ryggrad N; landrygg N; hovedsnøre N
čielgedákti N: ryggrad N _ ryggvirvel N
čivga N: unge N _ unge N _ SAME
čoahkkáigeassu N: oppsummering N; sammendrag N _ oppsummering N; sammendrag N _ SAME
čoarvvuš N: gevir N _ gevir N _ SAME
čoarvvus N: gevir N _ gevir N _ SAME
čoarvi N: gevir N; horn N _ horn N
čujuhus N: adresse N; henvisning N _ adresse N; anvisning N, henvisning N
čuohti N: hundre N _ hundre N _ SAME
čáhci N: vann N _ vann N, vatn N
jávri N: vann N _ innsjø N
čálašeapmi N: korrespondanse N _ korrespondanse N _ SAME
čálus N: notat N _ notat N, skriv N
čázet N: komag N _ komag N, sommerkomag N
buser N: genser N _ genser N _ SAME
báidi N: genser N _ skjorte N
myhta N: myte N _ myte N _ SAME
gáddu N: myte N; tro N _ knehase N; tro N, formodning N
guollejávri N: fiskevann N _ fiskevann N _ SAME
ámmátolmmoš N: embetsmann N _ embetsmann N _ SAME
noras N: lårbein N _ lårbein N, margbein N
viisodat N: klokskap N _ klokskap N _ SAME
astoáiggeviessu N: fritidsbolig N; fritidshus N _ fritidshus N, fritidsbolig N
bargiidpolitihkka N: personalpolitikk N _ personalpolitikk N _ SAME
bargonávccahisvuođaoadju N: uføretrygd N _ uføretrygd N _ SAME
buhcciidruoktu N: sykehjem N _ sykehjem N _ SAME
bátnedivššohat N: tannklinikk N _ tannklinikk N _ SAME
departemeantaráđđi N: departementsråd N _ departementsråd N _ SAME
diehtogáldu N: informasjonskilde N; datakilde N _ informasjonskilde N, datakilde N
diehtojuohkinteknologiija N: informasjonsteknologi N _ informasjonsteknologi N _ SAME
diehtovuođđu N: informasjonsgrunnlag N; database N _ database N; informasjonsgrunnlag N
doaibmagoddi N: arbeidsutvalg N; kommisjon N _ kommisjon N, arbeidsutvalg N
bargolávdegoddi N: arbeidsutvalg N _ arbeidsutvalg N _ SAME
doaibmaguovddáš N: aktivitetssenter N _ aktivitetssenter N _ SAME
doaibmalohpi N: konsesjon N; løyve N _ konsesjon N, løyve N
lohpi N: løyve N; tillatelse N; lov N _ tillatelse N, lov N
doaibmasisaboahtu N: driftsinntekt N _ driftsinntekt N _ SAME
doavtterbálvalus N: legetjeneste N _ legetjeneste N _ SAME
duktasadji N: hustuft N _ hustuft N _ SAME
dutkanprošeakta N: forskningsprosjekt N _ forskningsprosjekt N _ SAME
dásseárvoláhka N: likestillingslov N _ likestillingslov N _ SAME
fievrredandoarjja N: frakttilskudd N _ frakttilskudd N _ SAME
fitnodatregisttar N: foretaksregister N _ foretaksregister N _ SAME
gielddariekti N: herredsrett N _ herredsrett N _ SAME
givssideapmi N: mobbing N _ mobbing N _ SAME
gulahallanváhnen N: foreldrekontakt N _ foreldrekontakt N _ SAME
gulaskuddannotáhtta N: høringsnotat N _ høringsnotat N _ SAME
guovttegielalašvuođadoarjja N: tospråklighetstilskudd N _ tospråklighetstilskudd N _ SAME
gáddeavádat N: strandsone N _ strandsone N _ SAME
jođihandoarjja N: driftstilskudd N; driftsstøtte N _ driftstilskudd N
loahpaheapmi N: avslutning N _ avslutning N _ SAME
luoddadirektoráhtta N: vegdirektorat N _ vegdirektorat N _ SAME
luonddusuodjalanláhka N: naturvernlov N _ naturvernlov N _ SAME
lávdegoddeevttohus N: komitéinnstilling N _ komitéinnstilling N _ SAME
meroštallannjuolggadus N: beregningsregel N _ beregningsregel N _ SAME
mánáidoadju N: barnetrygd N _ barnetrygd N _ SAME
mánáidsuodjalusláhka N: barnevernlov N _ barnevernlov N _ SAME
nationálabušeahtta N: nasjonalbudsjett N _ nasjonalbudsjett N _ SAME
njuovahatstruktuvra N: slakteristruktur N _ slakteristruktur N _ SAME
oahppostipeanda N: utdanningsstipend N _ utdanningsstipend N _ SAME
odelsláhka N: odelslov N _ odelslov N _ SAME
ovdaprošeakta N: forprosjekt N _ forprosjekt N _ SAME
ovddidanprošeakta N: utviklingsprosjekt N _ utviklingsprosjekt N _ SAME
ovttaolbmofitnodat N: enkeltmannsforetak N _ eneierforetak N, enkeltmannsforetak N
ovttasbargolávdegoddi N: samarbeidsutvalg N _ samarbeidskomité N, samarbeidsutvalg N
predikatiiva N: predikativ N _ predikativ N _ SAME
redakšuvdnalávdegoddi N: redaksjonskomité N _ redaksjonskomité N _ SAME
regionálapolitihkka N: regionalpolitikk N _ regionalpolitikk N _ SAME
guovlopolitihkka N: regionalpolitikk N; distriktspolitikk N _ distriktspolitikk N
riektecealkámuš N: kjennelse N _ kjennelse N _ SAME
riektegeavat N: rettspraksis N _ rettspraksis N _ SAME
riektegeavahus N: rettspraksis N _ rettsanvendelse N
riektesihkarvuohta N: rettssikkerhet N _ rettssikkerhet N _ SAME
rámmaplána N: rammeplan N _ rammeplan N _ SAME
sadjásašvirgi N: vikariat N _ vikariat N _ SAME
seavagiella N: tegnspråk N _ tegnspråk N _ SAME
giehtagiella N: tegnspråk N _ tegnspråk N _ SAME
servodatberoštupmi N: samfunnsinteresse N _ samfunnsinteresse N _ SAME
siffar N: siffer N _ siffer N _ SAME
skovvi N: blankett N; skjema N _ skjema N, blankett N
skuvlafriddjaortnet N: skolefritidsordning N _ skolefritidsordning N _ SAME
skuvlaastoáiggeortnet N: skolefritidsordning N _ skolefritidsordning N _ SAME
astoáiggefálaldat N: skolefritidsordning N; fritidstilbud N _ fritidstilbud N
sárdnestuollu N: talerstol N _ talerstol N _ SAME
telefonguovddáš N: sentralbord N _ sentralbord N _ SAME
telefončoahkkin N: telefonmøte N _ telefonmøte N _ SAME
ulbmilmearrádus N: formålsbestemmelse N _ formålsbestemmelse N _ SAME
ulbmilparagráfa N: formålsbestemmelse N; formålsparagraf N _ formålsparagraf N
vearrovuogádat N: skattesystem N _ skattesystem N _ SAME
vuoigŋaduodji N: åndsverk N _ åndsverk N _ SAME
jurddamáilbmi N: tankeverden N _ tankeverden N _ SAME
oaggunáigi N: fisketid N _ fisketid N _ SAME
oahppanbáiki N: lærested N _ lærested N _ SAME
juogus N: seksjon N _ seksjon N _ SAME
forum N: forum N _ forum N _ SAME
maori N: maori N _ maori N _ SAME
plánen N: planlegging N _ planlegging N _ SAME
preassa N: presse N _ presse N _ SAME
media N: presse N _ media N
bajásšaddan N: oppvekst N _ oppvekst N _ SAME
sámerádio N: sameradio N _ sameradio N _ SAME
bargoeallin N: arbeidsliv N _ arbeidsliv N _ SAME
lagasrádio N: nærradio N _ nærradio N _ SAME
riegádeapmi N: fødsel N _ fødsel N _ SAME
boazoálbmot N: reindriftsfolk N _ reindriftsfolk N _ SAME
giellageavaheapmi N: språkbruk N _ språkbruk N _ SAME
giellabargu N: språkarbeid N _ språkarbeid N _ SAME
fágabiras N: fagmiljø N _ fagmiljø N _ SAME
ruvdnaprinsa N: kronprins N _ kronprins N _ SAME
ođđadárogiella N: nynorsk N _ nynorsk N _ SAME
rádjeofelaš N: grenselos N _ grenselos N _ SAME
plánabargu N: planarbeid N _ planarbeid N _ SAME
guovllukommišuvdna N: distriktskommisjon N _ distriktskommisjon N _ SAME
nuoraidsearvi N: ungdomsforbund N _ ungdomsforbund N _ SAME
rádjaguovlu N: grenseområde N _ grenseområde N _ SAME
geassebargu N: sommerjobb N _ sommerjobb N _ SAME
plánalávdegoddi N: planutvalg N _ planutvalg N _ SAME
bearašmiellahttu N: familiemedlem N _ familiemedlem N _ SAME
rehketmašiidna N: kalkulator N _ regnemaskin N, kalkulator N
diehtu N: informasjon N; beskjed N; kunnskap N; opplysning N _ kunnskap N, viten N; informasjon N
diehtojuohkin N: informasjon N; orientering N _ informasjon N, orientering N
sorta N: type N _ sort N
jagiáigi N: sesong N _ årstid N
digaštallan N: debatt N; diskusjon N _ debatt N, ordskifte N
buvtta N: produkt N _ produkt N _ SAME
vuovdin N: salg N _ salg N _ SAME
buvttadus N: produksjon N _ produksjon N, avkastning N
mearrádus N: vedtak N; bestemmelse N _ bestemmelse N
vátni N: mangel N _ mangel N _ SAME
vádjit N: mangel N; underskudd N _ underskudd N, mangel N
váili N: mangel N; underskudd N _ mangel N, underskudd N
osku N: religion N; tro N _ tro N; religion N
geahččaleapmi N: prøve N; forsøk N _ prøve N
geahččalus N: prøve N; prøvelse N; fristelse N _ prøvelse N; fristelse N
bušeahtta N: budsjett N _ budsjett N _ SAME
sadji N: posisjon N; sted N; rolle N; plass N _ sted N, plass N; posisjon N; rolle N
posišuvdna N: posisjon N _ posisjon N _ SAME
dorvu N: sikkerhet N; tillit N; trygghet N _ tillit N; sikkerhet N
sihkarvuohta N: sikkerhet N _ sikkerhet N _ SAME
hápmi N: stil N; form N _ form N; skikkelse N; utseende N; fasade N
eaktu N: forutsetning N; vilkår N; kriterium N _ betingelse N, vilkår N; klausul N; kriterium N
duohtavuohta N: alvor N; realitet N; faktum N _ sannhet N
fearán N: episode N; hendelse N; historie N _ hending N, hendelse N
guorahallan N: analyse N; utredning N; utredning N; undersøkelse N _ utredning N; analyse N
vuolggaheapmi N: initiativ N _ initiativ N _ SAME
dálkkádat N: klima N _ klima N _ SAME
bálvalus N: service N; tjeneste N _ tjeneste N
ovdanbuktin N: presentasjon N; fremstilling N; foredrag N; uttrykk N; framstilling N _ presentasjon N
ádji N: opphold N _ tidhefte N
čuohpaheapmi N: operasjon N _ operasjon N _ SAME
leaika N: humor N; spøk N _ spøk N
gielddus N: forbud N _ forbud N _ SAME
dáidu N: sans N; kunnskap N; evne N _ kunnskap N; forstand N
sále N: sal N _ sal N _ SAME
tennjet N: tegning N _ tegning N _ SAME
tevnnet N: tegning N _ tegning N _ SAME
ealáhat N: pensjon N _ beite N; pensjon N
suodjalus N: beskyttelse N; forsvar N; vern N _ beskyttelse N, vern N
suodji N: beskyttelse N; vern N _ ly N, vern N
goallosvovdna N: tilhenger N _ tilhenger N _ SAME
borasdávda N: kreft N _ kreft N _ SAME
dihtomiella N: bevissthet N _ bevissthet N _ SAME
suoidni N: gress N _ gress N, høy N; sennegress N
rássi N: gress N _ gras N; urt N, blomst N
sáŋgár N: forbilde N; helt N _ helt N
ruovderaŧŧi N: jernbane N _ jernbane N _ SAME
ruovdemáđidja N: jernbane N _ jernbanespor N
váldi N: fullmakt N; mandat N; myndighet N _ fullmakt N, myndighet N, mandat N
fápmudus N: fullmakt N; mandat N _ mandat N
náittosbárra N: ektepar N _ brudepar N
náittospárra N: ektepar N _ brudepar N
dovddastus N: erkjennelse N _ innrømmelse N, tilståelse N; betroelse N
oahpponeavvu N: læremiddel N _ læremiddel N _ SAME
dutkan N: etterforskning N; forskning N; undersøkelse N _ undersøkelse N; forskning N
ovttasbargoprošeakta N: samarbeidsprosjekt N _ samarbeidsprosjekt N _ SAME
garrusátni N: banning N _ banneord N
stevvel N: støvel N _ støvel N _ SAME
ekovuogádat N: økosystem N _ økosystem N _ SAME
jahkelohku N: årstall N _ årstall N _ SAME
guoddá N: madrass N _ pute N
gilvočuoigan N: langrenn N; skirenn N _ skirenn N
báhpasuohkan N: prestegjeld N _ prestesokn N
čáhcerusttet N: vannverk N _ vannanlegg N
eanandoallopolitihkka N: landbrukspolitikk N _ landbrukspolitikk N _ SAME
gávpeolmmái N: handelsmann N _ handelsmann N _ SAME
gávpejas N: handelsmann N _ handelsmann N _ SAME
berošteaddjijoavku N: interessegruppe N _ interessegruppe N _ SAME
riikkageaidnu N: riksveg N; riksvei N _ riksvei N
almmuhantávval N: oppslagstavle N _ oppslagstavle N _ SAME
bargobivttas N: kjeledress N _ arbeidsplagg N
dárbbaš N: rekvisita N; behov N _ behov N, nødvendighet N
váldooassi N: hovedenhet N; hoveddel N _ hoveddel N
sátnevuorrolistu N: talerliste N _ talerliste N _ SAME
resursaváili N: ressursknapphet N _ ressurssvak A
ruoššagiella N: russisk N _ russisk N _ SAME
čuovga N: lys N _ lys N _ SAME
láppis N: lam N _ lam N _ SAME
molssaeaktu N: alternativ N _ alternativ N _ SAME
juolgi N: bein N; fot N _ fot N, bein N
goarta N: kort N _ kort N _ SAME
koarta N: kort N _ kort N _ SAME
sálti N: salt N _ salt N _ SAME
feaila N: feil N _ feil N _ SAME
boasttuvuohta N: feil N _ feil N _ SAME
váddu N: feil N; skade N _ skade N, feil N
meattáhus N: feil N _ feil N _ SAME
meaddádus N: feil N _ feil N, tabbe N
vearri N: feil N; urett N _ urett N, feil N
ruoktu N: hjem N _ heim N, hjem N
vuohki N: måte N; metode N _ måte N, metode N
láhki N: måte N _ måte N, vis N
báđar N: flyktning N _ flyktning N _ SAME
eaiggát N: eier N _ eier N _ SAME
ossodathoavda N: avdelingsleder N; avdelingsdirektør N _ avdelingsleder N
áirras N: representant N _ representant N _ SAME
bálvá N: tjener N; tjenestemann N _ tjener N
bálkábargu N: lønnsarbeid N _ lønnsarbeid N _ SAME
oaggunstávrá N: fiskestang N _ fiskestang N _ SAME
oaggunstággu N: fiskestang N _ fiskestang N _ SAME
čáhcádat N: vassdrag N _ vassdrag N _ SAME
čázádat N: vassdrag N _ vassdrag N, vassfar N
goavddis N: runebomme N _ runebomme N _ SAME
noaidegárri N: runebomme N _ runebomme N _ SAME
meavrresgárri N: runebomme N _ runebomme N _ SAME
gávpotguovddáš N: bykjerne N _ bykjerne N _ SAME
luoikkaheapmi N: utlån N _ utlån N _ SAME
sámegieldiibmu N: samisktime N _ samisktime N _ SAME
synonyma N: synonym N _ synonym N _ SAME
riddokultuvra N: kystkultur N _ kystkultur N _ SAME
vahkkoplána N: ukeplan N _ ukeplan N _ SAME
čállinproseassa N: skriveprosess N _ skriveprosess N _ SAME
ritma N: rytme N _ rytme N _ SAME
responsa N: respons N _ respons N _ SAME
fonta N: font N _ font N _ SAME
neahtta N: nett N _ nett N _ SAME
čállin N: skriving N _ skriving N _ SAME
oađđenseahkka N: sovepose N _ sovepose N _ SAME
skandála N: skandale N _ skandale N _ SAME
beaivečuovga N: dagslys N _ dagslys N _ SAME
suoivva N: skygge N _ skygge N _ SAME
suoivvan N: skygge N _ skygge N _ SAME
teáhterčájáhus N: teaterforestilling N _ teaterforestilling N _ SAME
ámadadju N: ansikt N _ ansikt N _ SAME
ámadeadju N: ansikt N _ ansikt N _ SAME
leksikon N: leksikon N _ leksikon N _ SAME
katastrofa N: katastrofe N _ katastrofe N _ SAME
ivdnegeavaheapmi N: fargebruk N _ fargebruk N _ SAME
gievkkanbeavdi N: kjøkkenbord N _ kjøkkenbord N _ SAME
filosofa N: filosof N _ filosof N _ SAME
tráhppa N: trapp N _ trapp N _ SAME
ráhppa N: trapp N _ trapp N _ SAME
ráhppá N: trapp N _ trapp N _ SAME
boardda N: trapp N _ trapp N _ SAME
tráhppá N: trapp N _ trapp N _ SAME
skuvlaseahkka N: skolesekk N _ skolesekk N _ SAME
skuvlalávka N: skolesekk N _ skolesekk N _ SAME
skuvlabargu N: skolearbeid N _ skolearbeid N _ SAME
romána N: roman N _ roman N _ SAME
lohkanhárjehallan N: lesetrening N _ lesetrening N _ SAME
geometriija N: geometri N _ geometri N _ SAME
spiinnebiergu N: svinekjøtt N _ svinekjøtt N _ SAME
stáidnár N: steinbit N _ steinbit N _ SAME
stáinnir N: steinbit N _ steinbit N _ SAME
nissonbeaivi N: kvinnedag N _ kvinnedag N _ SAME
iđitbiebmu N: frokost N _ frokost N _ SAME
iđđesbiebmu N: frokost N _ frokost N _ SAME
iđitborramuš N: frokost N _ frokost N _ SAME
huksentiŋga N: byggemateriale N _ byggemateriale N _ SAME
lássa N: glass N _ glass N; skjær som synes over vannet N
dákteriggi N: skjelett N _ skjelett N _ SAME
ambulánsa N: ambulanse N _ ambulanse N _ SAME
buohccibiila N: ambulanse N _ ambulanse N _ SAME
buohccebiila N: ambulanse N _ sykebil N, ambulanse N
alfabehta N: alfabet N _ alfabet N _ SAME
mohtorsihkkel N: motorsykkel N _ motorsykkel N _ SAME
advearba N: adverb N _ adverb N _ SAME
giellateknologiija N: språkteknologi N _ språkteknologi N _ SAME
beaivelatnja N: stue N _ dagligstue N, stue N
stohpu N: stue N; hus N; bolig N _ stue N; hus N
orrunlatnja N: stue N _ stue N _ SAME
olgoseaidni N: yttervegg N _ yttervegg N _ SAME
olggoš N: omslag N; trekk N; overflate N _ omslag N, trekk N; overflate N
jumešbealli N: tvilling N _ tvilling N _ SAME
šuhkoláda N: sjokolade N _ sjokolade N _ SAME
koaffar N: koffert N _ koffert N _ SAME
politihkkár N: politiker N _ politiker N _ SAME
politihkar N: politiker N _ politiker N _ SAME
stáhta N: stat N _ stat N _ SAME
stáda N: stat N _ stat N _ SAME
sámeálbmot N: samefolk N _ samefolket N
artista N: artist N _ artist N _ SAME
sámediggeáirras N: sametingsrepresentant N _ sametingsrepresentant N _ SAME
ekonomiija N: økonomi N _ økonomi N _ SAME
ruhtadilli N: økonomi N _ økonomi N _ SAME
direktevra N: direktør N _ direktør N _ SAME
advokáhta N: advokat N _ advokat N _ SAME
buletiija N: politi N _ politi N _ SAME
poliisa N: politi N _ politi N _ SAME
politiija N: politi N _ politi N _ SAME
boles N: politi N _ politi N _ SAME
filbmafestivála N: filmfestival N _ filmfestival N _ SAME
válgabiire N: valgkrets N _ valgkrets N _ SAME
boazoealáhus N: reindriftsnæring N _ reindriftsnæring N _ SAME
boazodoalloealáhus N: reindriftsnæring N _ reindriftsnæring N _ SAME
kulturráđđi N: kulturråd N _ kulturråd N _ SAME
olmmošvuoigatvuohta N: menneskerettighet N _ menneskerettighet N _ SAME
kulturskuvla N: kulturskole N _ kulturskole N _ SAME
listu N: liste N _ liste N _ SAME
lista N: liste N _ liste N _ SAME
ruovttubáiki N: hjemsted N _ hjemsted N _ SAME
ohcanáigemearri N: søknadsfrist N _ søknadsfrist N _ SAME
ohcanáigi N: søknadsfrist N _ søknadsfrist N _ SAME
neahttasiidu N: nettside N _ nettside N _ SAME
alimusriekti N: høyesterett N _ høyesterett N _ SAME
e-boasta N: e-post N _ e-post N _ SAME
e-maila N: e-post N _ e-post N _ SAME
e-poasta N: e-post N _ e-post N _ SAME
nuppástuhttinprográmma N: omstillingsprogram N _ omstillingsprogram N _ SAME
doaibmaplána N: handlingsplan N _ handlingsplan N _ SAME
ruvkedoaibma N: gruvedrift N _ gruvedrift N _ SAME
almmolašvuohta N: offentlighet N _ offentlighet N _ SAME
leansmánnekantuvra N: lensmannskontor N _ lensmannskontor N _ SAME
musihkkafestivála N: musikkfestival N _ musikkfestival N _ SAME
guovttegielalašvuohta N: tospråklighet N _ tospråklighet N _ SAME
guovttegielatvuohta N: tospråklighet N _ tospråklighet N _ SAME
válgalihttu N: valgforbund N _ valgforbund N _ SAME
goansta N: kunst N _ kunst N _ SAME
dáidda N: kunst N _ kunst N _ SAME
boazodoalloskuvla N: reindriftsskole N _ reindriftsskole N _ SAME
geafivuohta N: fattigdom N _ fattigdom N _ SAME
tonna N: tonn N _ tonn N _ SAME
sámepolitihkar N: samepolitiker N _ samepolitiker N _ SAME
sámepolitihkkár N: samepolitiker N _ samepolitiker N _ SAME
ráđđelahttu N: rådsmedlem N _ rådsmedlem N _ SAME
riikkastivra N: landsstyre N _ landsstyre N _ SAME
dáiddačájáhus N: kunstutstilling N _ kunstutstilling N _ SAME
reportáša N: reportasje N _ reportasje N _ SAME
veahtu N: hindring N; hefte N _ hefte N, hindring N
eastta N: hindring N _ hindring N _ SAME
mánáidruoktu N: barnehjem N _ barnehjem N _ SAME
dutkamuš N: forskning N _ forskning N _ SAME
meahccebálvalus N: fjelltjeneste N _ fjelltjeneste N _ SAME
festivála N: festival N _ festival N _ SAME
kapteaidna N: kaptein N _ kaptein N _ SAME
konfirmánta N: konfirmant N _ konfirmant N _ SAME
stivrračoahkkin N: styremøte N _ styremøte N _ SAME
interneahttasiidu N: internettside N _ internettside N _ SAME
máttasápmi N: sørsame N _ sørsame N _ SAME
lullisápmelaš N: sørsame N _ sørsame N _ SAME
máttasápmelaš N: sørsame N _ sørsame N _ SAME
kulturárbi N: kulturarv N _ kulturarv N _ SAME
turistaealáhus N: turistnæring N _ turistnæring N _ SAME
turismaealáhus N: turistnæring N _ turistnæring N _ SAME
mandáhta N: mandat N _ mandat N _ SAME
eanandoalloministtar N: landbruksminister N _ landbruksminister N _ SAME
eanadoalloministtar N: landbruksminister N _ landbruksminister N _ SAME
kulturdepartemeanta N: kulturdepartement N _ kulturdepartement N _ SAME
bellodatustit N: partifelle N _ partifelle N _ SAME
girjjáš N: hefte N _ liten bok N, hefte N
beassášfestivála N: påskefestival N _ påskefestival N _ SAME
rukto N: rute N _ rute N _ SAME
ruvtto N: rute N _ rute N _ SAME
jurddašanvuohki N: tenkemåte N _ tenkemåte N _ SAME
kulturbálkkašupmi N: kulturpris N _ kulturpris N _ SAME
stuorradiggeáirras N: stortingsrepresentant N _ stortingsrepresentant N _ SAME
spábbačiekčanlihttu N: fotballforbund N _ fotballforbund N _ SAME
vuotnaguovlu N: fjordområde N _ fjordområde N _ SAME
olgoriikalaš N: utlending N _ utlending N _ SAME
vuođđudus N: stiftelse N _ stiftelse N, grunnleggelse N
muitokonsearta N: minnekonsert N _ minnekonsert N _ SAME
fylkkadoavttir N: fylkeslege N _ fylkeslege N _ SAME
álbmotlihttu N: folkeforbund N _ folkeforbund N _ SAME
áigečála N: tidsskrift N _ tidsskrift N _ SAME
journalistaoahppu N: journalistutdanning N _ journalistutdanning N _ SAME
proavás N: prost N _ prost N _ SAME
nuoraidlávdegoddi N: ungdomsutvalg N _ ungdomsutvalg N _ SAME
luondduhálddašeapmi N: naturforvaltning N _ naturforvaltning N _ SAME
duiskalaš N: tysker N _ tysker N _ SAME
bovdehus N: invitasjon N _ invitasjon N _ SAME
bovdejupmi N: invitasjon N _ invitasjon N _ SAME
plakáhta N: plakat N _ plakat N _ SAME
sámeministtar N: sameminister N _ sameminister N _ SAME
kulturministtar N: kulturminister N _ kulturminister N _ SAME
ođassátta N: nyhetssending N _ nyhetssending N _ SAME
boazonjuovahat N: reinslakteri N _ reinslakteri N _ SAME
válgastivra N: valgstyre N _ valgstyre N _ SAME
kulturdoallu N: kulturarrangement N _ kulturarrangement N _ SAME
guolástusministtar N: fiskeriminister N _ fiskeriminister N _ SAME
dáhkki N: tak N _ tak N _ SAME
rohpi N: tak N _ tak N _ SAME
ruhtasubmi N: pengesum N _ pengesum N _ SAME
guovlodepartemeanta N: regionaldepartement N _ regionaldepartement N _ SAME
luohttámuš N: tillit N _ tillit N _ SAME
luohttevašvuohta N: tillit N _ tillit N _ SAME
dramatihkka N: dramatikk N _ dramatikk N _ SAME
fylkkalávdegoddi N: fylkesutvalg N _ fylkesutvalg N _ SAME
etáhtta N: etat N _ etat N _ SAME
girkočoahkkin N: kirkemøte N _ kirkemøte N _ SAME
boastaboksa N: postboks N _ postboks N _ SAME
poastaboksa N: postboks N _ postboks N _ SAME
kulturorganisašuvdna N: kulturorganisasjon N _ kulturorganisasjon N _ SAME
dutkandepartemeanta N: forskningsdepartement N _ forskningsdepartement N _ SAME
kultureallin N: kulturliv N _ kulturliv N _ SAME
dutkanbargu N: forskningsarbeid N _ forskningsarbeid N _ SAME
árja N: iver N; energi N; innsats N _ energi N, iver N; innsats N
dáiddačeahppi N: kunstner N _ kunstner N _ SAME
dáiddár N: kunstner N _ kunstner N _ SAME
máilmmisoahti N: verdenskrig N _ verdenskrig N _ SAME
oljofitnodat N: oljeselskap N _ oljeselskap N _ SAME
dáiddamusea N: kunstmuseum N _ kunstmuseum N _ SAME
stuoraservodat N: storsamfunn N _ storsamfunn N _ SAME
stuorraservodat N: storsamfunn N _ storsamfunn N _ SAME
eksámen N: eksamen N _ eksamen N _ SAME
loahppageahččaleapmi N: eksamen N _ eksamen N; generalprøve N
oktasašorohat N: fellesbeite N _ fellesbeite N _ SAME
oktasašguohtun N: fellesbeite N _ fellesbeite N _ SAME
gieldaministtar N: kommunalminister N _ kommunalminister N _ SAME
álbmotjienasteapmi N: folkeavstemning N _ folkeavstemning N _ SAME
kulturmuitoráđđi N: kulturminneråd N _ kulturminneråd N _ SAME
stuorradiggedieđáhus N: stortingsmelding N _ stortingsmelding N _ SAME
boazopolitiija N: reinpoliti N _ reinpoliti N _ SAME
šiehtadallanjoavku N: forhandlingsgruppe N _ forhandlingsgruppe N _ SAME
páhppa N: prest N _ prest N _ SAME
báhppa N: prest N _ prest N _ SAME
diehtojuohkinhoavda N: informasjonssjef N _ informasjonssjef N _ SAME
bartaeaiggát N: hytteeier N _ hytteeier N _ SAME
skuvlafálaldat N: skoletilbud N _ skoletilbud N _ SAME
sotnabeaiskuvla N: søndagsskole N _ søndagsskole N _ SAME
minsttar N: mønster N _ mønster N _ SAME
historihkkár N: historiker N _ historiker N _ SAME
čoahkkinjođihangoddi N: møteledelse N _ møteledelse N _ SAME
čoahkkinjođiheapmi N: møteledelse N _ møteledelse N _ SAME
cáhcu N: strek N _ strek N _ SAME
sáhcu N: strek N _ strek N _ SAME
bartasadji N: hyttetomt N; tomt N _ hyttetomt N
olgoriikkadepartemeanta N: utenriksdepartement N _ utenriksdepartement N _ SAME
gilišillju N: bygdetun N _ bygdetun N _ SAME
fuolkevuohta N: slektskap N _ slektskap N _ SAME
sáttogáddi N: sandstrand N _ sandstrand N _ SAME
skuvlastivra N: skolestyre N _ skolestyre N _ SAME
deaddileapmi N: trykking N; opplag N _ trykking N
guovddášeiseváldi N: sentralmyndighet N _ sentralmyndighet N _ SAME
dásseárvolávdegoddi N: likestillingsutvalg N _ likestillingsutvalg N _ SAME
báhčinlohpi N: fellingstillatelse N _ fellingstillatelse N _ SAME
váldokantuvra N: hovedkontor N _ hovedkontor N _ SAME
mánotbadji N: måned N _ måned N _ SAME
mánnu N: måned N _ måne N; måned N
lágamánniriekti N: lagmannsrett N _ lagmannsrett N _ SAME
lágamánneriekti N: lagmannsrett N _ lagmannsrett N _ SAME
sámediggelistu N: sametingsliste N _ sametingsliste N _ SAME
ministtarráđđi N: ministerråd N _ ministerråd N _ SAME
čábbodat N: skjønnhet N _ skjønnhet N _ SAME
ráđđehusbellodat N: regjeringsparti N _ regjeringsparti N _ SAME
nástegovva N: stjernebilde N _ stjernebilde N _ SAME
girkodepartemeanta N: kirkedepartement N _ kirkedepartement N _ SAME
válgaáigodat N: valgperiode N _ valgperiode N _ SAME
tearbma N: term N _ term N _ SAME
stáhtaministtar N: statsminister N _ statsminister N _ SAME
jorgalanbargu N: oversettelsesarbeid N; oversettelse N _ oversettelsesarbeid N
sámediggeáigodat N: sametingsperiode N _ sametingsperiode N _ SAME
smávvafanas N: småbåt N _ småbåt N _ SAME
searvegodderáđđi N: menighetsråd N _ menighetsråd N _ SAME
rádiosátta N: radiosending N _ radiosending N _ SAME
giellastivra N: språkstyre N _ språkstyre N _ SAME
vuollegašvuohta N: ydmykhet N _ ydmykhet N _ SAME
politiijameašttir N: politimester N _ politimester N _ SAME
giellahálddašanguovlu N: språkforvaltningsområde N _ språkforvaltningsområde N _ SAME
dásseárvobálkkašupmi N: likestillingspris N _ likestillingspris N _ SAME
dearvvasvuođaguovddáš N: helsesenter N _ helsesenter N _ SAME
dearvvašvuođaguovddáš N: helsesenter N _ helsesenter N _ SAME
boazodoallokantuvra N: reindriftskontor N _ reindriftskontor N _ SAME
prošeaktabargu N: prosjektarbeid N _ prosjektarbeid N _ SAME
ealáhusossodat N: næringsavdeling N _ næringsavdeling N _ SAME
olgohivsset N: utedo N _ utedo N _ SAME
kulturfálaldat N: kulturtilbud N _ kulturtilbud N _ SAME
girkodulka N: kirketolk N _ kirketolk N _ SAME
eanandoallodepartemeanta N: landbruksdepartement N _ landbruksdepartement N _ SAME
dutkanguovddáš N: forskningssenter N _ forskningssenter N _ SAME
oahppomátki N: studietur N _ studietur N _ SAME
dihtorprográmma N: dataprogram N _ dataprogram N _ SAME
stáhtaráđđi N: statsråd N _ statsråd N _ SAME
stádaráđđi N: statsråd N _ statsråd N _ SAME
ráđđehusadvokáhta N: regjeringsadvokat N _ regjeringsadvokat N _ SAME
fylkkadiggeáirras N: fylkestingsrepresentant N _ fylkestingsrepresentant N _ SAME
resursaguovddáš N: ressurssenter N _ ressurssenter N _ SAME
mánáidfestivála N: barnefestival N _ barnefestival N _ SAME
sámediggepresideanta N: sametingspresident N _ sametingspresident N _ SAME
nohkkanlatnja N: soverom N _ soverom N _ SAME
oađđenlatnja N: soverom N _ soverom N _ SAME
politiijaguovlu N: politidistrikt N _ politidistrikt N _ SAME
davviguovlu N: nordområde N _ nordområde N _ SAME
riddoministtar N: kystminister N _ kystminister N _ SAME
dearvvašvuođaministtar N: helseminister N _ helseminister N _ SAME
reaškkas N: latter N _ latter N _ SAME
čohkkánsadji N: sitteplass N _ sitteplass N _ SAME
filbmaguovddáš N: filmsenter N _ filmsenter N _ SAME
TV N: fjernsyn N _ TV N, fjernsyn N
ahki N: alder N _ alder N _ SAME
albmi N: himmel N _ himmel N _ SAME
alkohola N: alkohol N _ alkohol N _ SAME
allakonjunktuvra N: høykonjunktur N _ høykonjunktur N _ SAME
allaskuvla N: høgskole N; høyskole N _ høgskole N
allavearru N: toppskatt N _ toppskatt N _ SAME
almennet N: allmenning N _ allmenning N _ SAME
hálti N: himmelretning N; retning N _ himmelretning N; kurs N; retning N
almmiguovlu N: himmelretning N _ himmelretning N _ SAME
almmáiolmmoš N: mann N _ mann N _ SAME
dievdoolmmoš N: mann N _ mann N _ SAME
dievdu N: mann N _ mann N _ SAME
almmái N: mann N _ mann N _ SAME
gállis N: mann N _ kall N, mann N
arkiivačoavdda N: arkivnøkkel N _ arkivnøkkel N _ SAME
artihkal N: artikkel N _ artikkel N _ SAME
salla N: fang N _ fang N, favn N
fátmi N: fang N _ fang N _ SAME
aski N: fang N _ fang N _ SAME
astoáiggeklubba N: fritidsklubb N _ fritidsklubb N _ SAME
astoáiggeopmodat N: fritidseiendom N _ fritidseiendom N _ SAME
ávki N: nytte N _ nytte N _ SAME
áhpu N: nytte N _ nytte N _ SAME
gealbu N: nytte N; kompetanse N _ gagn N, nytte N; kompetanse N
gávdni N: nytte N _ nytte N, gagn N
attáldat N: gave N; anlegg N; evne N _ gave N
skeaŋka N: gave N _ gave N _ SAME
aviisa N: avis N _ avis N _ SAME
áviisa N: avis N _ avis N _ SAME
avvi N: belte N _ belte N _ SAME
boagán N: belte N _ belte N _ SAME
avádat N: sone N _ sone N _ SAME
badjebáza N: overskudd N _ overskudd N _ SAME
badjelbáza N: overskudd N _ overskudd N _ SAME
ballu N: frykt N _ frykt N; angst N
bargguhisvuođaruhta N: arbeidsledighetstrygd N _ arbeidsledighetstrygd N _ SAME
bargiidlihkadus N: arbeiderbevegelse N _ arbeiderbevegelse N _ SAME
bargoaddidivat N: arbeidsgiveravgift N _ arbeidsgiveravgift N _ SAME
bargobihttá N: arbeidsoppgave N; oppgave N _ arbeidsoppgave N
bargobiras N: arbeidsmiljø N _ arbeidsmiljø N _ SAME
bargojoavku N: arbeidsgruppe N; utvalg N _ utvalg N, arbeidsgruppe N
bargolatnja N: arbeidsrom N _ arbeidsrom N _ SAME
bargomárkan N: arbeidsmarked N _ arbeidsmarked N _ SAME
bargonoađđi N: arbeidsbyrde N _ arbeidsbyrde N _ SAME
bargoplána N: arbeidsplan N _ arbeidsplan N _ SAME
bargoriekti N: arbeidsrett N _ arbeidsrett N _ SAME
bargoáigi N: arbeidstid N _ arbeidstid N _ SAME
barta N: hytte N _ hytte N _ SAME
bassebeaivi N: helligdag N _ helligdag N _ SAME
beahci N: furu N _ furu N _ SAME
beaiveruhta N: dagpenger N _ dagpenger N _ SAME
beaivi N: dag N _ dag N; sol N
bealgi N: tommelfinger N _ tommelfinger N, tommel N; stortå N
beallji N: øre N _ øre N; svømmefinne N
evre N: øre N _ øre N _ SAME
beana N: hund N _ hund N _ SAME
čeahborbeaska N: pesk N _ pesk N, tykk pesk N, pesk av tykt høstskinn N
beaska N: pesk N _ pesk N _ SAME
suollemassátni N: passord N _ passord N _ SAME
beassansátni N: passord N _ passord N _ SAME
beavdegirjelasáhus N: protokolltilførsel N _ protokolltilførsel N _ SAME
beavdi N: bord N; pult N _ bord N
bordi N: bord N; rekke N _ bord N; rekke N; skranke N
bellodat N: parti N _ parti N _ SAME
bensiidna N: bensin N _ bensin N _ SAME
bensinstašuvdna N: bensinstasjon N _ bensinstasjon N _ SAME
girjerájus N: bibliotek N _ bibliotek N _ SAME
girjerádju N: bibliotek N _ bibliotek N _ SAME
bibliotehka N: bibliotek N _ bibliotek N _ SAME
biebmu N: mat N _ mat N, føde N
borramuš N: mat N _ mat N _ SAME
biegga N: vind N _ vind N _ SAME
bierdna N: bjørn N _ bjørn N _ SAME
guovža N: bjørn N _ bjørn N _ SAME
diggi N: ting N; rett N _ ting N, rett N; tinglyd N
diŋga N: ting N _ ting N _ SAME
tiŋga N: ting N _ ting N _ SAME
ášši N: sak N _ sak N _ SAME
sálga N: kjøttstykke N _ kjøttstykke N _ SAME
biergohaddi N: kjøttpris N _ kjøttpris N _ SAME
oažži N: kjøtt N; muskel N _ kjøtt N; kjød N, legeme N; muskel N
biergu N: kjøtt N _ kjøtt N _ SAME
bievlavuoján N: barmarkskjøretøy N _ barmarkskjøretøy N _ SAME
moallu N: bit N _ smule N, bit N
binná N: bit N _ bit N, stykke N; liten flokk N
bihtánsámegiella N: pitesamisk N _ pitesamisk N _ SAME
biila N: bil N _ bil N _ SAME
divohat N: verksted N _ verksted N _ SAME
birasviessu N: miljøbygg N _ miljøbygg N _ SAME
birranbeaivi N: døgn N _ døgn N _ SAME
jándor N: døgn N _ døgn N _ SAME
bisma N: biskop N _ biskop N _ SAME
molssodanlatnja N: garderobe N _ stellerom N; garderobe N
bivttasheŋgehat N: garderobe N _ garderobe N _ SAME
lasta N: blad N _ løv N, blad N
poasta N: post N _ post N _ SAME
boasta N: post N _ post N _ SAME
boazodoalloláhka N: reindriftslov N _ reindriftslov N _ SAME
boazodoallostivra N: reindriftsstyre N _ reindriftsstyre N _ SAME
boazodoallošiehtadus N: reindriftsavtale N _ reindriftsavtale N _ SAME
boazolohku N: reintall N _ reintall N _ SAME
boazoáidi N: reingjerde N _ reingjerde N _ SAME
boađus N: resultat N _ resultat N _ SAME
bohccobiergu N: reinkjøtt N _ reinkjøtt N _ SAME
ráidu N: rekke N; serie N; rekkefølge N; kolonne N _ raid N, rekke N; serie N; kolonne N
borgemánnu N: august N _ august N _ SAME
reive N: brev N _ brev N _ SAME
breava N: brev N _ brev N _ SAME
šoavva N: brus N; sus N _ sus N, brus N
šávva N: brus N _ brus N _ SAME
juhca N: brus N; sus N _ sus N, brus N
bruvsa N: brus N _ brus N _ SAME
buolaš N: kulde N _ kulde N, frost N
buolva N: generasjon N _ slektsledd N, generasjon N; kne N
sohkabuolva N: generasjon N _ slektsledd N, generasjon N
bustávva N: bokstav N; tegn N _ bokstav N
buvru N: grøt N _ grøt N _ SAME
suohkat N: grøt N _ grøt N _ SAME
buđet N: potet N _ potet N _ SAME
bábir N: papir N _ papir N _ SAME
bádja N: vadmel N _ vadmel N _ SAME
gákkis N: vadmel N _ vadmel N _ SAME
báhti N: gryte N _ gryte N _ SAME
ruitu N: gryte N _ gryte N _ SAME
báidnu N: farge N _ farge N, maling N
ivdni N: farge N _ farge N _ SAME
báikenamma N: stedsnavn N _ stedsnavn N _ SAME
báiki N: sted N _ sted N, heim N
bálddis N: kveite N _ kveite N _ SAME
máksu N: betaling N; betydning N _ betaling N; betydning N _ SAME
bárdni N: sønn N; gutt N _ gutt N; sønn N
bárku N: bark N _ bark N _ SAME
bárra N: par N _ par N _ SAME
párra N: par N _ par N _ SAME
bátnedoavttir N: tannlege N _ tannlege N _ SAME
bávččas N: smerte N _ smerte N _ SAME
vuoissahat N: smerte N _ sting N, smerte N
gihpu N: smerte N _ smerte N _ SAME
báŋku N: bank N _ bank N _ SAME
gráda N: grad N _ grad N _ SAME
cealkka N: setning N; uttrykk N _ setning N; uttrykk N _ SAME
cuoŋománnu N: april N _ april N _ SAME
savu N: kulp N _ kulp N, stilleflytende strekning i elva N
savvon N: kulp N _ kulp N _ SAME
dappal N: kulp N _ kulp N, bakevje N
jorbmi N: kulp N _ djup kulp N; myrhull N
darfegoahti N: torvgamme N _ torvgamme N _ SAME
darfi N: torv N _ torv N _ SAME
lavdnji N: torv N _ torv N _ SAME
daŋas N: lyng N _ lyng N _ SAME
teadja N: te N _ te N _ SAME
deadja N: te N _ te N _ SAME
deahkki N: muskel N _ muskel N _ SAME
departemeanta N: departement N _ departement N _ SAME
diehtemeahttunvuohta N: uvitenhet N _ uvitenhet N _ SAME
dieđa N: vitenskap N; kunnskap N _ vitenskap N
dieđáhus N: melding N _ melding N _ SAME
diggegoddi N: tingrett N _ tingrett N _ SAME
dihtorspeallu N: dataspill N _ dataspill N _ SAME
tiibma N: time N _ time N, klokke N
tiibmu N: time N _ time N; ur N, klokke N
juksu N: hyse N _ hyse N _ SAME
diksu N: hyse N _ hyse N, kolje N
dikta N: dikt N _ dikt N _ SAME
maŋŋebárga N: tirsdag N _ tirsdag N _ SAME
disdat N: tirsdag N _ tirsdag N _ SAME
vearru N: avgift N; skatt N _ skatt N, avgift N
divat N: avgift N _ avgift N _ SAME
divri N: insekt N _ dyr N, insekt N
doaivva N: håp N _ håp N _ SAME
doaivu N: håp N; tro N _ håp N
doardna N: tårn N _ tårn N _ SAME
toardna N: tårn N _ tårn N _ SAME
doavttir N: lege N _ lege N, doktor N
dolla N: bål N; ild N _ bål N, ild N
dovdu N: følelse N; erfaring N _ følelse N; erfaring N _ SAME
dronnet N: dronning N _ dronning N _ SAME
dulka N: tolk N _ tolk N _ SAME
dulvi N: flom N _ flom N _ SAME
duogáš N: bakgrunn N _ bakgrunn N _ SAME
tuollu N: toll N _ toll N _ SAME
duollu N: toll N; toll N _ tele N; toll N
duolva N: skitt N _ smuss N, skitt N
luhča N: skitt N _ skitt N, avføring N, søle N
riekti N: domstol N; rett N; rett N; rettighet N _ rett N, domstol N
duopmostuollu N: domstol N _ domstol N _ SAME
duopmár N: dommer N _ dommer N _ SAME
duorastat N: torsdag N _ torsdag N _ SAME
duottarstohpu N: fjellstue N _ fjellstue N _ SAME
fearrán N: hendelse N _ hending N, hendelse N
dálki N: vær N _ vær N _ SAME
vierca N: vær N _ vær N _ SAME
fierca N: vær N _ vær N _ SAME
viessu N: hus N; bolig N _ hus N
dálvi N: vinter N _ vinter N _ SAME
dárbu N: behov N _ behov N _ SAME
dássi N: nivå N _ jamnhøyde N; nivå N
dáža N: nordmann N _ nordmann N _ SAME
dáčča N: nordmann N _ nordmann N, svenske N
eahket N: kveld N _ kveld N _ SAME
eanu N: onkel N _ onkel N _ SAME
čeahci N: onkel N _ onkel N _ SAME
eahki N: onkel N _ onkel N _ SAME
eahpeluohttámuš N: mistillit N _ mistillit N _ SAME
eahpedorvu N: mistillit N _ mistillit N _ SAME
eahpeluohttámuševttohus N: mistillitsforslag N _ mistillitsforslag N _ SAME
eahpádus N: tvil N _ tvil N; betenkelighet N, skepsis N
sarvva N: elg N _ elg N _ SAME
ealga N: elg N _ elg N _ SAME
eallin N: liv N _ liv N, leven N
heagga N: liv N _ liv N _ SAME
eallindilálašvuohta N: livssituasjon N; levekår N _ livssituasjon N
eallindilli N: livssituasjon N; levekår N _ livssituasjon N
eallingeardi N: livsløp N _ livsløp N _ SAME
eallu N: flokk N; reinflokk N _ flokk N, reinflokk N
boazoeallu N: reinflokk N _ reinflokk N _ SAME
eallinláibi N: levebrød N _ levebrød N _ SAME
eallámuš N: levebrød N _ levebrød N _ SAME
ealáhusfoanda N: næringsfond N _ næringsfond N _ SAME
ealáhuspolitihkka N: næringspolitikk N _ næringspolitikk N _ SAME
áhkká N: kone N _ hustru N, kone N
gálgu N: kone N _ kone N, hustru N
eamit N: kone N _ hustru N, kone N
eatnandoallu N: jordbruk N _ jordbruk N _ SAME
eanadoallu N: jordbruk N; landbruk N _ jordbruk N
eanandoallu N: jordbruk N; landbruk N _ jordbruk N
eananspábba N: jordklode N; jord N _ jordklode N
eatnanspábba N: jordklode N _ jordklode N _ SAME
eanetlohku N: flertall N _ flertall N _ SAME
eatnigiella N: morsmål N _ morsmål N _ SAME
eiseváldi N: myndighet N _ myndighet N _ SAME
ekologiija N: økologi N _ økologi N _ SAME
ekonoma N: økonom N _ økonom N _ SAME
elliidsuodjaleapmi N: dyrevern N _ dyrevern N _ SAME
erenoamášoahpahus N: spesialundervisning N _ spesialundervisning N _ SAME
erenoamášpedagogihkka N: spesialpedagogikk N _ spesialpedagogikk N _ SAME
eretcealkin N: oppsigelse N _ oppsigelse N _ SAME
etihkka N: etikk N _ etikk N _ SAME
evangelium N: evangelium N _ evangelium N _ SAME
eŋgel N: engel N _ engel N _ SAME
čiehka N: krok N _ hjørne N, krok N
faggi N: krok N _ krok N, knagg N
roahkki N: krok N; hake N _ krok N, hake N; hektekrok N, malje N
vanca N: båt N _ båt N _ SAME
vanas N: båt N _ båt N _ SAME
fanas N: båt N; fartøy N _ båt N
fiila N: fil N _ fil N _ SAME
filbma N: film N _ film N _ SAME
finjučála N: kursiv N _ kursiv N _ SAME
firkkal N: forkle N _ forkle N _ SAME
foanda N: fond N _ fond N _ SAME
foarbma N: form N _ form N _ SAME
friddjaminuhtta N: friminutt N _ friminutt N _ SAME
friijaminuhtta N: friminutt N _ friminutt N _ SAME
fylka N: fylke N _ fylke N _ SAME
fylkkagielda N: fylkeskommune N _ fylkeskommune N _ SAME
fylkkasuohkan N: fylkeskommune N _ fylkeskommune N _ SAME
fylkkamánni N: fylkesmann N _ fylkesmann N _ SAME
fága N: fag N _ fag N _ SAME
fágasearvi N: fagforening N _ fagforening N _ SAME
fáhcca N: vott N _ vott N _ SAME
fápmu N: makt N; kraft N; styrke N _ makt N, styrke N
fáttar N: fadder N _ fadder N _ SAME
risváhnen N: fadder N _ fadder N _ SAME
gahpir N: lue N _ lue N _ SAME
galbmaskábe N: kjøleskap N _ kjøleskap N _ SAME
ganjal N: tåre N _ tåre N _ SAME
gaskaahki N: middelalder N _ middelalder N _ SAME
gaskaáigi N: middelalder N _ middelalder N _ SAME
gaskafága N: mellomfag N _ mellomfag N _ SAME
gaskavahkku N: onsdag N _ onsdag N _ SAME
gassačoalli N: tykktarm N _ tykktarm N _ SAME
dopmu N: støv N _ støv N _ SAME
gavja N: støv N _ støv N _ SAME
gažaldat N: spørsmål N _ spørsmål N _ SAME
jearaldat N: spørsmål N _ spørsmål N _ SAME
geahpis N: lunge N _ lunge N _ SAME
geallir N: kjeller N _ kjeller N _ SAME
keallir N: kjeller N _ kjeller N _ SAME
geasseluopmu N: sommerferie N _ sommerferie N _ SAME
geassemánnu N: juni N _ juni N _ SAME
geassi N: sommer N _ sommer N _ SAME
geatki N: jerv N _ jerv N _ SAME
ovddasvástádus N: ansvar N _ ansvar N _ SAME
gielda N: kommune N _ kommune N; sogn N
suohkan N: kommune N _ kommune N; sogn N; herred N
gielddaráđđehus N: kommunestyre N _ kommunestyre N _ SAME
gielddastivra N: kommunestyre N _ kommunestyre N _ SAME
suohkanstivra N: kommunestyre N _ kommunestyre N _ SAME
gielis N: løgn N _ løgn N; løgner N
giellafága N: språkfag N _ språkfag N _ SAME
giellaprošeakta N: språkprosjekt N _ språkprosjekt N _ SAME
giellaráđđi N: språkråd N _ språkråd N _ SAME
skállu N: bøtte N _ bøtte N _ SAME
kievkkan N: kjøkken N _ kjøkken N _ SAME
gievkkan N: kjøkken N _ kjøkken N _ SAME
gievkkanhoavda N: kjøkkensjef N _ kjøkkensjef N _ SAME
gikta N: skyss N _ synkestein N, vekt N; skyss N
sáhttu N: skyss N _ skyss N _ SAME
siidu N: side N _ side N _ SAME
gilga N: side N _ side N _ SAME
gilisearvi N: bygdelag N _ bygdelag N _ SAME
giliskuvla N: grendeskole N _ grendeskole N _ SAME
gilvu N: konkurranse N; kamp N _ konkurranse N
gilvvohallan N: konkurranse N _ konkurranse N _ SAME
gilvva N: sæd N _ sæd N, frø N
gilvvagárdi N: hage N _ hage N _ SAME
ginttal N: stearinlys N _ talglys N, stearinlys N
girji N: bok N _ bok N; brev N; flekk i pelsen N
girjjálašvuohta N: litteratur N _ litteratur N _ SAME
kirku N: kirke N _ kirke N _ SAME
girku N: kirke N _ kirke N _ SAME
giđđa N: vår N _ vår N _ SAME
goarrunmašiidna N: symaskin N _ symaskin N _ SAME
goaskin N: ørn N _ ørn N _ SAME
neahkameahttun N: spøkelse N _ spøkelse N _ SAME
gobmi N: spøkelse N _ spøkelse N _ SAME
goikeguolli N: tørrfisk N _ klippfisk N; tørrfisk N
golggotmánnu N: oktober N _ oktober N _ SAME
gonagasbárdni N: prins N _ kongssønn N, prins N
prinsa N: prins N _ prins N _ SAME
gordni N: korn N _ korn N _ SAME
gorrelohku N: forholdstall N _ forholdstall N _ SAME
guorssahat N: hoste N _ hoste N _ SAME
gosahat N: hoste N _ hoste N _ SAME
govdodat N: bredde N _ bredde N _ SAME
lahttu N: medlem N _ medlem N, lem N
miellahttu N: medlem N _ medlem N _ SAME
gullevašvuohta N: identitet N; tilknytning N _ tilhørighet N; identitet N
identitehta N: identitet N _ identitet N _ SAME
gullu N: hørsel N _ hørsel N _ SAME
gummestevvel N: gummistøvel N _ gummistøvel N _ SAME
stálpi N: ulv N _ ulv N _ SAME
gumpe N: ulv N _ ulv N _ SAME
guoika N: stryk N _ stryk N, fossestryk N
guoksa N: melke N _ melke N _ SAME
guolbi N: golv N _ jordgolv N, golv N
lieksi N: tran N _ tran N _ SAME
guolevuodja N: tran N _ fiskeleverolje N, tran N
guopparas N: svamp N _ svamp N _ SAME
guossa N: gran N _ gran N _ SAME
guovvamánnu N: februar N _ februar N _ SAME
kursa N: kurs N _ kurs N _ SAME
gursa N: kurs N _ kurs N _ SAME
gussa N: ku N _ ku N _ SAME
gutna N: aske N _ aske N _ SAME
guvžá N: sjøaure N _ sjøaure N, sjøørret N
gužža N: urin N _ tiss N, urin N
gáddenuohtti N: landnot N _ landnot N _ SAME
káffe N: kaffe N _ kaffe N _ SAME
gáffe N: kaffe N _ kaffe N _ SAME
gáhkku N: kake N _ kake N _ SAME
gáhttu N: katt N _ hustak N; katt N
gáica N: geit N _ geit N _ SAME
ája N: kilde N _ kilde N _ SAME
gáldu N: kilde N _ kilde N _ SAME
gálla N: kål N _ kål N _ SAME
gálvobiila N: varebil N _ varebil N _ SAME
gámmár N: rom N _ kammer N, rom N
áidi N: gjerde N _ gjerde N _ SAME
gárdi N: gjerde N _ innhegning N; gjerde N; rypesnare med risgjerde N
kárta N: kart N _ kart N _ SAME
gárta N: kart N _ kart N _ SAME
gásta N: dåp N _ dåp N _ SAME
gávppašeapmi N: handel N; omsetning N _ handel N
gávpot N: by N _ by N _ SAME
bálkkašupmi N: pris N _ pris N, belønning N, premie N
haddi N: pris N _ pris N _ SAME
headjaskeaŋka N: bryllupsgave N _ bryllupsgave N _ SAME
heahpat N: skam N _ skam N _ SAME
heahtedoarjja N: krisehjelp N _ krisehjelp N _ SAME
heahti N: nød N _ nød N _ SAME
heasta N: hest N _ hest N _ SAME
vuoján N: hest N; kjøretøy N _ kjørerein N; hest N
hiida N: helvete N _ helvete N _ SAME
helvet N: helvete N _ helvete N _ SAME
hersko N: delikatesse N _ delikatesse N; god mat N
hivsset N: do N _ do N, WC N, toalett N
hiŋggal N: bås N _ bås N _ SAME
hoahkan N: regle N; rim N _ regle N
hoammá N: dreng N _ same vestfra N; dreng N, arbeidskar N
reaŋga N: dreng N _ dreng N _ SAME
homofiliija N: homofili N _ homofili N _ SAME
hutkáivuohta N: kreativitet N _ kreativitet N _ SAME
hábmen N: utforming N _ utforming N _ SAME
háhcci N: skritt N _ skrev N, skritt N
lávki N: skritt N _ løk N; skritt N, steg N
háhtta N: hatt N _ hatt N _ SAME
hálddašanláhka N: forvaltningslov N _ forvaltningslov N _ SAME
hálddahusláhka N: forvaltningslov N _ forvaltningslov N _ SAME
hálddašeapmi N: forvaltning N _ forvaltning N _ SAME
hápman N: havn N _ havn N _ SAME
hástalus N: utfordring N _ utfordring N _ SAME
hávdi N: grav N _ grav N _ SAME
idja N: natt N _ natt N _ SAME
illu N: glede N _ glede N _ SAME
institušuvdna N: institusjon N _ institusjon N _ SAME
interneahtta N: internett N _ internett N _ SAME
internáhtta N: internat N _ internat N _ SAME
moarsi N: kjæreste N _ kjæreste N; brud N
irgi N: kjæreste N _ kjæreste N; frier N; brudgom N
iđit N: morgen N _ morgen N _ SAME
jahkebealli N: halvår N _ halvår N _ SAME
jahkegeahččaleapmi N: årsprøve N _ årsprøve N _ SAME
jahkečoahkkin N: årsmøte N _ årsmøte N _ SAME
jahki N: år N _ år N _ SAME
jeaggi N: myr N _ myr N _ SAME
jeđđehus N: trøst N _ trøst N _ SAME
jiekŋa N: is N _ is N _ SAME
jienastanlihppu N: stemmeseddel N _ stemmeseddel N _ SAME
jietna N: stemme N _ lyd N; stemme N
joavkobargu N: gruppearbeid N _ gruppearbeid N _ SAME
joavkočoahkkin N: gruppemøte N _ gruppemøte N _ SAME
journalista N: journalist N _ journalist N _ SAME
jođas N: kabel N _ kabel N _ SAME
šuvva N: sus N _ sus N _ SAME
julggaštus N: erklæring N _ erklæring N; manifest N
juolgemihttu N: fot N _ fot N _ SAME
juovlafeasta N: julefest N _ julefest N _ SAME
juovlagoarta N: julekort N _ julekort N _ SAME
juovlakoarta N: julekort N _ julekort N _ SAME
juovlaluopmu N: juleferie N _ juleferie N _ SAME
juovlaruohtta N: julaften N _ julaften N _ SAME
juovlastállu N: julenisse N _ julenisse N _ SAME
jurdda N: tanke N; ide N; idé N _ tanke N
jáffu N: mel N; melsekk N _ mel N
jáhkka N: jakke N _ jakke N _ SAME
kantuvra N: kontor N _ kontor N _ SAME
kloáhkka N: kloakk N _ kloakk N _ SAME
skuvlalatnja N: klasserom N _ klasserom N _ SAME
luohkkálatnja N: klasserom N _ klasserom N _ SAME
klássalatnja N: klasserom N _ klasserom N _ SAME
kommišuvdna N: kommisjon N _ kommisjon N _ SAME
konsearta N: konsert N _ konsert N _ SAME
risttalašvuohta N: kristendom N _ kristendom N _ SAME
kristtalašvuohta N: kristendom N _ kristendom N _ SAME
ruvdnu N: krone N _ krone N _ SAME
kruvdna N: krone N _ krone N _ SAME
ránnjá N: nabo N _ nabo N _ SAME
kránnjá N: nabo N _ nabo N _ SAME
siidaguoibmi N: nabo N _ nabo N _ SAME
kulturfoanda N: kulturfond N _ kulturfond N _ SAME
kultuvra N: kultur N _ kultur N _ SAME
kántorhoavda N: kontorsjef N _ kontorsjef N _ SAME
lagasbiras N: nærmiljø N _ nærmiljø N _ SAME
lagašbiras N: nærmiljø N _ nærmiljø N _ SAME
lahkki N: halvdel N _ halvdel N, halvpart N
lassigollu N: merutgift N _ merutgift N _ SAME
lasseárvu N: merverdi N _ merverdi N _ SAME
lađas N: ledd N _ ledd N _ SAME
leansmánni N: lensmann N _ lensmann N _ SAME
leavga N: flagg N _ flagg N; fane N
leavgastággu N: flaggstang N _ flaggstang N _ SAME
liepma N: buljong N _ buljong N _ SAME
lieđđi N: blomst N _ blomst N _ SAME
lihkku N: lykke N _ lykke N _ SAME
roassu N: ulykke N _ ulykke N; tap N
lihkohisvuohta N: ulykke N _ ulykke N _ SAME
lihkuhisvuohta N: ulykke N _ ulykke N _ SAME
linjála N: linjal N _ linjal N _ SAME
loddi N: fugl N _ fugl N _ SAME
logeš N: tier N _ titall N, tier N
logus N: lesestoff N _ lesestoff N _ SAME
lohkamuš N: lesestoff N _ lesestoff N _ SAME
lohku N: tall N; antall N _ tall N, antall N
láhka N: lov N _ lov N; lake N
máddi N: sør N _ sør N _ SAME
lulli N: sør N _ sør N _ SAME
davvisápmi N: nordsame N _ nordsame N _ SAME
davvisápmelaš N: nordsame N _ nordsame N _ SAME
luondu N: natur N; karakter N _ natur N; karakter N _ SAME
árvosátni N: karakter N _ karakter N _ SAME
luopmu N: ferie N _ ferie N _ SAME
luossa N: laks N _ laks N _ SAME
luossabivdu N: laksefiske N _ laksefiske N _ SAME
láddelaš N: kven N _ finne N, kven N; svenske N
kvena N: kven N _ kven N _ SAME
láibevajahas N: brødskive N _ brødskive N _ SAME
láibi N: brød N _ brød N _ SAME
láivi N: skip N _ skip N _ SAME
skiipa N: skip N; fartøy N _ skip N
lámpu N: lampe N _ lampe N _ SAME
lámpá N: lampe N _ lampe N _ SAME
lávdi N: scene N; plattform N _ scene N; plattform N; podium N
lávvardat N: lørdag N _ lørdag N _ SAME
lávvordat N: lørdag N _ lørdag N _ SAME
ávju N: egg N _ egg N _ SAME
manni N: egg N _ egg N _ SAME
monni N: egg N _ egg N _ SAME
mašiidna N: maskin N _ maskin N _ SAME
mearaguolli N: saltvannsfisk N _ saltvannsfisk N _ SAME
mearraguolli N: saltvannsfisk N _ saltvannsfisk N _ SAME
mearkkašupmi N: betydning N; merknad N _ betydning N; merknad N _ SAME
mearra N: hav N; sjø N _ hav N, sjø N
áhpi N: hav N _ vid myrstrekning N, treløs slette N; hav N
mearrasápmi N: sjøsame N _ sjøsame N _ SAME
mearrasápmelaš N: sjøsame N _ sjøsame N _ SAME
skáhpi N: rogn N _ rogn N, rognetre N
meađđen N: rogn N _ rogn N _ SAME
mehter N: meter N _ meter N _ SAME
oaivil N: mening N _ mening N _ SAME
meinnet N: mening N _ mening N _ SAME
miehkki N: sverd N _ sverd N _ SAME
mielki N: melk N _ melk N _ SAME
skoaddu N: tåke N _ skodde N, tåke N
mierká N: tåke N _ tåke N, skodde N
miessemánnu N: mai N _ mai N _ SAME
ministtar N: minister N _ minister N _ SAME
minuhtta N: minutt N _ minutt N _ SAME
modji N: smil N _ smil N _ SAME
mutuvra N: motor N _ motor N _ SAME
mohtor N: motor N _ motor N _ SAME
mátta N: rot N _ rot N; nederste del N
moivi N: rot N _ rot N, grums N
máddu N: rot N _ rot N; opprinnelse N
ruohtas N: rot N; opprinnelse N _ rot N
kulturmuitu N: kulturminne N _ kulturminne N _ SAME
muitu N: minne N _ minne N, hukommelse N
nierra N: kinn N _ kinn N _ SAME
muohtu N: kinn N _ kinn N _ SAME
muorji N: bær N _ bær N _ SAME
musihkka N: musikk N _ musikk N _ SAME
vuossárga N: mandag N _ mandag N _ SAME
mánnodat N: mandag N _ mandag N _ SAME
mánáidboddu N: barnetime N _ barnetime N _ SAME
mánáidgárdi N: barnehage N _ barnehage N _ SAME
mánáidmánná N: barnebarn N _ barnebarn N _ SAME
áhkkut N: barnebarn N _ barnebarn N _ SAME
áddjut N: barnebarn N _ barnebarn N _ SAME
márfi N: pølse N _ pølse N _ SAME
čoahkkebáiki N: tettsted N _ tettsted N _ SAME
reaisu N: reise N _ reise N _ SAME
namma N: navn N _ navn N _ SAME
neavttár N: skuespiller N _ skuespiller N _ SAME
ráđđi N: råd N _ råd N _ SAME
neavva N: råd N; anbefaling N _ råd N, formaning N
niehkki N: nakke N _ nakke N _ SAME
niski N: nakke N _ nakke N _ SAME
niehku N: drøm N _ drøm N _ SAME
niibeboagán N: knivbelte N _ knivbelte N, belte med kniv N
niibi N: kniv N _ kniv N _ SAME
nisu N: kvinne N _ kvinne N _ SAME
nissonolmmoš N: kvinne N _ kvinne N _ SAME
nisson N: kvinne N _ kvinne N _ SAME
njukčamánnu N: mars N _ mars N _ SAME
njunni N: nese N _ nese N _ SAME
njuovvanrusttet N: slakteri N _ slakteri N _ SAME
njuovahat N: slakteri N _ slakteri N _ SAME
njuovčča N: tunge N _ tunge N _ SAME
njárga N: nes N _ nes N; halvøy N
nummir N: nummer N _ nummer N _ SAME
nummar N: nummer N _ nummer N _ SAME
nummár N: nummer N _ nummer N _ SAME
nuohtti N: not N _ not N _ SAME
nuoraidskuvla N: ungdomsskole N _ ungdomsskole N _ SAME
návet N: fjøs N _ fjøs N _ SAME
návste N: naust N _ naust N; skjul N, skur N
návstu N: naust N _ naust N _ SAME
oabbá N: søster N; søsken N _ søster N
oahpahus N: undervisning N; utdanning N; opplæring N _ undervisning N
oaivegávpot N: hovedstad N _ hovedstad N _ SAME
oaivi N: hode N _ hode N _ SAME
oaksi N: grein N; kvist N _ grein N, kvist N
oamedovdu N: samvittighet N _ samvittighet N _ SAME
oarra N: snøre N _ snøre N, tau N
olgoriika N: utland N _ utlandet N
olju N: olje N _ olje N _ SAME
organisašuvdna N: organisasjon N _ organisasjon N _ SAME
orgána N: organ N _ organ N _ SAME
ossodat N: avdeling N; andel N _ andel N; avdeling N
ovdamearka N: eksempel N _ eksempel N _ SAME
ođas N: nyhet N _ nyhet N _ SAME
ođđajagemánnu N: januar N _ januar N _ SAME
plána N: plan N _ plan N _ SAME
politihkka N: politikk N _ politikk N _ SAME
preassadieđáhus N: pressemelding N _ pressemelding N _ SAME
prográmma N: program N _ program N _ SAME
proseanta N: prosent N _ prosent N _ SAME
páhkka N: pakke N _ pakke N _ SAME
ragat N: brunst N _ brunst N _ SAME
ragatáigi N: brunst N _ brunst N _ SAME
raporta N: rapport N _ rapport N _ SAME
reahka N: slede N _ slede N _ SAME
riegádanbeaiskeaŋka N: bursdagsgave N _ fødselsdagsgave N, bursdagsgave N
rievssat N: rype N; lirype N _ rype N, lirype N
rihppaskuvla N: konfirmasjonsskole N _ konfirmasjonsskole N _ SAME
riikkajoavku N: landslag N _ landslag N _ SAME
risku N: sølje N _ sølje N _ SAME
solju N: sølje N _ sølje N _ SAME
rista N: kors N _ kors N _ SAME
ristáhčči N: gudfar N _ gudfar N _ SAME
riššu N: dusj N _ dusj N _ SAME
rovvi N: bru N _ enkel bru N; bru N; stoppskive N
šaldi N: bru N; bro N _ bru N
ruovdi N: jern N _ jern N _ SAME
ruovttusiidu N: hjemmeside N _ hjemmeside N _ SAME
ruošša N: russer N _ russer N _ SAME
ruvke N: gruve N; verk N _ gruve N
rádji N: grense N _ grense N _ SAME
rádjá N: grense N _ grense N _ SAME
ráhkesvuohta N: kjærlighet N _ kjærlighet N _ SAME
ráhkisvuohta N: kjærlighet N _ kjærlighet N _ SAME
rávdi N: smed N _ smed N _ SAME
ráđđealmmái N: rådmann N _ rådmann N _ SAME
gielddahoavda N: rådmann N _ rådmann N _ SAME
ráđđeolmmái N: rådmann N _ rådmann N _ SAME
ráđđehus N: regjering N _ regjering N _ SAME
ráđđeviessu N: rådhus N _ rådhus N _ SAME
sahá N: sag N _ sag N _ SAME
sarrit N: blåbær N _ blåbær N _ SAME
seaidni N: vegg N _ vegg N _ SAME
sealgi N: rygg N _ rygg N _ SAME
searvi N: forening N; selskap N _ forening N, selskap N
seaŋga N: seng N _ seng N _ SAME
seminára N: seminar N _ seminar N _ SAME
sihkkel N: sykkel N _ sykkel N _ SAME
silba N: sølv N _ sølv N _ SAME
silki N: silke N _ silke N; silketørkle N
sirpe N: sigd N _ sigd N _ SAME
siseana N: innland N _ innland N _ SAME
sudja N: årsak N; grunn N _ årsak N, grunn N; skyld N
sivva N: årsak N; grunn N _ grunn N, årsak N
skuvla N: skole N _ skole N _ SAME
skuvlabeaivi N: skoledag N _ skoledag N _ SAME
skuvlatiibma N: skoletime N _ skoletime N _ SAME
skuvladiibmu N: skoletime N _ skoletime N _ SAME
skuvlafága N: skolefag N _ skolefag N _ SAME
skuvlajahki N: skoleår N _ skoleår N _ SAME
skuvlašillju N: skolegård N _ skolegård N _ SAME
skábmamánnu N: november N _ november N _ SAME
skárfa N: skarv N _ skarv N _ SAME
soabbi N: stav N _ stav N, kjepp N
soahki N: bjørk N _ bjørk N _ SAME
šiehtadus N: avtale N _ avtale N _ SAME
soahti N: krig N _ krig N _ SAME
soalddát N: soldat N _ soldat N _ SAME
sohkabealli N: kjønn N _ kjønn N _ SAME
sohkar N: sukker N _ sukker N _ SAME
sotnabeaivi N: søndag N _ søndag N _ SAME
speadjal N: speil N _ speil N _ SAME
speajal N: speil N _ speil N _ SAME
speallu N: spill N _ spill N _ SAME
spábba N: ball N _ ball N _ SAME
spáiddar N: fakkel N _ fakkel N, bluss N
spánnja N: spann N _ spann N _ SAME
stoagus N: leke N; lek N _ leke N, leketøy N
čuolda N: stolpe N _ stolpe N _ SAME
stoalpu N: stolpe N _ stolpe N _ SAME
viessogálvu N: møbel N _ møbel N _ SAME
strategiija N: strategi N _ strategi N _ SAME
studeanta N: student N _ student N _ SAME
stuollu N: stol N _ stol N _ SAME
stállja N: stall N _ stall N _ SAME
stávval N: stavelse N _ stavelse N _ SAME
summá N: sum N _ sum N _ SAME
submi N: sum N; beløp N _ sum N
suddu N: synd N _ synd N _ SAME
suolu N: øy N _ øy N, holme N
suomagiella N: finsk N _ finsk N _ SAME
suorbma N: finger N _ finger N _ SAME
sáidi N: sei N _ sei N _ SAME
sálbma N: salme N _ salme N _ SAME
sálbmagirji N: salmebok N _ salmebok N _ SAME
sámediggejoavku N: sametingsgruppe N _ sametingsgruppe N _ SAME
sámegielkursa N: samiskkurs N _ samiskkurs N _ SAME
sámeláhka N: samelov N _ sameloven N
sámepolitihkka N: samepolitikk N _ samepolitikk N _ SAME
sámil N: mose N _ mose N _ SAME
sápmi N: same N _ same N _ SAME
sápmelaš N: same N _ same N _ SAME
sátnegirji N: ordbok N _ ordbok N _ SAME
sátneluohkká N: ordklasse N _ ordklasse N _ SAME
sátni N: ord N _ ord N _ SAME
sátta N: sending N _ sending N _ SAME
sáttobábir N: sandpapir N _ sandpapir N _ SAME
sávdni N: dampbad N _ dampbad N, sauna N
sávdnji N: søm N _ søm N; badstue N
sávza N: sau N _ sau N _ SAME
teaksta N: tekst N _ tekst N _ SAME
tealtá N: telt N _ telt N _ SAME
teknihkkár N: tekniker N _ tekniker N _ SAME
telefovdna N: telefon N _ telefon N _ SAME
telegrámma N: telegram N _ telegram N _ SAME
teáhter N: teater N _ teater N _ SAME
toga N: tog N _ tog N _ SAME
linnjábiila N: tog N _ rutebuss N; tog N
tráktor N: traktor N _ traktor N _ SAME
turista N: turist N _ turist N _ SAME
távval N: tavle N _ tavle N _ SAME
uksa N: dør N _ dør N _ SAME
ulbmil N: formål N; mål N _ mål N, formål N
universitehta N: universitet N _ universitet N _ SAME
universiteahtta N: universitet N _ universitet N _ SAME
uvja N: dun N _ dun N _ SAME
vahkku N: uke N _ uke N _ SAME
vahát N: skade N; tap N; uhell N _ skade N, tap N; uhell N, vanvare N
varra N: blod N _ blod N _ SAME
vašši N: hat N _ hat N _ SAME
veahkki N: hjelp N _ hjelp N _ SAME
veaiki N: kobber N _ kobber N _ SAME
vealgi N: gjeld N _ gjeld N _ SAME
vearju N: våpen N _ våpen N _ SAME
vejolašvuohta N: mulighet N _ mulighet N _ SAME
vihtan N: vitne N _ vitne N _ SAME
vilba N: fetter N _ fetter N; tremenning N
vilbealle N: fetter N; søskenbarn N _ fetter N
virgi N: embete N; stilling N _ stilling N, embete N
vuodja N: smør N _ smør N, fett N
vuokta N: hår N _ hår N _ SAME
vuolla N: øl N _ øl N _ SAME
vuola N: øl N _ øl N _ SAME
vuolgga N: avreise N; opprinnelse N _ opprinnelse N; start N; avreise N
vuorbi N: skjebne N _ lodd N, skjebne N
eallinvuorbi N: skjebne N _ skjebne N _ SAME
vuotna N: fjord N _ fjord N _ SAME
vuovdi N: skog N _ skog N _ SAME
vuođđoealáhus N: primærnæring N _ basisnæring N, primærnæring N
vuođđoláhka N: grunnlov N _ grunnloven N
vuođđoskuvla N: grunnskole N _ grunnskole N _ SAME
váibmu N: hjerte N _ hjerte N _ SAME
váldoášši N: hovedsak N _ hovedsak N _ SAME
presideanta N: president N _ president N _ SAME
vástádus N: svar N _ svar N _ SAME
vásáhus N: opplevelse N; erfaring N _ opplevelse N
áddjá N: bestefar N _ bestefar N; gammel mann N
áhkku N: bestemor N _ bestemor N; eldre kvinne N
áhčči N: far N _ far N _ SAME
áibmu N: luft N _ luft N _ SAME
áigi N: tid N _ tid N _ SAME
áitta N: trussel N _ trussel N _ SAME
ákšu N: øks N _ øks N _ SAME
álbmot N: folk N; befolkning N _ folk N
álbmotmusihkka N: folkemusikk N _ folkemusikk N _ SAME
álbmotriekti N: folkerett N _ folkerett N _ SAME
álbmotčoahkkin N: folkemøte N _ folkemøte N _ SAME
álgu N: begynnelse N; opprinnelse N _ begynnelse N
ámtamánni N: amtmann N _ amtmann N _ SAME
árba N: arr N _ arr N _ SAME
árbbolaš N: arving N _ arving N _ SAME
árbevierru N: tradisjon N _ tradisjon N _ SAME
árbi N: arv N _ arv N _ SAME
árbmu N: nåde N _ nåde N; amnesti N
árgabeaivi N: hverdag N _ hverdag N _ SAME
árga N: hverdag N _ hverdag N _ SAME
árka N: ark N _ ark N _ SAME
ásodatbáiki N: boligfelt N _ boligfelt N _ SAME
ássandoarjja N: bostøtte N _ bostøtte N _ SAME
klieanta N: klient N _ klient N _ SAME
áššehas N: klient N _ klient N _ SAME
čakča N: høst N _ høst N _ SAME
čakčaluopmu N: høstferie N _ høstferie N _ SAME
čakčamánnu N: september N _ september N _ SAME
čalbmi N: øye N _ øye N; garnmaske N, maske N
šalbmi N: øye N _ nåløye N; øye N
čeavrris N: oter N _ oter N _ SAME
čielgamielki N: helmelk N _ helmelk N _ SAME
čievra N: grus N _ grus N _ SAME
čoahkkinplána N: møteplan N _ møteplan N _ SAME
čoalus N: tarm N _ tarm N _ SAME
čoarveduodji N: hornsløyd N _ hornsløyd N _ SAME
čoavdda N: nøkkel N _ nøkkel N _ SAME
čoavddasátni N: stikkord N _ nøkkelord N, stikkord N
čoavji N: mage N _ mage N _ SAME
čohkka N: fjelltopp N; topp N _ topp N, fjelltopp N
čuoiganbeaivi N: skidag N _ skidag N _ SAME
čuovgagovva N: lysbilde N _ lysbilde N, slide N
čuoččuhus N: påstand N _ påstand N; pretensjon N
čuvdi N: pekefinger N _ pekefinger N _ SAME
čuvla N: kjole N _ kjole N _ SAME
čájáhus N: utstilling N _ utstilling N _ SAME
čála N: skrift N _ skrift N; tegnsett N
čállingoddi N: sekretariat N _ sekretariat N _ SAME
čállingursa N: skrivekurs N _ skrivekurs N _ SAME
čállinkursa N: skrivekurs N _ skrivekurs N _ SAME
čállinmašiidna N: skrivemaskin N _ skrivemaskin N _ SAME
čáppagirjjálašvuohta N: skjønnlitteratur N _ skjønnlitteratur N _ SAME
šibit N: husdyr N _ husdyr N, fe N
šiehtadallan N: forhandling N _ forhandling N _ SAME
šiehtadallanvuorru N: forhandlingsrunde N _ forhandlingsrunde N _ SAME
šloahtta N: slott N _ slott N _ SAME
šárka N: sjark N _ sjark N _ SAME
duiskkagiella N: tysk N _ tysk språk N
dihtorfitnodat N: datafirma N _ datafirma N _ SAME
báŋkoloatna N: banklån N _ banklån N _ SAME
joganjálbmi N: elvemunning N _ elvemunning N _ SAME
ruvsu N: rose N _ rose N _ SAME
vearsa N: vers N _ vers N _ SAME
mearkabeaivi N: merkedag N _ merkedag N _ SAME
skuvlaskibir N: skolekamerat N _ skolekamerat N _ SAME
ovdagáddu N: fordom N _ fordom N _ SAME
guoddu N: holdning N _ holdning N _ SAME
miellaguoddu N: holdning N; innstilling N _ holdning N, innstilling N
bargoproseassa N: arbeidsprosess N _ arbeidsprosess N _ SAME
bargostipeanda N: arbeidsstipend N _ arbeidsstipend N _ SAME
boazodoalloagronoma N: reindriftsagronom N _ reindriftsagronom N _ SAME
boazodoallofoanda N: reindriftsfond N _ reindriftsfond N _ SAME
boazodoallofága N: reindriftsfag N _ reindriftsfag N _ SAME
boazodoalloguovlu N: reindriftsområde N; reinbeiteområde N _ reindriftsområde N, reinbeiteområde N
boazodoallopolitihkka N: reindriftspolitikk N _ reindriftspolitikk N _ SAME
buohkaidriekti N: allemannsrett N _ allemannsrett N _ SAME
buvttadanfitnodat N: produksjonsbedrift N _ produksjonsbedrift N _ SAME
bággovuovdin N: tvangssalg N _ tvangssalg N _ SAME
báikenammaprošeakta N: stedsnavnprosjekt N _ stedsnavnprosjekt N _ SAME
báktedáidda N: bergkunst N _ bergkunst N _ SAME
bálseduodji N: keramikk N _ keramikk N _ SAME
cára N: tsar N _ tsar N _ SAME
dahkkivuoigatvuohta N: opphavsrett N _ opphavsrett N _ SAME
diehtojuohkinkampánja N: informasjonskampanje N _ informasjonskampanje N _ SAME
diehtojuohkinčoahkkin N: informasjonsmøte N _ informasjonsmøte N _ SAME
dieđihandivat N: påmeldingsavgift N _ påmeldingsavgift N _ SAME
dieđihanskovvi N: påmeldingsskjema N _ påmeldingsskjema N _ SAME
diktáhtta N: diktat N _ diktat N _ SAME
direktoráhtta N: direktorat N _ direktorat N _ SAME
doaibmaboađus N: driftsresultat N _ driftsresultat N _ SAME
doaibmabušeahtta N: driftsbudsjett N _ driftsbudsjett N _ SAME
duopmostuolloláhka N: domstollov N _ domstollov N _ SAME
duottarguovlu N: fjellområde N _ fjellområde N _ SAME
dálááigi N: nåtid N _ nåtid N _ SAME
dásseárvopolitihkka N: likestillingspolitikk N _ likestillingspolitikk N _ SAME
dávdamearka N: sykdomstegn N; symptom N _ symptom N, sykdomstegn N
ealáhusdoaibma N: næringsvirksomhet N; næringsliv N _ næringsliv N, næringsvirksomhet N
ekspedišuvdnahoavda N: ekspedisjonssjef N _ ekspedisjonssjef N _ SAME
filbmafoanda N: filmfond N _ filmfond N _ SAME
fápmuiboahtin N: ikrafttredelse N _ ikrafttredelse N _ SAME
geaidnoláhka N: veglov N _ veglov N _ SAME
giellapolitihkka N: språkpolitikk N _ språkpolitikk N _ SAME
girjeprošeakta N: bokprosjekt N _ bokprosjekt N _ SAME
girkoláhka N: kirkelov N _ kirkelov N _ SAME
guolledávda N: fiskesykdom N _ fiskesykdom N _ SAME
guovllubuohcceviessu N: regionsykehus N _ regionsykehus N _ SAME
jahkedivat N: årsavgift N _ årsavgift N _ SAME
jearahallan N: intervju N _ intervju N, utspørring N
kontoplána N: kontoplan N _ kontoplan N _ SAME
kulturhistorjá N: kulturhistorie N _ kulturhistorie N _ SAME
kulturpolitihkka N: kulturpolitikk N _ kulturpolitikk N _ SAME
lappekommišuvdna N: lappekommisjon N _ lappekommisjon N _ SAME
luopmoláhka N: ferielov N _ ferielov N _ SAME
láhkadiggi N: lagting N _ lagting N _ SAME
láhkaevttohus N: lovforslag N _ lovforslag N _ SAME
láhkaárvalus N: lovforslag N _ lovforslag N _ SAME
láhkavuođđu N: hjemmel N _ hjemmel N _ SAME
lávdegoddečoahkkin N: komitémøte N _ komitémøte N _ SAME
lášmmohallanlatnja N: gymnastikksal N _ gymnastikksal N _ SAME
meahcceguovlu N: utmarksområde N _ utmarksområde N _ SAME
miellahttočoahkkin N: medlemsmøte N _ medlemsmøte N _ SAME
mánáidláhka N: barnelov N _ barnelov N _ SAME
mánáidsuodjalus N: barnevern N _ barnevern N _ SAME
nammariekti N: namsrett N _ namsrett N _ SAME
njunuščoahkkin N: toppmøte N _ toppmøte N _ SAME
nominašunčoahkkin N: nominasjonsmøte N _ nominasjonsmøte N _ SAME
nominašuvdnačoahkkin N: nominasjonsmøte N _ nominasjonsmøte N _ SAME
nuoraidpolitihkka N: ungdomspolitikk N _ ungdomspolitikk N _ SAME
nuoraidprošeakta N: ungdomsprosjekt N _ ungdomsprosjekt N _ SAME
rasisma N: rasisme N _ rasisme N _ SAME
oahpahusossodat N: opplæringsavdeling N _ opplæringsavdeling N _ SAME
oahppodoarjja N: utdanningsstønad N _ utdanningsstønad N _ SAME
oahppolihttu N: studieforbund N _ studieforbund N _ SAME
oahpponeavvokataloga N: læremiddelkatalog N _ læremiddelkatalog N _ SAME
oahpponeavvopedagogihkka N: læremiddelpedagogikk N _ læremiddelpedagogikk N _ SAME
oaiveskálžu N: hodeskalle N _ hodeskalle N _ SAME
oasseprošeakta N: delprosjekt N _ delprosjekt N _ SAME
olggosmáksin N: utbetaling N _ utbetaling N _ SAME
orohatplána N: distriktsplan N _ distriktsplan N _ SAME
ovdaskuvla N: førskole N _ førskole N _ SAME
plánačoavddus N: planløsning N _ planløsning N _ SAME
preassadoarjja N: pressestøtte N _ pressestøtte N _ SAME
preassaguovddáš N: pressesenter N _ pressesenter N _ SAME
preassakonferánsa N: pressekonferanse N _ pressekonferanse N _ SAME
preassapolitihkka N: pressepolitikk N _ pressepolitikk N _ SAME
prevenšuvdna N: prevensjon N _ prevensjon N _ SAME
psykiatriija N: psykiatri N _ psykiatri N _ SAME
reaidadoarjja N: kontantstøtte N _ kontantstøtte N _ SAME
refušuvdnagáibádus N: refusjonskrav N _ refusjonskrav N _ SAME
rehketdoallu N: regnskap N _ regnskap N _ SAME
riebansilba N: kråkesølv N _ kråkesølv N _ SAME
riektegáldu N: rettskilde N _ rettskilde N _ SAME
riektejoavku N: rettsgruppe N _ rettsgruppe N _ SAME
riikkapolitihkka N: rikspolitikk N _ rikspolitikk N _ SAME
rámmašiehtadus N: rammeavtale N _ rammeavtale N _ SAME
ráŋggáštusovddasvástádus N: straffansvar N _ straffansvar N _ SAME
sadjásaš N: vikar N _ vikar N _ SAME
seksualitehta N: seksualitet N _ seksualitet N _ SAME
servodatdieđa N: samfunnsvitenskap N _ samfunnsvitenskap N _ SAME
servodatstruktuvra N: samfunnsstruktur N _ samfunnsstruktur N _ SAME
sisamáksin N: innbetaling N _ innbetaling N _ SAME
skuvlabiras N: skolemiljø N _ skolemiljø N _ SAME
skuvlagievkkan N: skolekjøkken N _ skolekjøkken N _ SAME
skuvlahoavda N: skolesjef N _ skolesjef N _ SAME
skuvlakantuvra N: skolekontor N _ skolekontor N _ SAME
skuvlaneahtta N: skolenett N _ skolenett N _ SAME
skuvlapolitihkka N: skolepolitikk N _ skolepolitikk N _ SAME
skuvlaservodat N: skolesamfunn N _ skolesamfunn N _ SAME
skuvlasáhttu N: skoleskyss N _ skoleskyss N _ SAME
sohkarbihttá N: sukkerbit N _ sukkerbit N _ SAME
statistihkka N: statistikk N _ statistikk N _ SAME
streaŋga N: streng N _ streng N _ SAME
sáivačáhcebiologiija N: ferskvannsbiologi N _ ferskvannsbiologi N _ SAME
sámekonvenšuvdna N: samekonvensjon N _ samekonvensjon N _ SAME
tearbmaprošeakta N: termprosjekt N _ termprosjekt N _ SAME
vearba N: verb N _ verb N _ SAME
virgáibidjan N: ansettelse N _ ansettelse N _ SAME
vuojadeapmi N: svømming N _ svømming N _ SAME
sekunda N: sekund N _ sekund N _ SAME
luonddufága N: naturfag N _ naturfag N _ SAME
mearridanváldi N: beslutningsmyndighet N _ beslutningsmyndighet N _ SAME
ohppiidráđđi N: elevråd N _ elevråd N _ SAME
soahtefáŋga N: krigsfange N _ krigsfange N _ SAME
musihkkár N: musiker N _ musiker N _ SAME
musihkar N: musiker N _ musiker N _ SAME
professor N: professor N _ professor N _ SAME
lágádus N: forlag N _ forlag N _ SAME
bievlavuodjin N: barmarkskjøring N _ barmarkskjøring N _ SAME
euro N: euro N _ euro N _ SAME
helikopter N: helikopter N _ helikopter N _ SAME
sámeskuvla N: sameskole N _ sameskole N _ SAME
ohcanskovvi N: søknadsskjema N _ søknadsskjema N _ SAME
sámesearvi N: sameforening N _ sameforening N _ SAME
jávkan N: fravær N _ fravær N _ SAME
studio N: studio N _ studio N _ SAME
sáddehat N: studio N _ studio N _ SAME
grámma N: gram N _ gram N _ SAME
mánáidgárdesadji N: barnehageplass N _ barnehageplass N _ SAME
jahkedieđáhus N: årsmelding N _ årsmelding N _ SAME
arena N: arena N _ arena N _ SAME
eallinahki N: levealder N _ levealder N _ SAME
váldosivva N: hovedårsak N _ hovedårsak N _ SAME
giellanjuolggadus N: språkregel N _ språkregel N _ SAME
fágareive N: fagbrev N _ fagbrev N _ SAME
veterána N: veteran N _ veteran N _ SAME
girkogárdi N: kirkegård N _ kirkegård N _ SAME
klubba N: klubb N _ klubb N _ SAME
sámegielda N: samekommune N _ samekommune N _ SAME
sámenisu N: samekvinne N _ samekvinne N _ SAME
bargobeaivi N: arbeidsdag N _ arbeidsdag N _ SAME
reserváhtta N: reservat N _ reservat N _ SAME
optimista N: optimist N _ optimist N _ SAME
drámá N: drama N _ drama N _ SAME
vuođđokursa N: grunnkurs N _ grunnkurs N _ SAME
mediaplána N: medieplan N _ medieplan N _ SAME
ambassadevra N: ambassadør N _ ambassadør N _ SAME
morála N: moral N _ moral N _ SAME
gaskamearri N: gjennomsnitt N _ gjennomsnitt N _ SAME
nubbigiella N: andrespråk N _ andrespråk N _ SAME
leavgabeaivi N: flaggdag N _ flaggdag N _ SAME
byrokráhta N: byråkrat N _ byråkrat N _ SAME
girjeráidu N: bokserie N _ bokserie N _ SAME
nuoraidorganisašuvdna N: ungdomsorganisasjon N _ ungdomsorganisasjon N _ SAME
duopmogirku N: domkirke N _ domkirke N _ SAME
koahkka N: kokk N _ kokk N _ SAME
goahkka N: kokk N _ kokk N _ SAME
ovdabargu N: forarbeid N _ forarbeid N _ SAME
viessobáŋku N: husbank N _ husbank N _ SAME
arkeologa N: arkeolog N _ arkeolog N _ SAME
nuoraidprográmma N: ungdomsprogram N _ ungdomsprogram N _ SAME
iežasoassi N: egenandel N _ egenandel N _ SAME
dollár N: dollar N _ dollar N _ SAME
náhkkegahpir N: skinnlue N _ skinnlue N _ SAME
vovdna N: vogn N _ vogn N _ SAME
olmmoš N: person N; menneske N _ menneske N
persovdna N: person N _ person N _ SAME
fitnodat N: bedrift N; selskap N _ firma N, foretak N
giehta N: hånd N _ hand N; arm N
stivra N: styre N _ styre N _ SAME
jođihangoddi N: ledelse N _ ledelse N, lederskap N
proseassa N: prosess N _ prosess N _ SAME
hámádat N: profil N; struktur N _ profil N
kontu N: konto N _ konto N _ SAME
ovttadat N: enhet N _ enhet N _ SAME
spiehkastat N: unntak N _ unntak N, avvik N
doaba N: begrep N _ fagord N
smáhkka N: smak N _ smak N _ SAME
boddu N: pause N _ pause N _ SAME
dovdomearka N: symptom N; kjennetegn N _ kjennetegn N
fállu N: meny N _ tilbud N; meny N
mátkelihppu N: billett N _ billett N _ SAME
bileahtta N: billett N _ billett N _ SAME
rekláma N: reklame N _ reklame N _ SAME
rádio N: radio N _ radio N _ SAME
ohcan N: søk N; søknad N _ søknad N; leting N
našuvdna N: nasjon N _ nasjon N _ SAME
stáhtabušeahtta N: statsbudsjett N _ statsbudsjett N _ SAME
máŋggus N: kopi N _ kopi N _ SAME
válgagižžu N: valgkamp N _ valgkamp N _ SAME
nuohtta N: tone N; melodi N _ melodi N; note N
čeabet N: hals N _ hals N _ SAME
čeabát N: hals N _ hals N _ SAME
čotta N: hals N _ svelg N, hals N
riekkis N: ring N _ ring N _ SAME
eanadat N: landskap N _ terreng N
matematihkka N: matematikk N _ matematikk N _ SAME
vuolláibáza N: underskudd N _ underskudd N _ SAME
veardádus N: sammenligning N _ sammenligning N; lignelse N
ruovttueana N: hjemland N _ hjemland N _ SAME
ruovtturiika N: hjemland N _ hjemland N _ SAME
jápmin N: dødsfall N; død N _ døden N
váikkuhus N: påvirkning N; konsekvens N _ virkning N; påvirkning N
stipeanda N: stipend N _ stipend N _ SAME
doavttergráda N: doktorgrad N _ doktorgrad N _ SAME
paragráfa N: paragraf N _ paragraf N _ SAME
biografiija N: biografi N _ biografi N _ SAME
stuorradiggeválga N: stortingsvalg N _ stortingsvalg N _ SAME
jearaldatmearka N: spørsmålstegn N _ spørsmålstegn N _ SAME
gažaldatmearka N: spørsmålstegn N _ spørsmålstegn N _ SAME
elfápmodoaimmahat N: kraftverk N _ kraftverk N _ SAME
olgoriikkapolitihkka N: utenrikspolitikk N _ utenrikspolitikk N _ SAME
bajásgeassin N: oppdragelse N _ oppfostring N
sosiologiija N: sosiologi N _ sosiologi N _ SAME
lihtar N: liter N _ liter N _ SAME
lihtter N: liter N _ liter N _ SAME
mastergráda N: mastergrad N _ mastergrad N _ SAME
oadju N: trygd N _ trygd N _ SAME
honnet N: honning N _ honning N _ SAME
oanádus N: forkortelse N _ forkorting N
subjeakta N: subjekt N _ subjekt N _ SAME
diibmoplána N: timeplan N _ timeplan N _ SAME
ađa N: marg N _ marg N, margbein N
muorjemeastu N: syltetøy N _ syltetøy N _ SAME
duppallatnja N: dobbeltrom N _ dobbeltrom N _ SAME
johtolatsihkarvuohta N: trafikksikkerhet N _ trafikksikkerhet N _ SAME
ássanovttadat N: boenhet N _ boenhet N _ SAME
válgalatnja N: valglokale N _ valglokale N _ SAME
adjektiiva N: adjektiv N _ adjektiv N _ SAME
njuovvan N: slakting N _ slakting N _ SAME
nuoskkidanláhka N: forurensningslov N _ forurensningslov N _ SAME
bivdosadji N: fiskeplass N _ fiskeplass N _ SAME
skábma N: mørketid N _ mørketid N _ SAME
ovdahistorjá N: forhistorie N _ forhistorie N _ SAME
rahpansárdni N: åpningstale N _ åpningstale N _ SAME
váldošiehtadus N: hovedavtale N _ hovedavtale N _ SAME
lonuhangávpi N: byttehandel N _ byttehandel N _ SAME
rievdna N: gryn N _ gryn N _ SAME
surbmi N: gryn N _ gryn N _ SAME
eanaláhka N: jordlov N _ jordlov N _ SAME
substantiiva N: substantiv N _ substantiv N _ SAME
válgačoahkkin N: valgmøte N _ valgmøte N _ SAME
biilaboagán N: sikkerhetsbelte N _ bilbelte N
liššá N: ljå N _ ljå N _ SAME
ovddidanfoanda N: utviklingsfond N _ utviklingsfond N _ SAME
ovdánahttinfoanda N: utviklingsfond N _ utviklingsfond N _ SAME
riikkarevišuvdna N: riksrevisjon N _ riksrevisjon N _ SAME
skuter N: skuter N _ skuter N _ SAME
mohtorgielká N: skuter N _ skuter N _ SAME
sámediggeválga N: sametingsvalg N _ sametingsvalg N _ SAME
preposišuvdna N: preposisjon N _ preposisjon N _ SAME
geaidnogalba N: veiskilt N _ veiskilt N _ SAME
lieđđegavja N: pollen N _ pollen N, blomsterstøv N
digaštallanfáddá N: debattema N _ debattema N _ SAME
luoddaguorra N: vegkant N _ vegkant N _ SAME
geaidnoravda N: vegkant N _ vegkant N _ SAME
geaidnoguorra N: vegkant N _ vegkant N _ SAME
guhkesáiggeperspektiiva N: langtidsperspektiv N _ langtidsperspektiv N _ SAME
lohkosátni N: tallord N _ tallord N _ SAME
giellakonsuleanta N: språkkonsulent N _ språkkonsulent N _ SAME
sámekultuvra N: samekultur N _ samekultur N _ SAME
vearroláhka N: skattelov N _ skatteloven N
fávli N: dyp N _ dyp N _ SAME
čikŋodat N: dyp N _ dybde N
čiekŋalas N: dyp N _ dyp N, dypt sted N
heargi N: rein N _ kjørerein N
geahččoboazu N: rein N _ sytingsrein N
vuođđu N: grunn N; plattform N; grunnlag N _ bunn N, grunn N, underside N, fundament N
vuoigatvuohta N: rett N; rettighet N _ rettighet N
badjesápmi N: reindriftssame N _ reindriftssame N _ SAME
boazosápmi N: reindriftssame N _ reindriftssame N _ SAME
badjealmmái N: reindriftssame N _ reindriftssame N _ SAME
boazoalmmái N: reindriftssame N _ reindriftssame N _ SAME
badjenisu N: reindriftssame N; reindriftskvinne N _ reindriftssame N
heargevuodjingilvu N: reinkappkjøring N _ reinkappkjøring N _ SAME
heargevuodjin N: reinkappkjøring N _ reinkappkjøring N _ SAME
heargegilvovuodjin N: reinkappkjøring N _ reinkappkjøring N _ SAME
heargegilvu N: reinkappkjøring N _ reinkappløp N
ovdáneaddjiriika N: utviklingsland N _ utviklingsland N _ SAME
skuvlaoabbá N: klassekamerat N _ klassekamerat N _ SAME
skuvlaviellja N: klassekamerat N _ klassekamerat N _ SAME
dárogiella N: norsk N _ norsk språk N
dárru N: norsk N _ norsk språk N
jiella N: trekk N _ trekk N, svakt luftdrag N
skoađas N: trekk N; isolasjon N _ trekk N, for N, paneling N; isolasjon N
čáhcegiera N: overflate N _ vannskorpe N
gelbbolašvuođaguovddáš N: kompetansesenter N _ kompetansesenter N _ SAME
gealboguovddáš N: kompetansesenter N _ kompetansesenter N _ SAME
friddjavuohta N: frihet N _ frihet N _ SAME
doalloovttadat N: driftsenhet N _ driftsenhet N _ SAME
riddoguovlu N: kystområde N _ kystområde N _ SAME
eaiggáduššanvuoigatvuohta N: eiendomsrett N _ eiendomsrett N _ SAME
oamastanriekti N: eiendomsrett N _ eiendomsrett N _ SAME
eanaeaiggáduššanvuoigatvuohta N: eiendomsrett N _ jordeiendomsrett N
ovttasbargošiehtadus N: samarbeidsavtale N _ samarbeidsavtale N _ SAME
ovttasbargosoahpamuš N: samarbeidsavtale N _ samarbeidsavtale N _ SAME
justiisaministtar N: justisminister N _ justisminister N _ SAME
bivdu N: fiske N; jakt N; fangst N _ jakt N; fiske N
guollebivdu N: fiske N _ fiske N _ SAME
minoritehta N: minoritet N _ minoritet N _ SAME
justiisadepartemeanta N: justisdepartement N _ justisdepartement N _ SAME
hálddašanorgána N: forvaltningsorgan N _ forvaltningsorgan N _ SAME
dearvvašvuođabálvalus N: helsetjeneste N _ helsetjeneste N _ SAME
oahppu N: utdanning N; kunnskap N; opplæring N _ kunnskap N
oahppa N: utdanning N; kunnskap N _ kunnskap N; lære N
alitoahppu N: utdanning N _ høyere utdanning N
skuvlen N: utdanning N _ skolering N
skuvlejupmi N: utdanning N; skolegang N _ utdanning N
valáštallanlihttu N: idrettsforbund N _ idrettsforbund N _ SAME
eaiggátvuohta N: eierskap N _ eierskap N _ SAME
ođastus N: reform N _ reform N, fornyelse N
čállingiella N: skriftspråk N _ skriftspråk N _ SAME
táhpa N: tap N; tap N _ tap N
rutiidna N: rutine N _ rutine N _ SAME
ovdánanvejolašvuohta N: utviklingsmulighet N _ utviklingsmulighet N _ SAME
maŋŋelgaskabeaivi N: ettermiddag N _ ettermiddag N _ SAME
maŋŋágaskabeaivi N: ettermiddag N _ ettermiddag N _ SAME
veaigi N: ettermiddag N _ skumring N
ovttamielalašvuohta N: enighet N _ enighet N _ SAME
ovttaoaivilvuohta N: enighet N _ enighet N _ SAME
soabalašvuohta N: enighet N _ fordragelighet N
hušša N: stress N _ ståk N, stress N
ássanbáiki N: bosted N _ bosted N _ SAME
orrunbáiki N: bosted N _ bosted N _ SAME
ássansadji N: bosted N _ bosted N _ SAME
orrunsadji N: bosted N _ oppholdssone N
náittosdilli N: ekteskap N _ ekteskap N _ SAME
náittus N: ekteskap N _ vielse N
guovllupolitihkka N: distriktspolitikk N _ distriktspolitikk N _ SAME
neahttabáiki N: nettsted N _ nettsted N _ SAME
ealáhusovdáneapmi N: næringsutvikling N _ næringsutvikling N _ SAME
oahpaheaddjeoahppu N: lærerutdanning N _ lærerutdanning N _ SAME
čearddalašvuohta N: etnisitet N _ etnisitet N _ SAME
luonddugeavaheapmi N: naturbruk N _ naturbruk N _ SAME
boazoeaiggát N: reineier N _ reineier N _ SAME
boazoisit N: reineier N _ reineier N _ SAME
servodatovdáneapmi N: samfunnsutvikling N _ samfunnsutvikling N _ SAME
álgoálbmotnisu N: urfolkskvinne N _ urfolkskvinne N _ SAME
giellaovdáneapmi N: språkutvikling N _ språklig utvikling N
árdna N: skatt N _ skatt N _ SAME
šiella N: skatt N _ finnerlønn N, fødselsgave N
álbmotjoavku N: folkegruppe N _ folkegruppe N _ SAME
márkanšillju N: torg N _ torg N _ SAME
vearrosisaboahtu N: skatteinntekt N _ skatteinntekt N _ SAME
ossodatdirektevra N: avdelingsdirektør N _ avdelingsdirektør N _ SAME
lohkangelbbolašvuohta N: studiekompetanse N _ studiekompetanse N _ SAME
ruhtagáldu N: finansieringskilde N _ finansieringskilde N _ SAME
oadjoetáhtta N: trygdeetat N _ trygdeetat N _ SAME
vearrivuohta N: urett N _ urett N _ SAME
ovdánahttinbargu N: utviklingsarbeid N _ utviklingsarbeid N _ SAME
dálkkádatrievdan N: klimaendring N _ klimaendring N _ SAME
dadjamuš N: utsagn N; innflytelse N _ noe å si N
dajahus N: utsagn N; uttrykk N _ uttrykk N; joiketekst N
sátnevuorru N: innlegg N _ innlegg N _ SAME
sáhkavuorru N: innlegg N; tale N _ innlegg N
badjelmearebuvttadeapmi N: overproduksjon N _ overproduksjon N _ SAME
reaidu N: redskap N; utstyr N; verktøy N; hjelpemiddel N _ verktøy N, hjelpemiddel N
bargobierggas N: redskap N; utstyr N _ redskap N, arbeidsredskap N
bargoneavvu N: redskap N; verktøy N _ verktøy N
bivddus N: redskap N _ fangstredskap N
bivdoneavvu N: redskap N; fiskeredskap N _ fiskeredskap N
bargoviidodat N: arbeidsområde N _ arbeidsområde N _ SAME
bartaguovlu N: hytteområde N _ hytteområde N _ SAME
beaivebiebmu N: lunsj N _ lunsj N _ SAME
luovnnas N: lunsj N _ lunsj N _ SAME
beallelaš N: ektefelle N _ ektefelle N _ SAME
beavdegirji N: protokoll N _ protokoll N _ SAME
beloštus N: forsvar N _ forsvar N _ SAME
ávvir N: omsorg N; oppmerksomhet N _ oppmerksomhet N, omsorg N
fuolla N: omsorg N _ omsorg N _ SAME
biebmodoallu N: kosthold N _ diett N; kosthold N
ritni N: rim N _ rim N _ SAME
bihci N: rim N _ rimfrost N, rim N
birasoahppu N: orienteringsfag N _ orienteringsfag N, miljøfag N
rohkos N: bønn N _ bønn N _ SAME
guollebivdobierggas N: fiskeredskap N _ fiskeredskap N _ SAME
boazodoallu N: reindrift N _ reindrift N _ SAME
gánda N: gutt N _ gutt N _ SAME
lunta N: gutt N _ gutt N _ SAME
bártnáš N: gutt N _ liten gutt N
gánddaš N: gutt N _ liten gutt N
jeavdi N: gutt N _ gutt N _ SAME
bárti N: uhell N; problem N _ uhell N; knipe N
giera N: topp N _ topp N; utspring N
sisabahkken N: inngrep N _ inntrenging N
deaivvadansadji N: møteplass N _ møteplass N _ SAME
dievasčoahkkin N: plenum N; plenumsmøte N _ plenum N
ollesčoahkkin N: plenum N; plenumsmøte N _ plenumsmøte N
doaimmahus N: virksomhet N; redaksjon N _ redaksjon N
doaibmaguovlu N: virkeområde N _ virkeområde N _ SAME
doaibmaviidodat N: virkeområde N _ virkeområde N, aksjonsradius N
duodji N: håndarbeid N; håndverk N _ håndarbeid N, håndverk N
dipmaduodji N: håndarbeid N _ myksløyd N, håndarbeid med myke materialer N
duovdda N: område N _ område N, flytte- og beiteområde N, reinbeiteareal N
dálolaš N: gårdbruker N _ gårdbruker N _ SAME
eahketborramuš N: kveldsmat N _ kveldsmat N, aftensmat N
eahketbiebmu N: kveldsmat N _ kveldsmat N _ SAME
opmodat N: eiendom N _ eiendom N _ SAME
hávvi N: gang N _ sår N
vázzin N: gang N _ gåing N
feasta N: fest N _ fest N _ SAME
fierpmádat N: nettverk N; nettverk N _ nettverk N
fierbmi N: nettverk N; garn N _ fiskegarn N
fuomášupmi N: ide N; oppmerksomhet N; fokus N _ ide N
mális N: middag N _ kokt mat N; suppe N
perspektiiva N: perspektiv N _ perspektiv N _ SAME
geahččanguovlu N: perspektiv N _ perspektiv N _ SAME
geahčču N: tilsyn N; kontroll N _ tilsyn N, bevoktning N
bearráigeahčču N: tilsyn N; kontroll N _ oppsyn N
gelbbolašvuohta N: kompetanse N _ kompetanse N _ SAME
čehppodat N: kompetanse N _ dyktighet N
geardeviessu N: blokk N _ blokk N _ SAME
gielddaválga N: kommunevalg N _ kommunevalg N _ SAME
suohkanválga N: kommunevalg N _ kommunevalg N _ SAME
gierdilvuohta N: toleranse N _ toleranse N _ SAME
gierdevašvuohta N: toleranse N _ tålmodighet N
girdišillju N: flyplass N _ flyplass N _ SAME
mearri N: mål N _ mål N, mengde N
mihttu N: mål N; mål N _ mål N, målestokk N
prinsihppa N: prinsipp N _ prinsipp N _ SAME
govvádus N: framstilling N _ beskrivelse N, framstilling N
guoibmi N: kamerat N; partner N _ kamerat N; livsledsager N, ektemake N; samboer N
verdde N: kamerat N _ kamerat N; vert N, gjestevenn N
čielggadeapmi N: utredning N; utredning N _ utredning N
čielggadus N: utredning N _ forklaring N
doaresbealli N: distrikt N _ veggrøft N; avsides sted N
jáhkku N: tro N; forestilling N _ forestilling N
gáibi N: hake N _ hake N, kjake N
báddi N: bånd N; bånd N _ tau N
čanas N: bånd N; bånd N _ bånd N, bind N
čanastat N: bånd N; bånd N _ band N, bånd N
gárastat N: bånd N _ bånd N _ SAME
historjá N: historie N; historie N _ historie N
hálddašanguovlu N: forvaltningsområde N; forvaltningsområde N _ forvaltningsområde N, administrativt område N
iešmearrideapmi N: selvbestemmelse N _ selvbestemmelse N _ SAME
iežaskapitála N: egenkapital N _ egenkapital N _ SAME
isitgielda N: vertskommune N _ vertskommune N _ SAME
joatkkaoahppu N: videreutdanning N _ videreutdanning N _ SAME
lassioahppu N: videreutdanning N; etterutdanning N _ etterutdanning N
johka N: elv N _ bekk N, elv N
fielbmá N: elv N _ lita stille elv N, stille sted i ei lita elv N
eatnu N: elv N _ stor elv N, flod N
deatnu N: elv N _ stor elv N
johkafanas N: elvebåt N _ elvebåt N _ SAME
johtučálus N: rundskriv N _ rundskriv N _ SAME
johtučála N: rundskriv N _ rundskriv N _ SAME
jorgalus N: oversettelse N _ oversettelse N; omvendelse N
čájálmas N: forestilling N _ forestilling N _ SAME
govahallan N: forestilling N _ illusjon N
jávohisvuođageasku N: taushetsplikt N _ taushetsplikt N _ SAME
kapihtal N: kapittel N _ kapittel N _ SAME
káija N: kai N _ kai N _ SAME
láhttu N: løype N _ løype N _ SAME
liemas N: løype N _ løype N _ SAME
lullisámegiella N: sørsamisk N _ sørsamisk N _ SAME
máttasámegiella N: sørsamisk N _ sørsamisk N _ SAME
luohti N: joik N _ joik N _ SAME
juoigan N: joik N _ joiking N
sáibma N: garn N _ ørretgarn N, småfiskgarn N
láigu N: leie N _ leie N _ SAME
meahcci N: utmark N _ utmark N _ SAME
mearkkašeapmi N: merknad N; kommentar N _ kommentar N, bemerkning N
moraš N: sorg N _ sorg N _ SAME
máškitvuohta N: fleksibilitet N _ fleksibilitet N _ SAME
nagir N: søvn N _ søvn N _ SAME
nagirvárri N: søvn N _ søvn N _ SAME
namahus N: tittel N _ tittel N _ SAME
bajilčála N: tittel N _ overskrift N
nákca N: kraft N; evne N _ evne N, kraft N
oapman N: ovn N _ ovn N _ SAME
uvdna N: ovn N _ peis N, grue N
omman N: ovn N _ stekeovn N
ohcamuš N: søknad N _ søknad N _ SAME
ovdáneapmi N: utvikling N _ utvikling N _ SAME
gárggiideapmi N: utvikling N _ utvikling N _ SAME
pulta N: pult N _ pult N _ SAME
rámma N: ramme N _ ramme N _ SAME
seaguhus N: blanding N _ blanding N _ SAME
segohus N: blanding N _ blanding N _ SAME
stoahka N: lek N _ lek N; leven N
duhkoras N: lek N _ leketøy N
stoahkanhearva N: lek N _ leketøy N
sárdni N: tale N _ preken N, tale N
sáhka N: tale N _ tale N, samtale N
hállan N: tale N _ bøy N, li N, skråning N
sákta N: saft N _ saft N _ SAME
máihli N: saft N _ sevje N; juice N
sáhppi N: saft N _ galle N
álvu N: fangst N _ fangst N _ SAME
sálaš N: fangst N _ bytte N, fangst N
sámegiella N: samisk N _ samisk N _ SAME
urbi N: skudd N _ knopp N, skudd N
virgeolmmoš N: tjenestemann N _ tjenestemann N _ SAME
vuodjingoarta N: førerkort N _ sertifikat N, førerkort N
vuodjinkoarta N: førerkort N _ sertifikat N
vuorká N: arkiv N _ arkiv N; depot N, oppbevaringsplass N; oppbevaring N
váhnen N: forelder N _ forelder N _ SAME
mánnáolmmoš N: forelder N _ person med barn N
várrelahttu N: varamedlem N; vararepresentant N _ varamedlem N
čuolbma N: problem N; problemstilling N _ knute N; problemstilling N
váttisvuohta N: problem N _ problem N _ SAME
árran N: åre N _ åre N, ildsted N
áiru N: åre N _ åre N _ SAME
suotna N: åre N _ sene N
álbmotmeahcci N: nasjonalpark N _ nasjonalpark N _ SAME
ásodat N: bolig N _ bolig N; leilighet N
nálli N: art N; art N; bestand N _ ætt N; rase N
čoahkkin N: møte N _ møte N, forsamling N
deaivvadeapmi N: møte N _ treff N
čoavddalohku N: nøkkeltall N _ nøkkeltall N _ SAME
čuohpastat N: snitt N _ snitt N _ SAME
čuvgehus N: opplysning N _ opplysning N; belysning N
šaddu N: vekst N; vekst N; plante N _ vekst N; plante N
lassáneapmi N: vekst N; økning N _ økning N
boazoguovlu N: reinbeiteområde N _ reinbeiteområde N _ SAME
bivdovuoigatvuohta N: fiskerettighet N _ fiskerettighet N _ SAME
boazoguohtonkonvenšuvdna N: reinbeitekonvensjon N _ reinbeitekonvensjon N _ SAME
bealljemearka N: reinmerke N _ øremerke N
boazomearka N: reinmerke N _ reinmerke N _ SAME
bušeahttaevttohus N: budsjettforslag N _ budsjettforslag N _ SAME
bággodoaibma N: tvangstiltak N _ tvangstiltak N _ SAME
bátnedikšunbálvalus N: tannhelsetjeneste N _ tannhelsetjeneste N _ SAME
doaibmadoarjja N: driftsstøtte N _ driftsstøtte N _ SAME
doallostruktuvra N: bruksstruktur N _ bruksstruktur N _ SAME
dássenmandáhta N: utjevningsmandat N _ utjevningsmandat N _ SAME
eanajuohkinriekti N: jordskifterett N _ jordskifterett N _ SAME
golloluoitu N: kostnadsoverslag N _ kostnadsoverslag N _ SAME
infrastruktuvra N: infrastruktur N _ infrastruktur N _ SAME
siskkáldasstruktuvra N: infrastruktur N _ infrastruktur N _ SAME
luondduriggodat N: naturressurs N _ naturressurs N _ SAME
kommentára N: kommentar N _ kommentar N _ SAME
mobiilatelefovdna N: mobiltelefon N _ mobiltelefon N _ SAME
mohtorjohtolat N: motorferdsel N _ motorferdsel N _ SAME
mátkegollu N: reiseutgift N _ reiseutgift N _ SAME
njuolggadusčálus N: regelverk N _ regelverk N _ SAME
oahppanbiras N: læringsmiljø N _ læringsmiljø N _ SAME
oasussearvi N: aksjeselskap N _ aksjeselskap N, andelslag N
orohatdoarjja N: distriktstilskudd N _ distriktstilskudd N _ SAME
orohatstivra N: distriktsstyre N _ distriktsstyre N _ SAME
ovttasbargovuohki N: samarbeidsform N _ samarbeidsform N _ SAME
personsuodjalus N: personvern N _ personvern N _ SAME
regulerenplána N: reguleringsplan N _ reguleringsplan N _ SAME
servodatdilálašvuohta N: samfunnsforhold N _ samfunnsforhold N _ SAME
sierralohpi N: dispensasjon N _ dispensasjon N _ SAME
sohkabealperspektiiva N: kjønnsperspektiv N _ kjønnsperspektiv N _ SAME
spesialistadearvvašvuođabálvalus N: spesialisthelsetjeneste N _ spesialisthelsetjeneste N _ SAME
sáttagoddi N: delegasjon N _ delegasjon N _ SAME
telefonnummar N: telefonnummer N _ telefonnummer N _ SAME
virgelohpi N: permisjon N _ permisjon N _ SAME
vuoiŋŋasteapmi N: rekreasjon N _ rekreasjon N, hvile N
skuvlavázzin N: skolegang N _ skolegang N _ SAME
rievdadus N: endring N _ endring N _ SAME
rievdadeapmi N: endring N _ endring N _ SAME
nuppástus N: endring N _ forandring N; omstilling N
váldoulbmil N: hovedmål N _ hovedmål N _ SAME
fokus N: fokus N _ fokus N _ SAME
investeren N: investering N _ investering N _ SAME
anárašgiella N: enaresamisk N _ enaresamisk språk N
gonagasreabbá N: kongekrabbe N _ kongekrabbe N _ SAME
mearraguovlu N: havområde N _ havområde N _ SAME
boazodoallonisu N: reindriftskvinne N _ reindriftskvinne N _ SAME
dákse N: drosje N _ taksi N
rahčamuš N: kamp N; innsats N _ strev N
vuolggasadji N: utgangspunkt N _ innfallsvinkel N
dálkkodeapmi N: behandling N _ medisinsk behandling N
iskkadeapmi N: undersøkelse N _ undersøkelse N _ SAME
arva N: energi N _ energi N, viljestyrke N
alva N: energi N _ energi N _ SAME
čálamearka N: tegn N _ skrifttegn N
resursa N: ressurs N _ ressurs N _ SAME
riggodat N: ressurs N _ rikdom N
sisaboahtu N: inntekt N _ inntekt N _ SAME
dienas N: inntekt N _ fortjeneste N
riidu N: konflikt N; strid N _ trette N, krangel N
dahku N: handling N _ gjerning N; inngrep N
veahkaváldin N: vold N; overgrep N _ vold N, makt N, overgrep N
loahppajurdda N: konklusjon N _ resonnement N
menestus N: suksess N _ suksess N _ SAME
bagadallan N: veiledning N _ regi N; veiledning N
ráva N: anbefaling N _ formaning N
siedja N: verk N _ materie N, verk N, sårvæske N
čohkkehus N: samling N _ samling N, sammensetning N
čoakkáldat N: samling N _ samling N _ SAME
govus N: figur N _ figur N _ SAME
govadat N: figur N _ riss N
nággu N: strid N _ krangel N, disputt N, ordstrid N, tvistemål N
vuostálat N: strid N _ motbakke N
kapasitehta N: kapasitet N _ kapasitet N _ SAME
vearredahku N: overgrep N _ forbrytelse N
girjáivuohta N: mangfold N _ mangfold N _ SAME
searvan N: deltakelse N _ medvirkning N
riedja N: støy N; skrål N _ skrål N; bråk N; høyrøystet snakk N
váikkuhanfápmu N: innflytelse N _ påvirkningskraft N
váikkuhanváldi N: innflytelse N _ påvirkingskraft N
váikkuhanvejolašvuohta N: innflytelse N _ påvirkningsmulighet N
čanus N: tilknytning N _ binding N, sammenheng N
oadjebasvuohta N: trygghet N _ trygghet N _ SAME
mohtorfievru N: kjøretøy N _ motorkjøretøy N
vieljaš N: søsken N _ lillebror N
oappáš N: søsken N _ lillesøster N
bajuš N: pålegg N _ pålegg N; garndupp N
láibesuvli N: pålegg N _ pålegg N _ SAME
vearrogeahpádus N: skattelette N _ skattelette N _ SAME
geavahanguovlu N: bruksområde N _ bruksområde N _ SAME
váldobargu N: hovedoppgave N _ hovedarbeid N
rievdadusevttohus N: endringsforslag N _ endringsforslag N _ SAME
oambealle N: søskenbarn N _ kusine N
oarpmealle N: søskenbarn N _ kusine N
doaibmagollu N: driftsutgift N _ driftsutgift N _ SAME
šiehtadanlávdegoddi N: forhandlingsutvalg N _ forhandlingskomité N
rieibmu N: skrål N _ skrål N, leven N
davviguovlopolitihkka N: nordområdepolitikk N _ nordområdepolitikk N _ SAME
duollji N: reinskinn N _ reinskinn N; elgskinn N
gámas N: reinskinn N _ leggskinn N
