áššemeannudeaddji N: saksbehandlerstilling N; saksbehandler N _ saksbehandler N
ossodatjođiheaddji N: etatsleder N; avdelingsleder N; avdelingsdirektør N _ avdelingsleder N
buohccidikšu N: sykesøster N; sykepleier N _ sykepleier N
vearredahkki N: gjerningsmann N _ forbryter N
biebmoealli N: beitedyr N _ kjæledyr N
guldaleaddji N: lytter N; tilhører N _ tilhører N
govvejeaddji N: illustratør N; fotograf N _ fotograf N
bálvaleaddji N: servicepersonell N; tjener N _ tjener N
vuoiti N: prisvinner N; vinner N _ vinner N
šiehtadalli N: part N _ forhandler N
mánnageahčči N: barnetilsyn N _ barnevakt N
girjerájusbargi N: bibliotekar N _ bibliotekar N _ SAME
boazodoalli N: reindriftsutøver N; reineier N _ reindriftsutøver N
ráđđeaddi N: rådgiver N _ rådgiver N _ SAME
dáksevuoddji N: drosjesjåfør N _ drosjesjåfør N, taksisjåfør N
oahppi N: elev N _ elev N _ SAME
guoddi N: bærer N _ bærer N _ SAME
ságajođiheaddji N: ordfører N _ ordfører N, ordstyrer N
sátnejođiheaddji N: ordfører N _ ordfører N _ SAME
čálli N: forfatter N; sekretær N _ forfatter N; sekretær N; skribent N
girječálli N: forfatter N _ forfatter N _ SAME
girdi N: fly N _ fly N; flyver N
generálačálli N: generalsekretær N _ generalsekretær N _ SAME
váldočálli N: generalsekretær N _ hovedsekretær N
mátkkošteaddji N: reisende N _ reisende N _ SAME
geavaheaddji N: bruker N _ bruker N _ SAME
konferánsaoasseváldi N: konferansedeltaker N _ konferansedeltaker N _ SAME
oktiiheiveheaddji N: koordinator N _ koordinator N _ SAME
šiehtadallanjođiheaddji N: forhandlingsleder N _ forhandlingsleder N _ SAME
kulturguoddi N: kulturbærer N _ kulturbærer N _ SAME
geahčči N: publikum N; seer N _ publikum N
áššedovdi N: ekspert N _ ekspert N; sakkyndig N
čoahkkinoasseváldi N: møtedeltaker N _ møtedeltaker N _ SAME
guolgaealli N: pelsdyr N _ pelsdyr N _ SAME
meahciealli N: rovdyr N _ vilt dyr n
buohcci N: pasient N _ syk a; pasient N
sámegieloahpaheaddji N: samisklærer N _ samisklærer N _ SAME
stáhtačálli N: statssekretær N _ statssekretær N _ SAME
stádačálli N: statssekretær N _ statssekretær N _ SAME
bagadalli N: instruktør N; konsulent N _ instruktør N; konsulent N; rettleder N
lášmmohallanhárjeheaddji N: instruktør N _ instruktør N _ SAME
oasseváldi N: deltaker N _ deltaker N _ SAME
oassálasti N: deltaker N _ deltaker N _ SAME
filbmadahkki N: filmskaper N _ filmskaper N _ SAME
vuoddji N: sjåfør N _ sjåfør N _ SAME
doaimmaheaddji N: redaktør N _ redaktør N _ SAME
ovdaskuvlaoahpaheaddji N: førskolelærer N _ førskolelærer N _ SAME
ohcci N: søker N _ søker N, skjerper N
guollebivdi N: fisker N _ fisker N _ SAME
guolásteaddji N: fisker N _ fisker N _ SAME
čiekči N: fotballspiller N _ fotballspiller N _ SAME
spábbačiekči N: fotballspiller N _ fotballspiller N _ SAME
bivdi N: jeger N _ jeger N _ SAME
lohkki N: leser N _ leser N _ SAME
jođiheaddji N: leder N _ leder N, styrer N
prošeaktajođiheaddji N: prosjektleder N _ prosjektleder N _ SAME
fabrihkkabargi N: fabrikkarbeider N _ fabrikkarbeider N _ SAME
ássi N: innbygger N _ innbygger N _ SAME
dutki N: forsker N _ forsker N _ SAME
oahpaheaddji N: lærer N _ lærer N _ SAME
báhtareaddji N: flyktning N _ flyktning N _ SAME
jienasteaddji N: velger N _ velger N _ SAME
jorgaleaddji N: oversetter N _ oversetter N _ SAME
oamasteaddji N: eier N _ eier N _ SAME
vuostálasti N: motstander N _ motstander N _ SAME
mánáidáittardeaddji N: barneombud N _ barneombud N _ SAME
fuolaheaddji N: forsørger N _ forsørger N _ SAME
fylkkasátnejođiheaddji N: fylkesordfører N _ fylkesordfører N _ SAME
luohkkájođiheaddji N: klassestyrer N _ klassestyrer N _ SAME
mánáidgárdejođiheaddji N: barnehagestyrer N _ barnehagestyrer N _ SAME
ovddasteaddji N: representant N _ foresatt N; representant N
plánejeaddji N: planlegger N _ planlegger N _ SAME
čoahkkinjođiheaddji N: møteleder N _ dirigent N, møteleder N
digaštalli N: debattant N _ debattant N _ SAME
diktačálli N: dikter N _ dikter N _ SAME
smávvafanasbivdi N: småbåtfisker N _ småbåtfisker N _ SAME
šuokŋadahkki N: komponist N _ komponist N _ SAME
vuostáiváldi N: mottaker N _ mottaker N _ SAME
jábmi N: død N _ død N, lik N
vuotnaguolásteaddji N: fjordfisker N _ fjordfisker N _ SAME
láidesteaddji N: pådriver N _ dirigent N; pådriver N
fidnooahppi N: lærling N _ lærling N _ SAME
ruhtadeaddji N: finansieringskilde N _ finansiør N
