dovdat V: kjennskap N; føle V; kjenne V; kjenne V _ kjenne V; føle V
čoahkkinastit V: ha møte V _ holde møte V
báidnit V: prege V; påvirke V _ farge av V; påvirke V
láhčit V: tilrettelegge V _ re V
áŋgiruššat V: satse V _ ivre for V
čájehit V: opptre V; vise V _ vise V
láhttet V: opptre V; agere V _ bære seg at V
áđđestallat V: mime V; imitere V _ herme V
doapmat V: skynde V _ skynde seg V
jaskkodit V: stilne V _ tie V
boahtit V: møte frem V; komme V _ komme V
hoigadit V: dytte V; ekskludere V; skyve V _ skyve V
vuostálastit V: gå i mot V; bekjempe V _ protestere V; gjøre motstand V
leaikkastallat V: skøye V _ spøke V
árvidit V: spekulere V; skjønne V; forutse V; anta V _ skjønne V; gjette V
vuortnuhit V: røyne V; plage V; tvinge V; presse V _ plage V; tvinge V, presse V
hutkat V: uteksperimentere V; skape V _ finne på V, dikte opp V
vihahit V: vigsle V; vie V; innvie V _ vie V, innvie V
govvidit V: portrettere V; skissere V; gjenspeile V; beskrive V; illustrere V _ beskrive V, illustrere V
boarásmuvvat V: eldes V _ bli gammel V
reaškit V: gapskratte V _ skratte V
veaddit V: tjore V _ holde i tjor V
ahkiduššat V: mistrives V; vantrives V _ vantrives V
váccašit V: rusle V _ spasere V
čiŋahit V: utsmykke V; pynte V _ pynte V
gevret V: bortvise V; utvise V; pålegge V _ kommandere V
spežžet V: klappe V _ daske V
gaikkihit V: røske V _ rykke V
nimmorit V: murre V; beklage V _ beklage V
árpmihit V: skåne V _ forbarme seg V
márrat V: strømme V _ bruse V, dure V; innsige V
ovttastit V: konsolidere V; forene V; kombinere V _ forene V
gáržudit V: avgrense V; snevre V; innskrenke V; begrense V _ innskrenke V
ráddjet V: avgrense V; begrense V _ begrense V
leavvat V: bre V; spre V _ bre seg V
mearridit V: fastsette V; vedta V; bestemme V _ bestemme V
virgáibidjat V: tilsette V; konstituere V; ansette V _ ansette V
hilgut V: forkaste V; avslå V; avvise V _ vrake V; avslå V, avvise V
bajidit V: oppjustere V; løfte V; øke V; heve V _ løfte V, heve V
átnut V: begjære V; be V _ be V, tigge V
badjelgeahččat V: nedprioritere V; neglisjere V; overkjøre V; overse V _ forakte V, nedvurdere V
háddjet V: splitte V; fragmentere V; spre V _ rote V, spre V
buoridit V: bedre V; forbedre V _ forbedre V, rette på V
čiehkat V: skjule V; gjemme V _ gjømme V
čiegadit V: skjule V; gjemme V _ gjemme V
goarrut V: sømme V; sy V _ sy V
árvvoštallat V: evaluere V; vurdere V; kritisere V _ bedømme V; kritisere V; vurdere V
duhtat V: nøye V _ være fornøyd V
ođasmahttit V: modernisere V; revidere V; oppgradere V; fornye V; oppdatere V _ oppdatere V; fornye V
joatkašuvvat V: vedvare V; videreføre V; fortsette V _ fortsettes V
dáhkidit V: forsikre V; bekrefte V; garantere V; sikre V _ garantere V, bekrefte V; forsikre om V; kausjonere V
fuomášuhttit V: fokusere V; belyse V _ gjøre oppmerksom på V
duolbmat V: trå V; undervurdere V; overkjøre V; tråkke V; tråkke V; trampe V _ trø V, tråkke V
buokčalit V: dukke V; dykke V _ dykke V
suokkardit V: utforske V; granske V; drøfte V _ granske V
muitalit V: informere V; fortelle V; omtale V; opplyse V _ fortelle V
gulahit V: informere V; kunngjøre V; erklære V _ kunngjøre V
buohtastahttit V: jamføre V; sammenligne V; sammenlikne V _ sammenlikne V
veardidit V: jamføre V; sammenligne V; vurdere V _ sammenligne V
beahtahallat V: skuffe V _ bli skuffet V; bli bedratt V
háhkat V: anskaffe V; opparbeide V; skaffe V; rekruttere V _ skaffe V; rekruttere V
ovttastahttit V: samordne V; forene V; inkorporere V; kombinere V; integrere V; innlemme V _ forene V, inkorporere V; kombinere V
ođastit V: revidere V; fornye V; oppdatere V _ fornye V
dárkkistit V: revidere V; kontrollere V; overprøve V; undersøke V _ kontrollere V, overprøve V
guorahallat V: gjennomgå V; undersøke V; drøfte V _ undersøke V
cealkit V: fastslå V; felle V; nedfelle V; si V; uttale V; erklære V; omtale V; uttrykke V _ si V, uttale V
dovddastit V: tilkjenne V; erkjenne V _ innrømme V, bekjenne V
mieđihit V: tilkjenne V; erkjenne V _ bifalle V; erkjenne V
luoikat V: utlåne V; låne V _ låne bort V
čavget V: skjerpe V; stramme V _ stramme V, stramme inn V; sette igang V
dearvvahit V: hilse V _ hilse på V
váikkuhit V: bidra V; påvirke V _ virke V; påvirke V
veahkehit V: bidra V; hjelpe V _ hjelpe V, assistere V
dagahit V: bidra V; føre V _ forårsake V
dieđihit V: rapportere V; oppgi V; orientere V; melde V; melde V; kunngjøre V; innmelde V _ meddele V, orientere V
jorggihit V: vippe V; snu V _ snu V, vende seg V
sihkkut V: nulle V; slette V; sløyfe V; tørke V; stryke V; fjerne V _ tørke V; stryke ut V, fjerne V
rehkenastit V: kalkulere V; regne V; beregne V _ regne V
šláttardit V: tyste V _ sladre V
sihkastit V: slette V; viske V; tørke V; male V _ tørke V; male V
oahpahit V: skolere V; opplære V; undervise V; lære V _ undervise V, lære V
dinet V: opptjene V; tjene V _ tjene V
čollet V: sløye V _ sløye fisk V; gulpe V
navdit V: synse V; tro V; kalle V; anta V; mene V _ kalle V; mene V, tro V
váidit V: politianmelde V; påklage V; klage V; anklage V _ klage V, anklage V; anmelde V
ruostut V: rustne V _ ruste V, bli rusten V
čilget V: spesifisere V; skissere V; avklare V; forklare V; definere V _ forklare V
geatnegahttit V: forplikte V; pålegge V _ plikte V
čuohppat V: sakse V; hugge V; klippe V _ skjære V
sáddet V: oversende V; sende V _ sende V
doaimmahit V: utøve V; utføre V; drive V; drive V _ utrette V, utføre V
cuoigut V: peke V; påpeke V _ påpeke V, gjøre oppmerksom på V
cuiget V: peke V; påpeke V _ påpeke V
čujuhit V: peke V; påvise V; henvise V; påpeke V; vise V; markere V _ markere V; utpeke V
geiget V: avlevere V; overlevere V _ strekke ut V, rekke fram V
geahččalit V: utprøve V; prøve V; forsøke V _ prøve V
doalvut V: havne V; bringe V; eksportere V _ bringe bort V, føre bort V; eksportere V
beahttit V: svikte V _ bedra V, narre V
hállat V: snakke V; orde V; snakke V _ snakke V
hupmat V: snakke V; tale V; snakke V; uttrykke V _ snakke V
vákšut V: overvåke V _ granske nøye V
gozihit V: overvåke V _ vokte V
dohkkehit V: anerkjenne V; akseptere V; vedta V; godkjenne V _ godta V, akseptere V, bifalle V, knesette V; godkjenne V
molsut V: rullere V; bytte V; skifte V _ skifte V, bytte V
deattuhit V: vektlegge V; understreke V; fremheve V; poengtere V; påpeke V _ betone V, fremheve V, poengtere V
rávvet V: tilrå V; anbefale V _ formane V
jienastit V: votere V; nedstemme V; stemme V _ stemme V
vuovdit V: omsette V; selge V _ selge V
válddahit V: omhandle V; beskrive V _ beskrive V
máinnašit V: omhandle V; omtale V _ omtale V, rose V
addit V: yte V; levere V; gi V _ gi V
dáhpáhuvvat V: foregå V; forekomme V; skje V _ hende V, skje V
láittastuvvat V: kjede V; vantrives V _ vantrives V
suorggahit V: ryste V; skremme V _ skremme V
oaidnit V: øyne V; se V _ se V
láitit V: fordømme V; kritisere V _ klandre V, kritisere V
čuollat V: hugge V; hogge V _ hogge V
murret V: hugge V _ sage eller hogge ved V
láigohit V: innleie V; leie V _ leie av noen V
ceahkkut V: tømre V _ skjære hakk V
ravgat V: ramle V _ falle over ende V; sprette V
ráfehuhttit V: uroe V; forstyrre V _ forstyrre V, sjenere V
rihkkut V: overskride V; bryte V _ overtre V, bryte V, misligholde V
rasttildit V: overskride V; passere V; krysse V _ krysse V
sirdit V: omdisponere V; overføre V; flytte V _ flytte V
ásaiduvvat V: bosette V _ begynne å føle seg hjemme V, slå seg ned V
ássat V: bosette V; bo V _ bo V
vuođđudit V: konstituere V; oppnevne V; bygge V; etablere V; opprette V _ grunnlegge V
ájihit V: forsinke V; forhindre V _ hefte bort V
maŋŋonit V: forsinke V _ bli forsinket V
čiekŋudit V: utdype V; fordype V _ fordype V
darvehit V: fange V; klistre V _ feste V, klistre V, klebe V
lonohallat V: utveksle V; bytte V; skifte V _ skifte V; bytte med hverandre V
lonuhit V: utveksle V; bytte V; skifte V _ heve V; bytte V
oadjudit V: trygge V _ gjøre trygg V
duođaštit V: dokumentere V; attestere V; bekrefte V _ bekrefte V, bevitne V, attestere V; godtgjøre V
rahčat V: anstrenge V; slite V; kjempe V _ streve V
beasahit V: sleppe V; miste V _ miste V
bilidit V: skjemme V; skade V; ødelegge V _ ødelegge V
goallostit V: lenke V _ binde sammen etter hverandre V
vuodjat V: påkjøre V; svømme V _ svømme V
bassat V: rundvaske V; vaske V _ vaske V
ávkkuhit V: monne V _ nytte V, gagne V
goddit V: felle V; myrde V; drepe V _ drepe V
báhčit V: felle V; skyte V; stikke V _ skyte V; stikke V
njeaidit V: felle V; sprenge V; redusere V _ velte V
rivvet V: frata V; røve V _ røve V, ta med makt V; tackle V
manahit V: frata V; miste V; fjerne V _ miste V
atnit V: anse V; benytte V; bruke V _ bruke V; anse for V; inneha V
cegget V: stille V; etablere V; opprette V _ reise opp V
luoitit V: overlate V; slippe V; løse V _ slippe V, løse V
fievrridit V: overføre V; videreføre V; føre V; frakte V; eksportere V _ frakte V, ha med seg V
luvvet V: frigi V; frita V; løse V _ løse V
sierranit V: separere V; skilles V; skille V _ skilles V, skille seg ut V
vuoitit V: overkomme V; vinne V _ vinne V
boradit V: lunsje V; spise V _ spise V, ete V, ha et måltid V
guhkidit V: prolongere V; forlenge V _ forlenge V
ságastit V: orde V; tale V; snakke V _ samtale V
álggahit V: iverksette V; starte V; opprette V _ få i gang V
vásihit V: oppleves V; oppleve V _ erfare V, oppleve V
smiehttat V: reflektere V; tenke V _ tenke V, fundere V
joatkit V: videreføre V; fortsette V _ skjøte V; fortsette V
vuolláičállit V: signere V; underskrive V _ underskrive V
doahttalit V: overholde V; respektere V _ akte V, ta hensyn til V
čuovvut V: overholde V; følge V _ følge V
doallat V: overholde V; avholde V; abonnere V; holde V; holde V; holde V _ holde V
máksit V: utbetale V; bety V; belaste V; betale V _ betale V; koste V; bety V
deavdit V: oppfylle V; fylle V _ fylle V
ollašuhttit V: oppfylle V; gjennomføre V; fullføre V _ fullføre V
ollašuvvat V: oppfylle V; oppnå V _ gjennomføres V
sárgut V: skissere V; tegne V _ streke V, tegne V, risse V
seaivut V: ankomme V; lande V _ dale ned V; sveve V
dubmehallat V: domfelle V _ bli dømt V
dubmet V: domfelle V; dømme V _ dømme V
dovddahit V: signalisere V; uttrykke V _ røpe V
ipmirdit V: begripe V; skjønne V; oppfatte V; forstå V _ forstå V, skjønne V
buktit V: overlevere V; bringe V; medføre V _ bringe V
gaskkustit V: overlevere V; formidle V _ formidle V
sirdašuvvat V: forskyve V _ flytte på seg V
sárdnidit V: forkynne V; preke V; tale V _ preke V, tale V
čállit V: protokollføre V; skrive V _ skrive V, notere V; rispe V; råskjære fisk V
diđoštit V: befare V _ innhente opplysninger V, få klarhet i V
barggahit V: aktivisere V _ sysselsette V
nágget V: insistere V; påstå V _ krangle V; påstå V
bissehit V: opphøre V; stoppe V; stanse V; undergrave V _ stoppe V
bagadallat V: veilede V; beskrive V; instruere V _ beskrive V; instruere V
bagadit V: veilede V; oppdra V; refse V; instruere V _ oppdra V, rettlede V; straffe V, refse V
heaittihit V: nedlegge V; avslutte V; avvikle V; oppheve V _ avslutte V; avvikle V
bávkalit V: sprenge V; smelle V _ smelle V, fyre av V
cuvket V: sprenge V _ knuse V; veksle V
vurket V: arkivere V; oppbevare V; lagre V _ oppbevare V; lagre V
nannet V: lovfeste V; styrke V; bekrefte V; sikre V _ styrke V; bekrefte V
jođihit V: ledes V; føre V; dominere V; drive V; lede V _ lede V, styre V
guoddalit V: anke V; påklage V; anklage V _ klage på V, anklage V
čatnat V: knyte V; binde V; knytte V _ binde V, forbinde V, kople V
vuolidit V: avkorte V; redusere V _ senke V
áidut V: gjerde V _ inngjerde V
namuhit V: tilføre V; omtale V; nevne V _ nevne V
bálkáhit V: premiere V; engasjere V; leie V; betale V _ ansette V; leie V; betale V
dásset V: balansere V; utjevne V; stabilisere V _ jamne V, jevne V; stabilisere V
molsašuddat V: variere V _ bli forandret V
čielggadit V: utrede V; avklare V; forklare V _ forklare V
jevdet V: utjevne V _ jevne ut V
ráhkadit V: utarbeide V; lage V; skape V _ lage V
ráhkadahttit V: utarbeide V _ få noen til å lage V
viššat V: tørre V; tore V; orke V _ orke V, gidde V
duostat V: tørre V; våge V; tore V _ våge V, tore V
geasehit V: transportere V; kjøre V; frakte V _ kjøre V, frakte V
illastit V: torturere V _ mishandle V
deattašit V: taste V; trykke V _ trykke V
goaridit V: svekke V; tappe V; undergrave V _ vanskjøtte V
hedjonit V: svekke V _ bli svak V
riidit V: stride V; forhindre V; nekte V _ nekte V; forhindre V
njáhkat V: snike V _ smyge V
njágahit V: snike V _ liste seg til noe V
sivahallat V: skylde V; påtale V; beskylde V; anklage V _ anklage for V, påtale V
šiggut V: skjelle V _ hysse på V
lápmašuvvat V: skamslå V; skade V _ bli vanfør V, bli skadet V
buhtistit V: rengjøre V; rense V _ reingjøre V, rense V
čuohcat V: ramme V; påvirke V; berøre V _ påvirke V, berøre V
jáhkihit V: overbevise V _ få til å tro V
eattehit V: opprøre V _ bli sint V
movttáskit V: oppløfte V _ bli glad V, bli oppmuntret V
boltut V: oppkjøre V; brøyte V _ rote opp V, grave opp V
fáhtet V: oppfange V _ få tak i V
lahkanit V: nærme V _ nærme seg V
lahkonit V: nærme V _ nærme seg V
deaivat V: møte V; treffe V; treffe V _ treffe V
deaivvadit V: møte V; treffe V; møtes V _ møtes V
gávnnadit V: møte V; møtes V _ møtes V
duostut V: møte V _ ta imot V
dustet V: møte V; dempe V _ dempe V; ta imot V
deaividit V: møte V _ inntreffe V
muittuhit V: minne V _ påminne V, minne om V
nagadit V: makte V; klare V _ greie V, klare V
gielistit V: lyve V; lyge V _ lyge V
ealihit V: livnære V _ livberge V
gillát V: lide V; tåle V _ tåle V, holde ut V
biidnašuvvat V: lide V _ pines V
gárrut V: kvie V _ få seg til å gjøre noe V
fuomášit V: konstatere V; oppdage V; merke V _ oppdage V
gávnnahit V: konstatere V; finne V _ finne ut V
jávohuhttit V: kneble V _ få til å tystne V
gárvodit V: kle V _ kle på seg V
nuoladit V: kle V _ kle av seg V
čoalkit V: klapre V; banke V _ knakke V, banke V
bálkásit V: kassere V _ gå til spille V
sahet V: kappe V; sage V _ sage V
áimmahuššat V: ivareta V _ holde i hevd V, ta vare på V
vuhtiiváldit V: ivareta V _ ta hensyn til V
fuolahit V: ivareta V; sørge V _ sørge for V
fátmmastit V: involvere V; omfavne V; omfatte V _ omfavne V
sorrat V: involvere V _ vase sammen V
hoahpuhit V: intensivere V; forsere V _ påskynde V
huikit V: hoie V; rope V _ rope V
hehttet V: hemme V; forhindre V; forebygge V; holde V; hindre V _ hindre V, forhindre V
speadjalastit V: gjenspeile V _ avspeile V
buvttihit V: føre V; nå V; skape V _ rekke V, nå V
vearránit V: forverre V _ bli verre V
hálddašit V: forvalte V; beherske V; betjene V; administrere V _ rå over V; administrere V; beherske V; betjene V
eaktudit V: forutsette V _ ta forbehold V
válbmet V: ferdigstille V; fullføre V _ gjøre ferdig V
ohcalit V: etterspørre V; etterlyse V; søke V; savne V _ savne V, lengte etter V
jearahit V: etterspørre V; intervjue V; spørre V _ intervjue V, spørre V
váillahit V: etterlyse V; savne V _ savne V
smiehtadit V: dvele V; tenke V _ tenke V, gruble V
rámidit V: berømme V _ rose V, prise V
rábmot V: berømme V; skryte V _ skryte V; rose V
mearkkašit V: bemerke V; bety V; innebære V _ merke seg V, notere V; bety V
váivašuvvat V: bekymre V _ plages V
vuorjašuvvat V: bekymre V _ plages V
vuosttaldit V: bekjempe V _ protestere V, motarbeide V, opponere mot V
illosit V: begeistre V _ bli glad V
várret V: avsette V _ advare V; sette av V
čielgat V: avklare V _ klarne V, bli klar V
vuoddját V: kjøre avsted V _ kjøre av sted V
girdit V: fly V _ fly V _ SAME
girdilit V: fly V _ fly avgårde V
nanosmahttit V: styrke V; forsterke V _ styrke V, forsterke V
vuorjat V: plage V _ plage V, sjenere V
váivvidit V: plage V _ plage V, bry med V
bieguhit V: plage V _ plage V _ SAME
givssidit V: plage V; mobbe V _ mobbe V, plage V, pine V
iskat V: prøve V; undersøke V _ undersøke V, prøve V
viggat V: prøve V; forsøke V _ prøve V, streve V
geahččaladdat V: prøve V; eksperimentere V _ eksperimentere V
suhkat V: ro V _ ro V; gynge V
suvdit V: ro V _ ferge V, frakte i båt V
páhkket V: pakke V _ pakke V _ SAME
šiehtadit V: avtale V; forhandle V _ avtale V
šiehttat V: avtale V _ få plass V; bli enig V
stoahkat V: leke V _ støye V; leke V
duhkoraddat V: leke V _ leke V _ SAME
fierrat V: rulle V _ rulle V; rase ned V
jorrat V: rulle V _ dreie V, gå rundt V
fieradit V: rulle V _ rulle V, tumle V
fierralit V: rulle V _ rulle V; dette V, falle overende V
čalmmustit V: synliggjøre V _ synliggjøre V _ SAME
čohkkát V: sitte V _ sitte V _ SAME
čohkohallat V: sitte V _ holde på å sitte V
čohkkádit V: sitte V _ sitte V _ SAME
jurddašit V: tenke V; mene V _ tenke V
jurddahit V: tenke V _ tenke V _ SAME
jurdilit V: tenke V _ tenke en tanke V
almmuhit V: publisere V; utgi V; kunngjøre V; opplyse V _ publisere V, gi ut V; deklarere V; bekjentgjøre V
arvat V: våge V _ våge V _ SAME
bivdit V: anmode V; fiske V; be V _ fiske V, jakte V; be V, anmode V
ávžžuhit V: anmode V; oppfordre V; utfordre V; anbefale V _ oppfordre V
ordnet V: sortere V; ordne V _ ordne V; sortere V
sirret V: sortere V; skille V; isolere V _ skille V, sortere V
čuoldit V: sortere V; skille V _ skille V, sortere V; veve bånd V
boaibmut V: sortere V; plukke V _ plukke V, pille V; sortere V
bovdet V: invitere V _ invitere V, innby V
hástit V: invitere V; oppfordre V; utfordre V _ utfordre V, oppfordre V
buhtadit V: kompensere V; erstatte V _ kompensere V, refundere V
buhttet V: kompensere V; erstatte V _ erstatte V
buvttadit V: produsere V _ produsere V _ SAME
bágget V: tvinge V; presse V _ tvinge V
bággehallat V: tvinge V _ tvinges V
caggat V: forhindre V; hindre V _ støtte opp V; forhindre V
heađuštit V: forhindre V; avverge V; undergrave V; hindre V _ forhindre V, avverge V
coggat V: putte V _ putte V, stappe V; kle på seg V
coggalit V: putte V _ putte fort V; kle på seg fort V
nahkehit V: putte V; stikke V _ putte V, stikke V
cábadit V: makulere V _ skjære i små biter V; makulere V
dahppat V: stenge V _ stenge V, lukke V
giddet V: stenge V; montere V _ feste V
liibmet V: klistre V; lime V _ lime V
ovdandoallat V: fremheve V _ anføre V, framholde V
doadjit V: knekke V; bryte V _ knekke V, bryte V
doaibmat V: fungere V; utføre V _ fungere V
doaivut V: håpe V; tro V; anta V _ håpe V; tro V
sávvat V: håpe V; ønske V _ ønske V
doarrut V: stange V; slåss V; kjempe V _ stange V; slåss V
nordat V: stange V _ puffe V, støte V
duvdit V: fortrenge V; skyve V; tilsidesette V _ støtte V; puffe V; fortrenge V
muktit V: overprøve V; forandre V; endre V _ endre V, forandre V
eastadit V: forebygge V; unngå V; hindre V _ hindre V; forebygge V
gahččat V: falle V _ falle V _ SAME
galbmot V: fryse V _ fryse V _ SAME
goallut V: fryse V _ fryse V _ SAME
galmmihit V: fryse V _ avkjøle V
gallestallat V: besøke V _ besøke V _ SAME
gallet V: besøke V _ besøke V _ SAME
galledit V: besøke V _ besøke V _ SAME
finadit V: besøke V _ stikke innom V
gaskkalduhttit V: avbryte V _ avbryte V _ SAME
botket V: avbryte V; bryte V; skille V _ bryte V, slite av V; slite seg løs V
unnut V: minske V; redusere V _ minske V, bli mindre V
geahpedit V: minske V; lette V; redusere V _ lette V, minske V
geahpidit V: minske V; lette V; redusere V _ lette V, minske V
uhccut V: minske V _ bli mindre V, minske V
hoahkat V: gjenta V _ ymte om at en vil V; gjenta V
geardut V: gjenta V _ gjenta V; multiplisere V
geardduhit V: gjenta V _ repetere V
vuodjit V: kjøre V; drive V _ kjøre V; drive V _ SAME
vuojihit V: kjøre V; frakte V _ frakte V
gohččut V: innkalle V; be V; pålegge V _ be V, befale V; innkalle V; pålegge V
golahallat V: fordrive V _ forbruke V
gudnejahttit V: hedre V _ ære V, hedre V
gulahallat V: kommunisere V _ forstå hverandre V; kommunisere V
gullot V: høres V _ høres V _ SAME
guldalit V: høres V; lytte V; høre V _ lytte V; kjenne etter V; teste V
guohcagit V: råtne V _ råtne V _ SAME
guossohit V: servere V _ traktere V, servere V
gáldet V: gjelde V; kastrere V _ gjelde V, kastrere V
guoskat V: gjelde V; berøre V _ komme bort i V; angå V
gustot V: gjelde V _ gjelde V _ SAME
gádjut V: redde V _ berge V, redde V
suddjet V: redde V; beskytte V _ beskytte V
gáidat V: forsvinne V _ vike V, forsvinne V
jávkat V: forsvinne V _ forsvinne V _ SAME
healbat V: forsvinne V _ forbli V
gálašit V: vasse V _ vasse V; bade V
gáržžidit V: innskrenke V; begrense V; redusere V _ innskrenke V
gáržut V: innskrenke V _ bli trang V, innskrenket V
heahpanit V: skjemmes V _ skamme seg V, skjemmes V
luohpat V: slutte V; gå V _ slutte V, gi opp V
heaitit V: slutte V _ slutte V _ SAME
loahpahit V: avslutte V; sluttføre V _ avrunde V, sluttføre V
biehttalit V: avslå V; avvise V; nekte V _ gi avslag V; nekte for V
máhttit V: beherske V _ kunne V
bálvalit V: betjene V; tjene V _ tjene V
hárdit V: erte V; terge V; mobbe V _ erte V, terge V
hárjehaddat V: øve V; trene V _ øve V, trene V
hárjehallat V: øve V; trene V _ trene V
ijastallat V: overnatte V; sove V _ overnatte V
ijastaddat V: overnatte V _ overnatte V _ SAME
idjadit V: overnatte V _ overnatte V _ SAME
ihtit V: fremkomme V; synes V _ vise seg V, komme til syne V, fremkomme V
áddet V: skjønne V; oppfatte V; forstå V _ forstå V
jorgalit V: oversette V _ oversette V; snu noe V; snu V; omvende V; gjøre et notkast V
jorgalahttit V: oversette V; snu V _ få til å snu V; få oversatt V
máhccat V: snu V; komme V _ snu V, vende tilbake V
jápmit V: dø V _ dø V _ SAME
lohkat V: lese V; telle V; studere V; si V _ lese V; telle V; si V
logadit V: lese V; studere V _ lese lenge V
oalgguhit V: oppmuntre V; stimulere V _ oppmuntre V, friste V
movttiidahttit V: oppmuntre V; inspirere V; motivere V; stimulere V _ oppmuntre V, motivere V
muddet V: moderere V; regulere V; justere V _ korrigere V, moderere V; regulere V
njammat V: absorbere V _ suge V, patte V, sutte V; absorbere V
njoarrat V: tappe V; skjenke V _ skjenke V, tappe V
nohkkat V: sovne V _ sovne V; sove V
oađđit V: sove V _ sove V _ SAME
čaibmat V: le V _ le V, flire V
boagustit V: le V _ le V, flire V
bohkosit V: le V _ sette i å le V
ovddastit V: representere V _ forestå V; representere V
ovddidit V: fremme V; utvikle V _ fremme V; gå for fort V
ovdanbuktit V: fremme V; presentere V; uttrykke V _ legge fram V, presentere V
ruhtadit V: finansiere V _ finansiere V _ SAME
rádjat V: oppbevare V; lagre V; ordne V _ ta vare på V, oppbevare V; ordne V
ráfáiduhttit V: frede V _ frede V _ SAME
ráđđádallat V: konsultere V; drøfte V _ drøfte V, konferere med V, konsultere V
vuoigŋat V: puste V _ puste V _ SAME
šohkut V: puste V; blåse V _ puste V, blåse V
sahkat V: puste V _ puste V, pese V
bosihastit V: puste V _ puste ut V
sehkket V: blande V _ blande V _ SAME
seaguhit V: blande V _ blande V; legere V
seahkanit V: blande V _ bli blandet V, rotet V; bli sinnsforvirret V
áššáskuhttit V: påtale V; saksøke V; anklage V _ skylde på V, anklage V
sorbmet V: myrde V; drepe V _ myrde V, drepe V
stajidit V: herje V _ herje V, plyndre V
speadjat V: herje V _ plyndre V, herje V
rigeret V: herje V _ bråke V
sujahaddat V: beskylde V _ beskylde V _ SAME
suoládit V: stjele V _ stjele V _ SAME
rievidit V: stjele V; røve V _ røve V
vajálduhttit V: overse V; glemme V _ overse V, glemme V
vavdat V: stamme V; stotre V _ stamme V, stotre V; bli sittende fast V
viežžat V: hente V; innhente V _ hente V; laste ned V
viežžalit V: hente V _ hente fort V, hente noe som ikke er langt borte V
vuojehit V: jage V; drive V _ drive V, jage V
ádjit V: jage V; drive V _ jage V, drive V
oaguhit V: jage V; forfølge V _ forfølge V
vuoruhit V: prioritere V _ prioritere V _ SAME
ásahit V: innrette V; ordne V; etablere V; opprette V; innføre V _ etablere V; ordne V, innrette V
feret V: innrette V; oppleve V _ oppleve V
čađahit V: gjennomføre V _ gjennomføre V _ SAME
čoagganit V: samles V; samle V _ samles V
čoahkkanit V: samles V; møtes V; samle V _ samles V
čohkket V: samles V; montere V; innhente V; samle V _ samle V; montere V
čoavdit V: frita V; løse V _ løse V, låse opp V; frita V
čálihit V: skrive V; skrive V; registrere V; innmelde V _ la skrive V, skrive ut V; la seg registrere V; ta ut lysning V
šaddadit V: dyrke V; føde V _ dyrke V; føde V _ SAME
gilvit V: dyrke V; så V; sette V; spre V _ så V, plante V
šiehtadallat V: forhandle V _ forhandle V _ SAME
ealáskahttit V: revitalisere V _ revitalisere V _ SAME
guovlladit V: kikke V _ kikke V, kaste et blikk på V
guovlalit V: kikke V _ titte i all hast V
ájahallat V: oppholde V _ oppholde V _ SAME
buđaldit V: oppholde V _ pusle V
coahkkalit V: klikke V; smelle V _ smelle V, klikke V
deaddilit V: klikke V; trykke V _ trykke V, klemme V
álgit V: starte V; begynne V _ begynne V
ohcat V: søke V _ leite V
geavahit V: benytte V; bruke V _ bruke V
albmadit V: melde V _ melde til øvrigheten V
vikkahit V: forsøke V _ forsøke V, prøve å få til noe V
nagodit V: bestå V; klare V _ klare V
ceavzit V: bestå V; bestå V; holde seg V; overleve V _ holde seg V, klare seg V
seailut V: bestå V; bevare V; overleve V _ bevares V; klare seg V
dohkket V: godkjenne V _ duge V
čuohpadit V: operere V _ skjære seg V, hogge seg V
dihttot V: forekomme V _ vise seg V
čiehkádit V: gjemme V _ gjømme seg V
skirvehit V: svinge V _ svinge brått V
soardit V: såre V; såre V _ undertrykke V; skamfere V
láibut V: bake V _ bake brød V
gáhkket V: bake V _ bake kake V
bohčit V: pumpe V; melke V _ melke V, klemme V
goahcat V: bremse V _ bremse V _ SAME
staigat V: avta V _ slå seg til ro V; avta V
diŋgot V: abonnere V; bestille V _ bestille V
ovdošit V: forutse V _ forutse V _ SAME
divodit V: restaurere V _ reparere V
divvut V: restaurere V; rette V; justere V _ reparere V, rette på V
jeđđet V: berolige V; trøste V _ trøste V
garvit V: fravike V; unngå V _ unngå V
dahkaluddat V: agere V _ late som V; gjøre seg til V
liikot V: like V _ like V _ SAME
loktet V: løfte V; heve V _ løfte V
loktestit V: løfte V _ løfte V _ SAME
lovttohallat V: løfte V _ løfte V _ SAME
váidalit V: klage V; beklage V _ klage V, beklage V
oaggut V: fiske V _ fiske V _ SAME
guolástit V: fiske V _ fiske V _ SAME
guohtut V: beite V _ beite V _ SAME
sihtat V: ønske V; be V _ ville ha V, ønske V
dáhttut V: ønske V; be V _ ville V, ønske V
gokčat V: dekke V _ dekke V _ SAME
bahčit V: melke V _ melke V; sentrifugere V
jáhkkit V: tro V; anta V _ tro V, anta V
gáddit V: tro V; anta V _ tro V, anta V
oskut V: tro V _ tro V _ SAME
bindit V: vare V; holde seg V _ vare V, holde seg V
bistit V: vare V _ vare V _ SAME
láidet V: leie V; lede V _ leie V
báhtarit V: rømme V _ flykte V, rømme V
gárgidit V: rømme V _ rømme V _ SAME
sálket V: tømme V _ tømme V; tappe V
gurret V: tømme V _ tømme V _ SAME
oljet V: olje V _ olje V _ SAME
vuoiŋŋastit V: hvile V _ hvile V _ SAME
vuojadit V: svømme V _ svømme V, bade V
fuobmát V: oppdage V _ oppdage V _ SAME
áicát V: oppdage V _ oppdage V _ SAME
šearrát V: glitre V; skinne V; lyse V _ lyse V, skinne V, glitre V
šealgut V: glitre V _ glitre V _ SAME
muosehuhttit V: forstyrre V _ forstyrre V _ SAME
rievdadit V: forandre V; endre V _ forandre V
muhttit V: forandre V _ forandre V _ SAME
nuppástuhttit V: forandre V; tilpasse V; endre V _ forandre V, omstille V
hoavridit V: mase V _ mase V _ SAME
hoavrristit V: mase V _ mase V _ SAME
hoavrrestit V: mase V _ mase V _ SAME
fillehallat V: bli forledet V _ bli forledet V, bli narret V
duolbmut V: tråkke V _ tråkke V, trø V
šulšet V: tråkke V _ tråkke V, lage spor V
čuovgat V: skinne V; lyse V _ skinne V, lyse V; belyse V
báitit V: skinne V _ skinne V _ SAME
šealgát V: skinne V _ glinse V, skinne V
báittašit V: skinne V; lyse V _ skinne V, lyse V
borrat V: spise V _ spise V, ete V; etse V
borastit V: spise V _ spise V _ SAME
ballat V: frykte V _ frykte V, være redd V
baladit V: frykte V _ frykte V _ SAME
kártet V: kartlegge V _ kartlegge V _ SAME
gártet V: kartlegge V _ kartlegge V _ SAME
buorrestit V: omfavne V _ klemme V, omfavne V
salastit V: omfavne V _ omfavne V _ SAME
sallut V: omfavne V _ favne V; omfavne V
kommenteret V: kommentere V _ kommentere V _ SAME
bajásšaddat V: vokse opp V; vokse V _ vokse opp V
plánet V: planlegge V _ planlegge V _ SAME
ovttasbargat V: samarbeide V _ samarbeide V _ SAME
skuvlet V: undervise V _ undervise V _ SAME
gažadit V: intervjue V; spørre V _ spørre V, intervjue V
jearahallat V: intervjue V _ intervjue V _ SAME
gahčat V: spørre V _ spørre V _ SAME
jearrat V: spørre V _ spørre V _ SAME
gulaskuddat V: spørre V _ forhøre seg V, spørre V
jearadit V: spørre V _ spørre V _ SAME
lihkostuvvat V: lykkes V _ lykkes V _ SAME
menestuvvat V: lykkes V _ lykkes V _ SAME
meinnestuvvat V: lykkes V _ lykkes V _ SAME
goarránit V: vantrives V _ vantrives V, visne V
arvit V: regne V _ regne V _ SAME
ráŋggáštit V: straffe V _ straffe V _ SAME
bargat V: arbeide V; gjøre V _ arbeide V; gjøre V _ SAME
hommát V: arbeide V _ sysle V, arbeide V
dahkat V: gjøre V; skape V _ gjøre V; lage V
njoammut V: krype V; smitte V _ krype V; smitte V _ SAME
beahkit V: krype V _ krype V _ SAME
čákŋat V: krype V _ krype V, smyge inn i V
guokkardit V: krype V _ gå på alle fire - på hender og føtter V
massit V: miste V; tape V _ miste V
ribahit V: miste V _ miste V _ SAME
láhppit V: miste V _ miste V _ SAME
biestit V: miste V; slippe V _ miste V; slippe V _ SAME
bisánit V: stoppe V _ stoppe V; feste seg V
orustit V: stoppe V; stanse V _ stanse V, stoppe V
čuoččastit V: stoppe V _ reise seg V; stoppe V; stille seg V
notkat V: stoppe V _ stoppe V, dytte igjen V
bisuhit V: beholde V; bevare V; opprettholde V _ beholde V
bláđet V: bla V _ bla V _ SAME
buollit V: brenne V _ brenne V _ SAME
boaldit V: brenne V _ brenne V; svi V
borgguhit V: røyke V _ røyke V _ SAME
suovastit V: røyke V _ ryke V; røyke V
buokčat V: dykke V _ dykke V _ SAME
buressivdnidit V: velsigne V _ velsigne V _ SAME
goaivut V: grave V _ grave V, måke V, spa V
burgit V: grave V _ rote V, grave V; demontere V
skurbat V: grave V _ pirke V, grave V
hávkadit V: kvele V _ kvele V _ SAME
buvihit V: kvele V _ kvele V _ SAME
bálkkašit V: belønne V _ gjengjelde V; belønne V
lotnut V: betale V _ betale V, løse ut V
bárgidit V: flette V _ flette V _ SAME
cahkkehit V: tenne V; fyre V _ tenne V
vuodjut V: synke V _ synke V _ SAME
coahkut V: synke V _ minke V, synke V
dearpat V: banke V; slå V _ slå V, banke V
huškut V: banke V; slå V _ slå V, banke V
cábmit V: banke V; slå V _ slå V, banke V
čoalkalit V: banke V _ banke V, knakke V
goalkalit V: banke V _ banke V, knakke V
darrat V: skjelve V; riste V _ skjelve V, riste V
libaidit V: skjelve V _ bevre V, skjelve V; glimte V
livzzistit V: skjelve V _ vakle V; skjelve V
doarggistit V: skjelve V _ skjelve V _ SAME
dekoreret V: dekorere V _ dekorere V _ SAME
hervet V: dekorere V _ dekorere V _ SAME
diehtit V: vite V; kjenne V _ vite V
diggot V: bestille V; diskutere V _ bestille V; diskutere V, trette V; føre rettsak V
diktit V: tillate V _ la V; tillate V
suovvat V: tillate V _ tillate V, gi lov V
doarridit V: forfølge V _ forfølge V _ SAME
doddjot V: brekke V _ brekke V, gå av V
doidit V: skylle V _ skylle V _ SAME
doidilit V: skylle V _ skylle V, skylle fort V
dulkot V: tolke V; fortolke V _ tolke V; fortolke V _ SAME
gierdat V: tåle V _ tåle V _ SAME
duoddut V: tåle V _ tåle V _ SAME
vuoššat V: koke V _ koke V _ SAME
duoldat V: koke V _ koke V _ SAME
dutkat V: granske V; studere V _ granske V, forske V
dánset V: danse V _ danse V _ SAME
dánsut V: danse V _ danse V _ SAME
dápmat V: temme V _ temme V _ SAME
dárbbahit V: trenge V _ trenge V _ SAME
dárbbašit V: trenge V _ behøve V, trenge V
dávistit V: svare V _ svare V, gi gjenlyd V, gi respons V, reagere på V
vástidit V: svare V _ svare V _ SAME
eallit V: leve V _ leve V _ SAME
fallehit V: angripe V _ angripe V _ SAME
rohkkáhit V: angripe V _ angripe V _ SAME
vanahit V: tøye V; dra V; strekke V _ strekke V, tøye V
fanahit V: tøye V _ tøye V _ SAME
muosáhit V: oppleve V _ smake V; oppleve V
heivet V: passe V _ høve V, passe V
soahpat V: passe V _ passe V, høve V; bli enig V
fáktet V: passe V _ passe V, vokte V
gazzut V: klore V _ klore V _ SAME
ruohkkat V: klore V _ klø V, klore V
gaccastit V: klore V _ spise en skjefull V; klore V
rámpostit V: skryte V _ rose V, skryte V
gerret V: skryte V _ rose V, skryte V
rámpot V: skryte V _ rose V; skryte V
gieldit V: forby V; nekte V _ forby V, nekte V
giitit V: takke V _ takke V _ SAME
giitalit V: takke V _ takke V _ SAME
muollat V: brøle V _ belje V, brøle V
rohkut V: brøle V _ brøle V _ SAME
gilljut V: brøle V _ hyle V, brøle V
čeargut V: brøle V; rope V _ brøle V; tordne V
čerget V: brøle V _ brøle V; tordne V
giljádit V: brøle V _ hyle V, brøle V
veadjit V: orke V _ orke V, greie V; kanskje adv
gillet V: orke V _ orke V _ SAME
gilvvohallat V: konkurrere V _ konkurrere V _ SAME
gilvalit V: konkurrere V _ konkurrere V _ SAME
gohcit V: våke V _ våke V _ SAME
gohčodit V: kalle V; definere V _ kalle V, betegne V
goikat V: tørke V _ tørke V _ SAME
goikadit V: tørke V _ tørke V; steke V
sihkestit V: tørke V; male V _ tørke V; male V _ SAME
golgat V: renne V; drive V; drive V _ renne V; reke V; drive V
čierastit V: renne V _ renne V, ake V
čierastallat V: renne V _ renne V, ake V
govvet V: fotografere V; illustrere V _ fotografere V
gođđat V: gyte V _ gyte V _ SAME
guoddit V: bære V; føde V _ bære V; føde V _ SAME
gáhtat V: angre V _ angre V _ SAME
gáibidit V: kreve V _ kreve V _ SAME
gásttašit V: døpe V _ døpe V _ SAME
gávdnot V: finnes V _ finnes V _ SAME
gávppahit V: handle V _ handle V _ SAME
gávppašit V: handle V _ handle V, drive handel V
háisut V: lukte V _ lukte V, stinke V
haksit V: lukte V _ lukte V _ SAME
háleštit V: prate V; snakke V _ prate V, snakke sammen V
humadit V: prate V; snakke V _ prate V
hábmet V: utforme V; skape V _ utforme V
hálahit V: overtale V; påvirke V _ overtale V
hávdádit V: begrave V; gravlegge V _ begrave V
čuodjat V: lyde V; ringe V _ klinge V, ringe V, lyde V
jeagadit V: lyde V _ lyde V, lystre V
jeđđedit V: trøste V _ trøste V _ SAME
juohkit V: dele V; spre V; fordele V; tildele V _ dele V
juogadit V: dele V; fordele V; tildele V _ dele V; dele ut V
juolludit V: bevilge V; gi V; tildele V _ avse V; bevilge V
leiket V: skjenke V _ skjenke V, helle V
njorret V: skjenke V _ skjenke V _ SAME
leaikut V: skjenke V _ skjenke V, helle V
njorrestit V: skjenke V _ skjenke V _ SAME
loaktit V: trives V _ forbruke V; trives V
lohpidit V: love V _ love V _ SAME
lágidit V: ordne V; arrangere V; lage V _ stelle V, ordne V; arrangere V
stellet V: ordne V; plassere V _ stelle V, ordne V, plassere V
lávlut V: synge V _ synge V _ SAME
maŋidit V: utsette V _ utsette V; saktne V
mieđuštit V: ledsage V; følge V _ ledsage V, følge V
mihtidit V: måle V _ måle V _ SAME
moddját V: smile V _ smile V _ SAME
muitit V: huske V; minnes V _ huske V, minnes V
muittašit V: minnes V _ minnes V _ SAME
máhccut V: brette V _ brette V; bukke V
máhcastit V: brette V _ brette V _ SAME
niegadit V: drømme V _ drømme V _ SAME
áitit V: true V _ true V _ SAME
uhkidit V: true V _ true V _ SAME
nihttit V: true V _ true V _ SAME
vuohkadit V: true V _ true V _ SAME
šállošit V: beklage V _ beklage V _ SAME
nuvkkihit V: nikke V _ nikke V _ SAME
nivkalit V: nikke V _ nikke V _ SAME
nivkut V: nikke V _ nikke V _ SAME
njuovvat V: slakte V _ slakte V, flå V
njuovadit V: slakte V _ slakte V _ SAME
vuoidat V: smøre V _ smøre V _ SAME
njuvdit V: smøre V _ kline V, smøre V
nomineret V: nominere V _ nominere V _ SAME
čuoččuhit V: påstå V; hevde V _ hevde V, påstå V
náitalit V: gifte seg V _ gifte seg V _ SAME
návddašit V: nyte V _ nyte V, smake V
oaffaruššat V: ofre V _ ofre V _ SAME
oastit V: kjøpe V _ kjøpe V _ SAME
vealahit V: diskriminere V _ diskriminere V; berøve V
olgguštit V: diskriminere V; tilsidesette V _ diskriminere V, tilsidesette V
orrut V: bo V; synes V _ være V, bli V; bo V; synes V
rasttidit V: krysse V _ krysse V _ SAME
organiseret V: organisere V _ organisere V _ SAME
šaddat V: fødes V; komme V; vokse V _ vokse V; fødes V; bli V; komme til å V
riegádit V: fødes V; føde V _ fødes V
riepmat V: begynne V _ begynne V _ SAME
viehkat V: løpe V; springe V _ løpe V
ruohttat V: løpe V; springe V _ løpe V
ráhkistit V: elske V _ elske V, være glad i V
sihkkelastit V: sykle V _ sykle V _ SAME
sojahit V: bøye V _ bøye V _ SAME
stirdut V: stivne V _ stivne V _ SAME
stávet V: stave V _ stave V _ SAME
suodjalit V: beskytte V; bevare V; verne V; sikre V _ verne V, beskytte V
várjalit V: beskytte V; forsvare V _ forsvare V, beskytte V
suoskat V: tygge V _ tygge V _ SAME
sáltet V: salte V _ salte V _ SAME
tennjet V: tegne V _ tegne V _ SAME
tevdnet V: tegne V _ tegne V _ SAME
vajáldahttit V: glømme V; glemme V _ glømme V
vardit V: blø V _ blø V _ SAME
vuoksit V: spy V _ spy V _ SAME
vuovssadit V: spy V _ spy V _ SAME
áibbašit V: lengte V _ lengte V _ SAME
ánssášit V: fortjene V _ fortjene V _ SAME
árbet V: arve V _ arve V _ SAME
ávvudit V: feire V; markere V _ feire V; fryde seg V
gođđit V: binde V; knytte V _ strikke V; veve V; binde, knytte V
čiekčat V: sparke V _ spenne V, sparke V
čievččastit V: sparke V _ sparke V, spenne V
čábbudit V: pynte V _ gjøre penere V, pynte V
čorget V: rydde V _ gjøre reint V, rydde V, stelle V
šliipet V: slipe V _ slipe V _ SAME
šluhttet V: avlyse V _ avlyse V _ SAME
ákkastallat V: argumentere V; begrunne V _ argumentere V
filbmet V: filme V _ filme V _ SAME
levget V: flagge V _ flagge V _ SAME
dáruiduhttit V: fornorske V _ fornorske V _ SAME
libardit V: vaie V _ flagre V, vaie V
bombet V: bombe V _ bombe V _ SAME
lásset V: låse V _ låse V _ SAME
fállat V: tilby V _ tilby V, by på V
doarjut V: støtte V _ støtte V, gi tilslutning til V
doarjalit V: støtte V _ støtte V _ SAME
čuožžilit V: oppstå V _ reise seg V
beroštit V: interessere V _ bry seg om V
seastit V: spare V; redusere V _ spare V
bealuštit V: forsvare V _ forsvare V; forfekte V; ta part V
olggosaddit V: utgi V _ utgi V _ SAME
málet V: male V _ male V _ SAME
ferdnet V: male V _ male V, kverne V
bossut V: blåse V _ blåse V _ SAME
bosádit V: blåse V _ blåse V _ SAME
bieggat V: blåse V _ blåse V _ SAME
analyseret V: analysere V _ analysere V _ SAME
márkanastit V: markedsføre V _ markedsføre V _ SAME
suddat V: smelte V _ smelte V, tine V
suddadit V: smelte V _ smelte V _ SAME
vuohčut V: smelte V _ piple V; smelte V
guođđit V: forlate V _ forlate V, etterlate V
guođđilit V: forlate V _ forlate V, etterlate V
gaivát V: glane V; se V _ glane V, glo V
gávkat V: glane V _ glane V, glo V
olahit V: nå V; nå V; oppnå V _ rekke V, nå V
joksat V: nå V; nå V; innhente V; oppnå V _ innhente V
juksat V: nå V; nå V; oppnå V _ nå igjen V
ollit V: nå V; strekke V _ nå V, rekke V
noddet V: nå V _ nå V, rekke V
eaiggáduššat V: eie V _ eie V _ SAME
oamastit V: eie V _ tilegne seg V; eie V
riegádahttit V: føde V _ føde V, nedkomme V
beaskidit V: klippe V _ klippe V _ SAME
vadjat V: klippe V _ klippe V, skjære V; lokke V
ofelastit V: følge V _ vise veg V, guide V
gávdnat V: finne V _ finne V _ SAME
dádjadit V: finne V _ finne fram V
merket V: merke V _ merke V _ SAME
mearkut V: merke V _ merke V _ SAME
merkot V: merke V _ legge merke til V
dárkot V: merke V; undersøke V; observere V _ betrakte V, undersøke V
vávjit V: merke V; mistenke V; kritisere V _ mistenke V; kritisere V
vuohttit V: merke V _ finne spor V, følge spor V
mannat V: reise V; dra V; gå V _ gå V, dra V, reise V
johtit V: reise V; flytte V _ bevege seg V; reise V; flytte V
vuolgit V: reise V; dra V _ dra V, reise av sted V
mátkkoštit V: reise V; ferdes V _ reise V, ferdes V
čuoččahit V: reise V _ reise seg V; stille seg V
oahppat V: lære V _ lære V; se etter fangst V
badjánit V: stige V _ stige V _ SAME
goargŋut V: stige V; øke V _ klatre V; stige V; stake elvebåt V
lassánit V: stige V; øke V _ øke V
časkit V: slå V; slå V _ slå V
speažžut V: slå V _ daske V, slå V
huškkastit V: slå V _ slå V _ SAME
ravkit V: slå V _ slå V _ SAME
meaidit V: slå V; hogge V _ slå V, hogge V, meie V
šávget V: slå V _ slå V, helle V
šávgut V: slå V _ slå V, helle V
roaškut V: slå V; smelle V _ slå V, smelle V
sárdnut V: tale V; snakke V _ tale V
ságastallat V: tale V; diskutere V _ snakke sammen V
vahágahttit V: skade V; ødelegge V _ skade V
roasmmuhuvvat V: skade V _ bli skadet V, skade seg V
deaddit V: presse V; veie V; trykke V _ trykke V, presse V; veie V
bahkket V: presse V _ trenge på V, trenge seg fram V; presse V; være nærgående V
geahččat V: se V _ se V, se på V
geahčadit V: se V _ forhåndsgranske V
guovlat V: se V _ kike V, titte V
rahpat V: åpne V _ åpne V, lukke opp V
rabastit V: åpne V _ åpne V, lukke opp V
rabestit V: åpne V _ åpne V, lukke opp V
leahkkut V: åpne V _ åpne V, lukke opp V
leahkastit V: åpne V _ åpne V, lukke opp V
rahpasit V: åpne V _ åpne seg V
guoskkahit V: røre V; berøre V; omtale V _ røre V, berøre V
lihkahit V: røre V; røre V _ røre V, bevege V
lihkastit V: røre V _ bevege V, røre V
njuorasmahttit V: røre V _ ydmyke V
bávkit V: smelle V _ smelle V _ SAME
beaškit V: smelle V _ smelle V; slamre V
spoahkkit V: smelle V _ smelle V _ SAME
beaškkihit V: smelle V _ smelle V; kollidere V
spoahkkalit V: smelle V _ smelle V, smekke V
bávkkihit V: smelle V _ smelle V _ SAME
bidjat V: sette V; sette V; sette V; plassere V _ sette V; legge V
bidjalit V: sette V _ legge V, sette V
bordit V: sette V _ stable V
baldit V: skremme V _ skremme V _ SAME
baldalit V: skremme V _ skremme V _ SAME
balddáhallat V: skremme V _ skremme V _ SAME
surgehit V: skremme V _ skremme V _ SAME
gárvvistit V: forberede V _ forberede V, gjøre klar V
ráhkkanahttit V: forberede V _ utruste V, forberede V
ráhkkanit V: forberede V _ gjøre seg klar V
hásttuhit V: oppfordre V; utfordre V _ oppfordre V, utfordre V
hástalit V: utfordre V _ utfordre V _ SAME
guorahaddat V: undersøke V _ undersøke V _ SAME
iskkadit V: undersøke V _ undersøke V, holde på å forsøke V
vihkket V: veie V _ veie V _ SAME
studeret V: studere V _ studere V _ SAME
vealtat V: unngå V _ unngå V _ SAME
dollet V: holde V; stanse V _ gripe V, ta et tak V; stanse V; konfiskere V; dra V
doalahit V: holde V; opprettholde V _ holde V, fortsette V; la være V
mielddisbuktit V: medføre V; innebære V _ medføre V
ovdánahttit V: utvikle V _ utvikle V _ SAME
gárget V: utvikle V _ vikle opp V, rekke opp V
ovdánit V: utvikle V _ utvikle seg V, gå framover V, avansere V
skeŋket V: gi V _ forære V, gi V
lávet V: bruke V _ pleie V, bruke V
golahit V: bruke V _ bruke V, forbruke V
ávkkástallat V: bruke V; utnytte V _ utnytte V
balahit V: mistenke V _ engste seg for noe V; mistenke V
biehtadit V: nekte V _ nekte V; benekte V
bihtit V: klare V _ klare V _ SAME
birget V: klare V; overleve V _ greie seg V
biđget V: ødelegge V; spre V _ ødelegge V; spre V _ SAME
billistit V: ødelegge V; undergrave V _ ødelegge V
billašuvvat V: ødelegge V _ bli ødelagt V
bissut V: holde seg V; fortsette V _ forbli V, holde seg V
bisihit V: stanse V _ stanse V _ SAME
rohkadallat V: be V _ be V _ SAME
lávdat V: spre V _ spre seg utover V
soaitit V: komme V _ kanskje adv; tilfeldigvis komme til å V
ollet V: komme V _ nå fram V
joavdat V: komme V _ nå fram V
ilbmat V: komme V _ utkomme V
čoaggit V: plukke V; samle V _ plukke V
gaskit V: plukke V _ ribbe V, plukke V
navvit V: plukke V _ pirke V, plukke V
murjet V: plukke V _ plukke bær V
lubmet V: plukke V _ plukke molter V
gággat V: bryte V _ bryte V, velte V
fággádit V: bryte V _ bryte V, ta tak V
heaibut V: bryte V _ bryte V, ta tak V
boatkanit V: bryte V _ bryte sammen V; slites av V
botnjat V: vri V _ vri V _ SAME
bonjastit V: vri V _ vri V _ SAME
jorahit V: vri V _ rotere V
čugget V: stikke V _ stikke V _ SAME
čuoggut V: stikke V _ stikke V _ SAME
čuggestit V: stikke V _ stikke V _ SAME
viehkalit V: stikke V; springe V _ løpe avgårde V
čuohcit V: påvirke V; berøre V _ påvirke V, berøre V
bálkestit V: kaste V _ kaste V _ SAME
suhppet V: kaste V; kaste V _ kaste V; sette ut V
bálkut V: kaste V _ kaste V _ SAME
suohpput V: kaste V; kaste V _ kaste V; sette ut garn, line, not V
njoarostit V: kaste V _ kaste lasso V
cancut V: springe V _ springe V, sprette V
dadjat V: si V _ si V _ SAME
jietnadit V: si V; uttale V _ gi lyd fra seg V
jienádit V: si V _ ytre V, ymte V
dadjalit V: si V _ si fort V
čárvet V: klype V _ klype V, klemme V
čárvut V: klype V _ klype V, klemme V
cikcut V: klype V _ klype V, knipe V
cibmut V: klype V _ knuge V; klype V
cuiggodit V: påpeke V; kritisere V _ formane V, advare V
savdnjit V: riste V _ riste V _ SAME
savdnjilit V: riste V _ riste V _ SAME
šluvgit V: riste V _ riste V, slenge V
dállet V: riste V _ riste V _ SAME
náđđut V: trykke V _ krype sammen V; trykke V
prentet V: trykke V _ prente V
oaidnalit V: treffe V _ sees V
digaštallat V: diskutere V; drøfte V _ debattere V
diggedit V: diskutere V _ diskutere V, krangle V
duddjot V: lage V; skape V _ lage V, gjøre håndarbeid V, utføre håndverk V
duššindahkat V: undergrave V _ annullere V, undergrave V
geavvat V: skje V; gå V _ heve seg V; gå V
dáncat V: trampe V _ trampe V _ SAME
earránit V: skilles V; skille V _ skilles V
earuhit V: differensiere V; skille V _ differensiere V, skjelne V
evttohit V: foreslå V; anbefale V _ foreslå V, avgi innstilling V; ta til orde for V
árvalit V: foreslå V _ foreslå V; ymte V
fihttet V: oppfatte V _ oppfatte V, komme på V
gaikut V: rive V; slite V _ rive V, slite V
njaskut V: rive V _ gnage V, rive V
ravget V: slite V _ rykke V, slite V
rundit V: slite V _ slite V, slepe V
gaikkehit V: slite V _ rykke til V, slite V
ravgut V: slite V _ rykke V, slite V
váibadit V: slite V _ trøtte ut V
geassit V: dra V; trekke V _ dra V, trekke V
vázzit V: gå V _ gå V, spasere V
vássit V: gå V _ svinne V, gå V
hurgit V: gå V _ ile V, legge i veg V
gollat V: gå V _ gå V, svinne V
vázzilit V: gå V _ begynne å gå V
meannudit V: behandle V _ oppføre seg V; behandle V
gieđahallat V: behandle V _ bearbeide V, behandle V
dálkkodit V: behandle V _ behandle for sykdom V, medisinere V
cielahit V: mobbe V _ gjø på noen V; skjelle ut V
rievdat V: drive V; endre V _ drive V, reke V; forandre seg V
gullat V: høre V _ høre V; tilhøre V
gullostit V: høre V _ plutselig høres V; føles svakt V
lihkahallat V: berøre V _ berøre V; bevege V
einnostit V: anta V; anslå V; forvente V _ forutsi V, spå V, antisipere V
gáhttet V: bevare V; verne V _ vokte V, ta vare på V, bevare V
sorját V: henge V _ henge V _ SAME
heaŋgát V: henge V _ henge V _ SAME
heŋget V: henge V _ henge opp V
heaŋgut V: henge V _ henge opp V
sorjalit V: henge V _ henge V _ SAME
harcet V: henge V _ henge V _ SAME
heivehit V: tilpasse V _ tilpasse V _ SAME
hoallat V: snakke V _ snakke V _ SAME
dárustit V: snakke V _ snakke norsk V
sámástit V: snakke V _ snakke samisk V
hoigat V: skyve V _ skyve V, puffe V
hovdet V: lede V _ lede V, styre V
čuorvut V: rope V _ rope V _ SAME
čurvet V: rope V _ rope V _ SAME
doahput V: skaffe V _ gripe V
áittardit V: skaffe V _ passe på saker V; skaffe V; sørge for V
geasuhit V: rekruttere V _ tiltrekke V
áddehaddat V: forstå V _ forstå hverandre V
šuvvat V: suse V _ suse V _ SAME
šoavvat V: suse V _ suse V, bruse V
juhcat V: suse V _ suse V, bruse V
julggaštit V: erklære V _ erklære V _ SAME
juoigat V: joike V _ joike V _ SAME
juoiggastit V: joike V _ joike litt V
jáddadit V: slukke V _ slukke V _ SAME
čáskadit V: slukke V _ slukke V _ SAME
jáddat V: slukke V _ slukne V
njávkkadit V: stryke V _ stryke V _ SAME
njávkat V: stryke V _ stryke med handa V
liktet V: stryke V _ pusse V; stryke V
veallát V: ligge V _ ligge V _ SAME
livvadit V: ligge V _ ligge V _ SAME
vealládit V: ligge V _ ligge V _ SAME
veallánit V: ligge V _ legge seg V
gárvet V: sluttføre V _ gjøre ferdig V
geargat V: sluttføre V _ bli ferdig V
lonet V: låne V _ låne V _ SAME
luoikkahit V: låne V _ låne hos noen V
moaitit V: kritisere V _ klage over V
čuolastit V: hogge V _ hogge V _ SAME
njáskat V: hogge V _ kviste V; rydde mark V
meroštit V: definere V; anslå V; beregne V _ anslå V; definere V
molssodit V: skifte V _ skifte V _ SAME
moraštit V: sørge V _ sørge V _ SAME
máinnastit V: fortelle V _ fortelle V, fortelle eventyr V
nuppástuvvat V: endre V _ forandre seg V
namahit V: omtale V; nevne V; oppnevne V _ nevne V
nammadit V: omtale V; oppnevne V _ oppnevne V; omtale V
jođašit V: ferdes V _ bevege V
vánddardit V: ferdes V _ vandre V, streife V
vádjolit V: ferdes V _ vandre V
johtalit V: ferdes V _ rikle, slarke V; ferdes V
oaivvildit V: mene V _ mene V, ta stilling til V
oidnot V: synes V _ synes V _ SAME
vuhttot V: synes V _ spores V
speallat V: spille V _ spille V; spille kort V
neaktit V: spille V _ se ut som V; spille V
čuojahit V: ringe V _ ringe V; spille V
riŋget V: ringe V _ ringe V _ SAME
riŋgestit V: ringe V _ ringe V _ SAME
sivdnidit V: skape V _ skape V, signe V
soahtat V: kjempe V _ kjempe V, krige V
vajálduvvat V: glemme V _ glemmes V
vuordit V: vente V; forvente V _ vente V
vuorddašit V: vente V _ vente lenge V
veavdit V: vente V _ vente V, hale med seg V
viiddidit V: utvide V _ utvide V _ SAME
stuoridit V: utvide V; øke V _ forstørre V
viidánit V: utvide V _ spre seg V; utvide seg V
vuosehit V: vise V _ vise V _ SAME
čájáhallat V: vise V _ framvise V
válljet V: velge V _ velge V _ SAME
čierrut V: gråte V _ gråte V _ SAME
čalmmustahttit V: markere V; belyse V _ fokusere på V, gjøre synlig V
čuolbmadit V: knytte V _ knytte V _ SAME
čadnot V: knytte V _ knyttes til V
čatnasit V: knytte V _ bli bundet V
čuvget V: belyse V; opplyse V _ opplyse V, belyse V
čuožžut V: stå V; stå V _ stå V
ceaggát V: stå V _ stå oppreist V
čuččodit V: stå V _ bli stående V
stuorrut V: vokse V; øke V _ bli stor V
sisttisdoallat V: inneholde V; omfatte V _ inneholde V
oasálastit V: delta V _ delta V _ SAME
oassálastit V: delta V _ delta i V
searvat V: delta V _ slutte seg sammen V
dolastit V: fyre V _ fyre V, ha bål V
ligget V: fyre V _ varme V
laskat V: øke V _ øke V, formere seg V
lasihit V: øke V _ legge til V, øke V
hukset V: bygge V _ bygge V _ SAME
rávdat V: trekke V _ trekke V _ SAME
jiellat V: trekke V _ trekke V, blåse svakt V
geassádit V: trekke V _ trekke seg V
rohttet V: trekke V _ rykke V; komme på V
vuorbádit V: trekke V _ kaste lodd V, trekke lodd V
sihkkarastit V: sikre V _ sikre V _ SAME
fárret V: flytte V _ flytte V _ SAME
unnidit V: redusere V _ forminsk V
uhcidit V: redusere V _ forminske V
registreret V: registrere V _ registrere V _ SAME
áicat V: registrere V; observere V _ oppdage V
vuoittáhallat V: tape V _ tape V _ SAME
láhppot V: tape V _ gå seg vill V
oažžut V: motta V; oppnå V _ få V
vuostáiváldit V: motta V _ ta imot V
njulget V: rette V _ rette ut V, glatte ut V
gálgat V: løse V _ løse V _ SAME
rátkit V: skille V _ skille V, skille rein V
rátkkašit V: skille V _ skille V _ SAME
imaštit V: overraske V _ forundre seg V
hirpmástuvvat V: overraske V _ bli forskrekket V
hirpmahuvvat V: overraske V _ bli forskrekket V
divustit V: justere V _ rette på V
divaštallat V: drøfte V _ diskutere V
dovddiidit V: identifisere V _ erfare V, lære å kjenne V
lahttudit V: innlemme V _ innlemme V, inkorporere V
duogŋat V: bøte V _ lappe V
čiktit V: bøte V _ bøte garn V; bøye en skitupp V
fearrat V: meisle V _ telje V
gomihit V: oppheve V _ velte V; avvise V; gjendrive V
