ballestalai			ballástalai
beaivvebealde		two words  lea sub
cipmástii			cipmastii  
deaddelit			deaddilit
dihráidit			dihraidi
earret_eará         two words  lea sub
earáládje           two words  lea sub
fanjádit			faŋádit 
fiasko				fiásko 
fiidnat				fiidnát
friddjaminukta		friddjaminuhta  
goappešagain		goappašagain 
guođđelit			guođđilit
gáfejá				kaféa 
hilján				hillján
hálidus				háliidus 
juogaládje			two words  lea sub
juohkeládje			two words
jámalgit			jámálgit
lieđđudeaddji		lieđđu
litnasit			litnásit
mannjit				maŋŋit
maŋŋelas			maŋŋelaš 
maŋŋelgaska         two words
njealjes			njealjis
nuppebealde			two words  lea sub
oaivádallan			oaivadallan
ovdošit				ovddošit
politiijá			politiija
reaškkehit			reaškkihit
rokkáhit			rohkkáhit
savkosit			savkosii
seammaládje			two words  lea sub
seavvelit			seavvilit
seksualalaš			seksuálalaš  
skerttehii			skerttegii
skutter				skuter 
skándala			skandála
snáhppat			snáhppát
spábbačikčiekči		spábbačiekči
stáđuheapme			stađuheapme
sulástahttit		sulastahttit
táll				tál
vihttanuppelotjahkásaš	viđanuppelotjahkásaš
vuohkáhalai				vuohkadalai
šlieđđát				šlieddát
šuohkehit				šuohkihit
čágalduhttet			čagalduhttet
